그는	ᄀ ᅳ ᄂ ᅳ ᆫ
괜찮은	ᄀ ᅫ ᆫ ᄎ ᅡ ᄂ ᅳ ᆫ
척하려고	ᄎ ᅥ ᄏ ᅡ ᄅ ᅧ ᄀ ᅩ
애쓰는	ᄋ ᅢ ᄊ ᅳ ᄂ ᅳ ᆫ
것	ᄀ ᅥ ᆮ
같았다	ᄀ ᅡ ᄐ ᅡ ᆮ ᄄ ᅡ
그녀의	ᄀ ᅳ ᄂ ᅧ ᄋ ᅴ
사랑을	ᄉ ᅡ ᄅ ᅡ ᆼ ᄋ ᅳ ᆯ
얻기	ᄋ ᅥ ᆮ ᄁ ᅵ
위해	ᄋ ᅱ ᄒ ᅢ
애썼지만	ᄋ ᅢ ᄊ ᅥ ᆮ ᄍ ᅵ ᄆ ᅡ ᆫ
헛수고였다	ᄒ ᅥ ᆮ ᄊ ᅮ ᄀ ᅩ ᄋ ᅧ ᆮ ᄄ ᅡ
용돈을	ᄋ ᅭ ᆼ ᄃ ᅩ ᄂ ᅳ ᆯ
아껴	ᄋ ᅡ ᄁ ᅧ
써라	ᄊ ᅥ ᄅ ᅡ
아내를	ᄋ ᅡ ᄂ ᅢ ᄅ ᅳ ᆯ
많이	ᄆ ᅡ ᄂ ᅵ
아낀다	ᄋ ᅡ ᄁ ᅵ ᆫ ᄃ ᅡ
그	ᄀ ᅳ
애	ᄋ ᅢ
전화번호	ᄌ ᅥ ᆫ ᄒ ᅪ ᄇ ᅥ ᆫ ᄒ ᅩ
알아	ᄋ ᅡ ᄅ ᅡ
차에	ᄎ ᅡ ᄋ ᅦ
대해	ᄃ ᅢ ᄒ ᅢ
잘	ᄌ ᅡ ᆯ
아세요	ᄋ ᅡ ᄉ ᅦ ᄋ ᅭ
거기	ᄀ ᅥ ᄀ ᅵ
도착하면	ᄃ ᅩ ᄎ ᅡ ᄏ ᅡ ᄆ ᅧ ᆫ
나한테	ᄂ ᅡ ᄒ ᅡ ᆫ ᄐ ᅦ
알려	ᄋ ᅡ ᆯ ᄅ ᅧ
줘	ᄌ ᅯ
그들은	ᄀ ᅳ ᄃ ᅳ ᄅ ᅳ ᆫ
내가	ᄂ ᅢ ᄀ ᅡ
시험에	ᄉ ᅵ ᄒ ᅥ ᄆ ᅦ
떨어졌다고	ᄄ ᅥ ᄅ ᅥ ᄌ ᅥ ᆮ ᄄ ᅡ ᄀ ᅩ
왔다	ᄋ ᅪ ᆮ ᄄ ᅡ
나는	ᄂ ᅡ ᄂ ᅳ ᆫ
살아오면서	ᄉ ᅡ ᄅ ᅡ ᄋ ᅩ ᄆ ᅧ ᆫ ᄉ ᅥ
감기를	ᄀ ᅡ ᆷ ᄀ ᅵ ᄅ ᅳ ᆯ
앓은	ᄋ ᅡ ᄅ ᅳ ᆫ
적이	ᄌ ᅥ ᄀ ᅵ
한	ᄒ ᅡ ᆫ
번도	ᄇ ᅥ ᆫ ᄃ ᅩ
없다	ᄋ ᅥ ᆸ ᄄ ᅡ
사흘	ᄉ ᅡ ᄒ ᅳ ᆯ
동안	ᄃ ᅩ ᆼ ᄋ ᅡ ᆫ
심하게	ᄉ ᅵ ᆷ ᄒ ᅡ ᄀ ᅦ
몸살을	ᄆ ᅩ ᆷ ᄉ ᅡ ᄅ ᅳ ᆯ
앓았어요	ᄋ ᅡ ᄅ ᅡ ᄊ ᅥ ᄋ ᅭ
요즘	ᄋ ᅭ ᄌ ᅳ ᆷ
공부가	ᄀ ᅩ ᆼ ᄇ ᅮ ᄀ ᅡ
안	ᄋ ᅡ ᆫ
돼요	ᄃ ᅫ ᄋ ᅭ
장사가	ᄌ ᅡ ᆼ ᄉ ᅡ ᄀ ᅡ
돼서	ᄃ ᅫ ᄉ ᅥ
우울해	ᄋ ᅮ ᄋ ᅮ ᆯ ᄒ ᅢ
아무	ᄋ ᅡ ᄆ ᅮ
것도	ᄀ ᅥ ᆮ ᄄ ᅩ
먹지	ᄆ ᅥ ᆨ ᄍ ᅵ
않으면	ᄋ ᅡ ᄂ ᅳ ᄆ ᅧ ᆫ
죽게	ᄌ ᅮ ᆨ ᄁ ᅦ
되어	ᄃ ᅬ ᄋ ᅥ
있다	ᄋ ᅵ ᆮ ᄄ ᅡ
그녀는	ᄀ ᅳ ᄂ ᅧ ᄂ ᅳ ᆫ
이유를	ᄋ ᅵ ᄋ ᅲ ᄅ ᅳ ᆯ
묻지	ᄆ ᅮ ᆮ ᄍ ᅵ
않고	ᄋ ᅡ ᆫ ᄏ ᅩ
돈을	ᄃ ᅩ ᄂ ᅳ ᆯ
빌려	ᄇ ᅵ ᆯ ᄅ ᅧ
주었다	ᄌ ᅮ ᄋ ᅥ ᆮ ᄄ ᅡ
아기를	ᄋ ᅡ ᄀ ᅵ ᄅ ᅳ ᆯ
안고	ᄋ ᅡ ᆫ ᄁ ᅩ
있을	ᄋ ᅵ ᄊ ᅳ ᆯ
게	ᄀ ᅦ
엄마는	ᄋ ᅥ ᆷ ᄆ ᅡ ᄂ ᅳ ᆫ
말없이	ᄆ ᅡ ᄅ ᅥ ᆸ ᄊ ᅵ
나를	ᄂ ᅡ ᄅ ᅳ ᆯ
꼭	ᄁ ᅩ ᆨ
안아	ᄋ ᅡ ᄂ ᅡ
주셨다	ᄌ ᅮ ᄉ ᅧ ᆮ ᄄ ᅡ
자리에	ᄌ ᅡ ᄅ ᅵ ᄋ ᅦ
앉으세요	ᄋ ᅡ ᆫ ᄌ ᅳ ᄉ ᅦ ᄋ ᅭ
여자가	ᄋ ᅧ ᄌ ᅡ ᄀ ᅡ
내	ᄂ ᅢ
옆에	ᄋ ᅧ ᄑ ᅦ
앉았다	ᄋ ᅡ ᆫ ᄌ ᅡ ᆮ ᄄ ᅡ
일일사에	ᄋ ᅵ ᄅ ᅵ ᆯ ᄉ ᅡ ᄋ ᅦ
전화를	ᄌ ᅥ ᆫ ᄒ ᅪ ᄅ ᅳ ᆯ
해서	ᄒ ᅢ ᄉ ᅥ
번호를	ᄇ ᅥ ᆫ ᄒ ᅩ ᄅ ᅳ ᆯ
알아보시지	ᄋ ᅡ ᄅ ᅡ ᄇ ᅩ ᄉ ᅵ ᄌ ᅵ
그러세요	ᄀ ᅳ ᄅ ᅥ ᄉ ᅦ ᄋ ᅭ
누군지	ᄂ ᅮ ᄀ ᅮ ᆫ ᄌ ᅵ
알아보겠니	ᄋ ᅡ ᄅ ᅡ ᄇ ᅩ ᄀ ᅦ ᆫ ᄂ ᅵ
절대	ᄌ ᅥ ᆯ ᄃ ᅢ
다른	ᄃ ᅡ ᄅ ᅳ ᆫ
사람의	ᄉ ᅡ ᄅ ᅡ ᄆ ᅴ
의견을	ᄋ ᅴ ᄀ ᅧ ᄂ ᅳ ᆯ
받아들이지	ᄇ ᅡ ᄃ ᅡ ᄃ ᅳ ᄅ ᅵ ᄌ ᅵ
않는다	ᄋ ᅡ ᆫ ᄂ ᅳ ᆫ ᄃ ᅡ
아이들도	ᄋ ᅡ ᄋ ᅵ ᄃ ᅳ ᆯ ᄃ ᅩ
언젠가는	ᄋ ᅥ ᆫ ᄌ ᅦ ᆫ ᄀ ᅡ ᄂ ᅳ ᆫ
그녀를	ᄀ ᅳ ᄂ ᅧ ᄅ ᅳ ᆯ
엄마로	ᄋ ᅥ ᆷ ᄆ ᅡ ᄅ ᅩ
받아들일	ᄇ ᅡ ᄃ ᅡ ᄃ ᅳ ᆯ ᄅ ᅵ ᆯ
거야	ᄀ ᅥ ᄋ ᅣ
어디에서	ᄋ ᅥ ᄃ ᅵ ᄋ ᅦ ᄉ ᅥ
영어를	ᄋ ᅧ ᆼ ᄋ ᅥ ᄅ ᅳ ᆯ
배우셨어요	ᄇ ᅢ ᄋ ᅮ ᄉ ᅧ ᄊ ᅥ ᄋ ᅭ
동료에게서	ᄃ ᅩ ᆼ ᄂ ᅭ ᄋ ᅦ ᄀ ᅦ ᄉ ᅥ
수화를	ᄉ ᅮ ᄒ ᅪ ᄅ ᅳ ᆯ
배우고	ᄇ ᅢ ᄋ ᅮ ᄀ ᅩ
있습니다	ᄋ ᅵ ᆮ ᄊ ᅳ ᆷ ᄂ ᅵ ᄃ ᅡ
이거	ᄋ ᅵ ᄀ ᅥ
걸로	ᄀ ᅥ ᆯ ᄅ ᅩ
바꿀	ᄇ ᅡ ᄁ ᅮ ᆯ
수	ᄉ ᅮ
있을까요	ᄋ ᅵ ᄊ ᅳ ᆯ ᄁ ᅡ ᄋ ᅭ
색깔을	ᄉ ᅢ ᆨ ᄁ ᅡ ᄅ ᅳ ᆯ
바꾸는	ᄇ ᅡ ᄁ ᅮ ᄂ ᅳ ᆫ
나을	ᄂ ᅡ ᄋ ᅳ ᆯ
거	ᄀ ᅥ
같아	ᄀ ᅡ ᄐ ᅡ
소영이	ᄉ ᅩ ᄋ ᅧ ᆼ ᄋ ᅵ
좀	ᄌ ᅩ ᆷ
바꿔	ᄇ ᅡ ᄁ ᅯ
주세요	ᄌ ᅮ ᄉ ᅦ ᄋ ᅭ
눈이	ᄂ ᅮ ᄂ ᅵ
얼음으로	ᄋ ᅥ ᄅ ᅳ ᄆ ᅳ ᄅ ᅩ
바뀌었어	ᄇ ᅡ ᄁ ᅱ ᄋ ᅥ ᄊ ᅥ
핸드폰이	ᄒ ᅢ ᆫ ᄃ ᅳ ᄑ ᅩ ᄂ ᅵ
네	ᄂ ᅦ
거랑	ᄀ ᅥ ᄅ ᅡ ᆼ
바뀐	ᄇ ᅡ ᄁ ᅱ ᆫ
차는	ᄎ ᅡ ᄂ ᅳ ᆫ
들판에	ᄃ ᅳ ᆯ ᄑ ᅡ ᄂ ᅦ
버려진	ᄇ ᅥ ᄅ ᅧ ᄌ ᅵ ᆫ
채	ᄎ ᅢ
발견됐다	ᄇ ᅡ ᆯ ᄀ ᅧ ᆫ ᄃ ᅫ ᆮ ᄄ ᅡ
이번	ᄋ ᅵ ᄇ ᅥ ᆫ
달	ᄃ ᅡ ᆯ
초에	ᄎ ᅩ ᄋ ᅦ
상어	ᄉ ᅡ ᆼ ᄋ ᅥ
떼가	ᄄ ᅦ ᄀ ᅡ
해안가에서	ᄒ ᅢ ᄋ ᅡ ᆫ ᄀ ᅡ ᄋ ᅦ ᄉ ᅥ
오타를	ᄋ ᅩ ᄐ ᅡ ᄅ ᅳ ᆯ
발견하시는	ᄇ ᅡ ᆯ ᄀ ᅧ ᆫ ᄒ ᅡ ᄉ ᅵ ᄂ ᅳ ᆫ
분께	ᄇ ᅮ ᆫ ᄁ ᅦ
사례하겠습니다	ᄉ ᅡ ᄅ ᅨ ᄒ ᅡ ᄀ ᅦ ᆮ ᄊ ᅳ ᆷ ᄂ ᅵ ᄃ ᅡ
결국	ᄀ ᅧ ᆯ ᄀ ᅮ ᆨ
그의	ᄀ ᅳ ᄋ ᅴ
개가	ᄀ ᅢ ᄀ ᅡ
시신을	ᄉ ᅵ ᄉ ᅵ ᄂ ᅳ ᆯ
발견했다	ᄇ ᅡ ᆯ ᄀ ᅧ ᆫ ᄒ ᅢ ᆮ ᄄ ᅡ
정신분석학은	ᄌ ᅥ ᆼ ᄉ ᅵ ᆫ ᄇ ᅮ ᆫ ᄉ ᅥ ᄏ ᅡ ᄀ ᅳ ᆫ
이십	ᄋ ᅵ ᄉ ᅵ ᆸ
세기에	ᄉ ᅦ ᄀ ᅵ ᄋ ᅦ
급격히	ᄀ ᅳ ᆸ ᄁ ᅧ ᄏ ᅵ
발전했다	ᄇ ᅡ ᆯ ᄍ ᅥ ᆫ ᄒ ᅢ ᆮ ᄄ ᅡ
한국어	ᄒ ᅡ ᆫ ᄀ ᅮ ᄀ ᅥ
실력이	ᄉ ᅵ ᆯ ᄅ ᅧ ᄀ ᅵ
날이	ᄂ ᅡ ᄅ ᅵ
갈수록	ᄀ ᅡ ᆯ ᄊ ᅮ ᄅ ᅩ ᆨ
발전하는	ᄇ ᅡ ᆯ ᄍ ᅥ ᆫ ᄒ ᅡ ᄂ ᅳ ᆫ
것을	ᄀ ᅥ ᄉ ᅳ ᆯ
보니	ᄇ ᅩ ᄂ ᅵ
기쁩니다	ᄀ ᅵ ᄈ ᅳ ᆷ ᄂ ᅵ ᄃ ᅡ
죄송하지만	ᄌ ᅬ ᄉ ᅩ ᆼ ᄒ ᅡ ᄌ ᅵ ᄆ ᅡ ᆫ
제	ᄌ ᅦ
이름을	ᄋ ᅵ ᄅ ᅳ ᄆ ᅳ ᆯ
밝힐	ᄇ ᅡ ᆯ ᄏ ᅵ ᆯ
수는	ᄉ ᅮ ᄂ ᅳ ᆫ
없어요	ᄋ ᅥ ᆸ ᄊ ᅥ ᄋ ᅭ
정전이	ᄌ ᅥ ᆼ ᄌ ᅥ ᄂ ᅵ
촛불을	ᄎ ᅩ ᆮ ᄈ ᅮ ᄅ ᅳ ᆯ
밝혔다	ᄇ ᅡ ᆯ ᄏ ᅧ ᆮ ᄄ ᅡ
모두가	ᄆ ᅩ ᄃ ᅮ ᄀ ᅡ
통과했음을	ᄐ ᅩ ᆼ ᄀ ᅪ ᄒ ᅢ ᄊ ᅳ ᄆ ᅳ ᆯ
발표하게	ᄇ ᅡ ᆯ ᄑ ᅭ ᄒ ᅡ ᄀ ᅦ
기쁘게	ᄀ ᅵ ᄈ ᅳ ᄀ ᅦ
생각합니다	ᄉ ᅢ ᆼ ᄀ ᅡ ᄏ ᅡ ᆷ ᄂ ᅵ ᄃ ᅡ
밴드는	ᄇ ᅢ ᆫ ᄃ ᅳ ᄂ ᅳ ᆫ
첫	ᄎ ᅥ ᆮ
음반을	ᄋ ᅳ ᆷ ᄇ ᅡ ᄂ ᅳ ᆯ
발표한	ᄇ ᅡ ᆯ ᄑ ᅭ ᄒ ᅡ ᆫ
직후에	ᄌ ᅵ ᄏ ᅮ ᄋ ᅦ
해체했다	ᄒ ᅢ ᄎ ᅦ ᄒ ᅢ ᆮ ᄄ ᅡ
화재가	ᄒ ᅪ ᄌ ᅢ ᄀ ᅡ
발생하지	ᄇ ᅡ ᆯ ᄉ ᅢ ᆼ ᄒ ᅡ ᄌ ᅵ
않도록	ᄋ ᅡ ᆫ ᄐ ᅩ ᄅ ᅩ ᆨ
조심해라	ᄌ ᅩ ᄉ ᅵ ᆷ ᄒ ᅢ ᄅ ᅡ
어제	ᄋ ᅥ ᄌ ᅦ
일본에서	ᄋ ᅵ ᆯ ᄇ ᅩ ᄂ ᅦ ᄉ ᅥ
태풍이	ᄐ ᅢ ᄑ ᅮ ᆼ ᄋ ᅵ
발생했다	ᄇ ᅡ ᆯ ᄉ ᅢ ᆼ ᄒ ᅢ ᆮ ᄄ ᅡ
돌고래는	ᄃ ᅩ ᆯ ᄀ ᅩ ᄅ ᅢ ᄂ ᅳ ᆫ
지능이	ᄌ ᅵ ᄂ ᅳ ᆼ ᄋ ᅵ
발달했다	ᄇ ᅡ ᆯ ᄃ ᅡ ᆯ ᄒ ᅢ ᆮ ᄄ ᅡ
이	ᄋ ᅵ
지역에는	ᄌ ᅵ ᄋ ᅧ ᄀ ᅦ ᄂ ᅳ ᆫ
농업이	ᄂ ᅩ ᆼ ᄋ ᅥ ᄇ ᅵ
발달했어요	ᄇ ᅡ ᆯ ᄃ ᅡ ᆯ ᄒ ᅢ ᄊ ᅥ ᄋ ᅭ
제안에	ᄌ ᅦ ᄋ ᅡ ᄂ ᅦ
반대했다	ᄇ ᅡ ᆫ ᄃ ᅢ ᄒ ᅢ ᆮ ᄄ ᅡ
저는	ᄌ ᅥ ᄂ ᅳ ᆫ
무력	ᄆ ᅮ ᄅ ᅧ ᆨ
사용을	ᄉ ᅡ ᄋ ᅭ ᆼ ᄋ ᅳ ᆯ
반대합니다	ᄇ ᅡ ᆫ ᄃ ᅢ ᄒ ᅡ ᆷ ᄂ ᅵ ᄃ ᅡ
저희	ᄌ ᅥ ᄒ ᅵ
회사에	ᄒ ᅬ ᄉ ᅡ ᄋ ᅦ
방문해	ᄇ ᅡ ᆼ ᄆ ᅮ ᆫ ᄒ ᅢ
주셔서	ᄌ ᅮ ᄉ ᅧ ᄉ ᅥ
감사드립니다	ᄀ ᅡ ᆷ ᄉ ᅡ ᄃ ᅳ ᄅ ᅵ ᆷ ᄂ ᅵ ᄃ ᅡ
너는	ᄂ ᅥ ᄂ ᅳ ᆫ
브레이크를	ᄇ ᅳ ᄅ ᅦ ᄋ ᅵ ᄏ ᅳ ᄅ ᅳ ᆯ
너무	ᄂ ᅥ ᄆ ᅮ
세게	ᄉ ᅦ ᄀ ᅦ
밟아	ᄇ ᅡ ᄇ ᅡ
어떤	ᄋ ᅥ ᄄ ᅥ ᆫ
남자가	ᄂ ᅡ ᆷ ᄌ ᅡ ᄀ ᅡ
지하철에서	ᄌ ᅵ ᄒ ᅡ ᄎ ᅥ ᄅ ᅦ ᄉ ᅥ
발을	ᄇ ᅡ ᄅ ᅳ ᆯ
밟고	ᄇ ᅡ ᆸ ᄁ ᅩ
모른	ᄆ ᅩ ᄅ ᅳ ᆫ
척했다	ᄎ ᅥ ᄏ ᅢ ᆮ ᄄ ᅡ
호기심으로	ᄒ ᅩ ᄀ ᅵ ᄉ ᅵ ᄆ ᅳ ᄅ ᅩ
가득	ᄀ ᅡ ᄃ ᅳ ᆨ
찬	ᄎ ᅡ ᆫ
눈으로	ᄂ ᅮ ᄂ ᅳ ᄅ ᅩ
바라보았다	ᄇ ᅡ ᄅ ᅡ ᄇ ᅩ ᄋ ᅡ ᆮ ᄄ ᅡ
문제는	ᄆ ᅮ ᆫ ᄌ ᅦ ᄂ ᅳ ᆫ
삼	ᄉ ᅡ ᆷ
자의	ᄌ ᅡ ᄋ ᅴ
시각에서	ᄉ ᅵ ᄀ ᅡ ᄀ ᅦ ᄉ ᅥ
바라볼	ᄇ ᅡ ᄅ ᅡ ᄇ ᅩ ᆯ
필요가	ᄑ ᅵ ᄅ ᅭ ᄀ ᅡ
있어	ᄋ ᅵ ᄊ ᅥ
저한테	ᄌ ᅥ ᄒ ᅡ ᆫ ᄐ ᅦ
많은	ᄆ ᅡ ᄂ ᅳ ᆫ
걸	ᄀ ᅥ ᆯ
바라지	ᄇ ᅡ ᄅ ᅡ ᄌ ᅵ
마세요	ᄆ ᅡ ᄉ ᅦ ᄋ ᅭ
빨리	ᄈ ᅡ ᆯ ᄅ ᅵ
나으시길	ᄂ ᅡ ᄋ ᅳ ᄉ ᅵ ᄀ ᅵ ᆯ
바랍니다	ᄇ ᅡ ᄅ ᅡ ᆷ ᄂ ᅵ ᄃ ᅡ
입술에	ᄋ ᅵ ᆸ ᄊ ᅮ ᄅ ᅦ
침이나	ᄎ ᅵ ᄆ ᅵ ᄂ ᅡ
바르고	ᄇ ᅡ ᄅ ᅳ ᄀ ᅩ
말해	ᄆ ᅡ ᆯ ᄒ ᅢ
선크림을	ᄉ ᅥ ᆫ ᄏ ᅳ ᄅ ᅵ ᄆ ᅳ ᆯ
발랐어야지	ᄇ ᅡ ᆯ ᄅ ᅡ ᄊ ᅥ ᄋ ᅣ ᄌ ᅵ
생일	ᄉ ᅢ ᆼ ᄋ ᅵ ᆯ
선물로	ᄉ ᅥ ᆫ ᄆ ᅮ ᆯ ᄅ ᅩ
책을	ᄎ ᅢ ᄀ ᅳ ᆯ
받았다	ᄇ ᅡ ᄃ ᅡ ᆮ ᄄ ᅡ
신용	ᄉ ᅵ ᄂ ᅭ ᆼ
카드를	ᄏ ᅡ ᄃ ᅳ ᄅ ᅳ ᆯ
받나	ᄇ ᅡ ᆫ ᄂ ᅡ
요	ᄋ ᅭ
스트레스	ᄉ ᅳ ᄐ ᅳ ᄅ ᅦ ᄉ ᅳ
받는	ᄇ ᅡ ᆫ ᄂ ᅳ ᆫ
일	ᄋ ᅵ ᆯ
어떻게	ᄋ ᅥ ᄄ ᅥ ᄏ ᅦ
그렇게	ᄀ ᅳ ᄅ ᅥ ᄏ ᅦ
버셨어요	ᄇ ᅥ ᄉ ᅧ ᄊ ᅥ ᄋ ᅭ
달에	ᄃ ᅡ ᄅ ᅦ
삼백만	ᄉ ᅡ ᆷ ᄇ ᅢ ᆼ ᄆ ᅡ ᆫ
원을	ᄋ ᅯ ᄂ ᅳ ᆯ
법니다	ᄇ ᅥ ᆷ ᄂ ᅵ ᄃ ᅡ
입을	ᄋ ᅵ ᄇ ᅳ ᆯ
벌려	ᄇ ᅥ ᆯ ᄅ ᅧ
보세요	ᄇ ᅩ ᄉ ᅦ ᄋ ᅭ
다리를	ᄃ ᅡ ᄅ ᅵ ᄅ ᅳ ᆯ
벌리고	ᄇ ᅥ ᆯ ᄅ ᅵ ᄀ ᅩ
앉지	ᄋ ᅡ ᆫ ᄍ ᅵ
마라	ᄆ ᅡ ᄅ ᅡ
벽	ᄇ ᅧ ᆨ
사이에	ᄉ ᅡ ᄋ ᅵ ᄋ ᅦ
벌어진	ᄇ ᅥ ᄅ ᅥ ᄌ ᅵ ᆫ
틈이	ᄐ ᅳ ᄆ ᅵ
법안을	ᄇ ᅥ ᄇ ᅡ ᄂ ᅳ ᆯ
놓고	ᄂ ᅩ ᄏ ᅩ
말다툼이	ᄆ ᅡ ᆯ ᄃ ᅡ ᄐ ᅮ ᄆ ᅵ
벌어졌어	ᄇ ᅥ ᄅ ᅥ ᄌ ᅥ ᄊ ᅥ
담배	ᄃ ᅡ ᆷ ᄇ ᅢ
꽁초를	ᄁ ᅩ ᆼ ᄎ ᅩ ᄅ ᅳ ᆯ
여기에	ᄋ ᅧ ᄀ ᅵ ᄋ ᅦ
버리지	ᄇ ᅥ ᄅ ᅵ ᄌ ᅵ
다	ᄃ ᅡ
써	ᄊ ᅥ
버렸어요	ᄇ ᅥ ᄅ ᅧ ᄊ ᅥ ᄋ ᅭ
내년	ᄂ ᅢ ᄂ ᅧ ᆫ
아버지	ᄋ ᅡ ᄇ ᅥ ᄌ ᅵ
환갑	ᄒ ᅪ ᆫ ᄀ ᅡ ᆸ
때	ᄄ ᅢ
잔치를	ᄌ ᅡ ᆫ ᄎ ᅵ ᄅ ᅳ ᆯ
벌일	ᄇ ᅥ ᄅ ᅵ ᆯ
오늘	ᄋ ᅩ ᄂ ᅳ ᆯ
아침	ᄋ ᅡ ᄎ ᅵ ᆷ
아내랑	ᄋ ᅡ ᄂ ᅢ ᄅ ᅡ ᆼ
말다툼을	ᄆ ᅡ ᆯ ᄃ ᅡ ᄐ ᅮ ᄆ ᅳ ᆯ
벌였어	ᄇ ᅥ ᄅ ᅧ ᄊ ᅥ
가난에서	ᄀ ᅡ ᄂ ᅡ ᄂ ᅦ ᄉ ᅥ
벗어나려면	ᄇ ᅥ ᄉ ᅥ ᄂ ᅡ ᄅ ᅧ ᄆ ᅧ ᆫ
습관부터	ᄉ ᅳ ᆸ ᄁ ᅪ ᆫ ᄇ ᅮ ᄐ ᅥ
바꿔라	ᄇ ᅡ ᄁ ᅯ ᄅ ᅡ
복잡한	ᄇ ᅩ ᆨ ᄍ ᅡ ᄑ ᅡ ᆫ
도시	ᄃ ᅩ ᄉ ᅵ
지역을	ᄌ ᅵ ᄋ ᅧ ᄀ ᅳ ᆯ
벗어나니	ᄇ ᅥ ᄉ ᅥ ᄂ ᅡ ᄂ ᅵ
참	ᄎ ᅡ ᆷ
좋군요	ᄌ ᅩ ᄏ ᅮ ᄂ ᅭ
외투	ᄋ ᅬ ᄐ ᅮ
벗으실래요	ᄇ ᅥ ᄉ ᅳ ᄉ ᅵ ᆯ ᄅ ᅢ ᄋ ᅭ
신발이	ᄉ ᅵ ᆫ ᄇ ᅡ ᄅ ᅵ
꽉	ᄁ ᅪ ᆨ
껴서	ᄁ ᅧ ᄉ ᅥ
벗을	ᄇ ᅥ ᄉ ᅳ ᆯ
수가	ᄉ ᅮ ᄀ ᅡ
햇빛이	ᄒ ᅢ ᆮ ᄈ ᅵ ᄎ ᅵ
비치는	ᄇ ᅵ ᄎ ᅵ ᄂ ᅳ ᆫ
상쾌하군	ᄉ ᅡ ᆼ ᄏ ᅫ ᄒ ᅡ ᄀ ᅮ ᆫ
커튼	ᄏ ᅥ ᄐ ᅳ ᆫ
너머에	ᄂ ᅥ ᄆ ᅥ ᄋ ᅦ
누군가의	ᄂ ᅮ ᄀ ᅮ ᆫ ᄀ ᅡ ᄋ ᅴ
그림자가	ᄀ ᅳ ᄅ ᅵ ᆷ ᄌ ᅡ ᄀ ᅡ
비쳤다	ᄇ ᅵ ᄎ ᅥ ᆮ ᄄ ᅡ
램프가	ᄅ ᅢ ᆷ ᄑ ᅳ ᄀ ᅡ
작품을	ᄌ ᅡ ᆨ ᄑ ᅮ ᄆ ᅳ ᆯ
비추게	ᄇ ᅵ ᄎ ᅮ ᄀ ᅦ
배치되어	ᄇ ᅢ ᄎ ᅵ ᄃ ᅬ ᄋ ᅥ
있었다	ᄋ ᅵ ᄊ ᅥ ᆮ ᄄ ᅡ
아침마다	ᄋ ᅡ ᄎ ᅵ ᆷ ᄆ ᅡ ᄃ ᅡ
얼굴을	ᄋ ᅥ ᆯ ᄀ ᅮ ᄅ ᅳ ᆯ
거울에	ᄀ ᅥ ᄋ ᅮ ᄅ ᅦ
비춰	ᄇ ᅵ ᄎ ᅯ
봐요	ᄇ ᅪ ᄋ ᅭ
금고는	ᄀ ᅳ ᆷ ᄀ ᅩ ᄂ ᅳ ᆫ
이미	ᄋ ᅵ ᄆ ᅵ
비어	ᄇ ᅵ ᄋ ᅥ
자리는	ᄌ ᅡ ᄅ ᅵ ᄂ ᅳ ᆫ
비었습니까	ᄇ ᅵ ᄋ ᅥ ᆮ ᄊ ᅳ ᆷ ᄂ ᅵ ᄁ ᅡ
우리는	ᄋ ᅮ ᄅ ᅵ ᄂ ᅳ ᆫ
서로	ᄉ ᅥ ᄅ ᅩ
답을	ᄃ ᅡ ᄇ ᅳ ᆯ
비교해	ᄇ ᅵ ᄀ ᅭ ᄒ ᅢ
보았다	ᄇ ᅩ ᄋ ᅡ ᆮ ᄄ ᅡ
부모가	ᄇ ᅮ ᄆ ᅩ ᄀ ᅡ
저지르는	ᄌ ᅥ ᄌ ᅵ ᄅ ᅳ ᄂ ᅳ ᆫ
큰	ᄏ ᅳ ᆫ
실수	ᄉ ᅵ ᆯ ᄉ ᅮ
중	ᄌ ᅮ ᆼ
하나는	ᄒ ᅡ ᄂ ᅡ ᄂ ᅳ ᆫ
자기	ᄌ ᅡ ᄀ ᅵ
아이를	ᄋ ᅡ ᄋ ᅵ ᄅ ᅳ ᆯ
집	ᄌ ᅵ ᆸ
아이와	ᄋ ᅡ ᄋ ᅵ ᄋ ᅪ
비교하는	ᄇ ᅵ ᄀ ᅭ ᄒ ᅡ ᄂ ᅳ ᆫ
것이	ᄀ ᅥ ᄉ ᅵ
이틀	ᄋ ᅵ ᄐ ᅳ ᆯ
차를	ᄎ ᅡ ᄅ ᅳ ᆯ
빌리고	ᄇ ᅵ ᆯ ᄅ ᅵ ᄀ ᅩ
싶은데요	ᄉ ᅵ ᄑ ᅳ ᆫ ᄃ ᅦ ᄋ ᅭ
아내에게서	ᄋ ᅡ ᄂ ᅢ ᄋ ᅦ ᄀ ᅦ ᄉ ᅥ
빌린다는	ᄇ ᅵ ᆯ ᄅ ᅵ ᆫ ᄃ ᅡ ᄂ ᅳ ᆫ
것은	ᄀ ᅥ ᄉ ᅳ ᆫ
이상해요	ᄋ ᅵ ᄉ ᅡ ᆼ ᄒ ᅢ ᄋ ᅭ
다이아몬드가	ᄃ ᅡ ᄋ ᅵ ᄋ ᅡ ᄆ ᅩ ᆫ ᄃ ᅳ ᄀ ᅡ
눈부시게	ᄂ ᅮ ᆫ ᄇ ᅮ ᄉ ᅵ ᄀ ᅦ
빛나고	ᄇ ᅵ ᆫ ᄂ ᅡ ᄀ ᅩ
모든	ᄆ ᅩ ᄃ ᅳ ᆫ
창에서	ᄎ ᅡ ᆼ ᄋ ᅦ ᄉ ᅥ
촛불이	ᄎ ᅩ ᆮ ᄈ ᅮ ᄅ ᅵ
반짝반짝	ᄇ ᅡ ᆫ ᄍ ᅡ ᆨ ᄈ ᅡ ᆫ ᄍ ᅡ ᆨ
영화	ᄋ ᅧ ᆼ ᄒ ᅪ
보러	ᄇ ᅩ ᄅ ᅥ
갈까	ᄀ ᅡ ᆯ ᄁ ᅡ
우연히	ᄋ ᅮ ᄋ ᅧ ᆫ ᄒ ᅵ
길에서	ᄀ ᅵ ᄅ ᅦ ᄉ ᅥ
여자를	ᄋ ᅧ ᄌ ᅡ ᄅ ᅳ ᆯ
봤어요	ᄇ ᅪ ᄊ ᅥ ᄋ ᅭ
제가	ᄌ ᅦ ᄀ ᅡ
해	ᄒ ᅢ
볼게요	ᄇ ᅩ ᆯ ᄀ ᅦ ᄋ ᅭ
어디선가	ᄋ ᅥ ᄃ ᅵ ᄉ ᅥ ᆫ ᄀ ᅡ
뵌	ᄇ ᅬ ᆫ
분	ᄇ ᅮ ᆫ
같아요	ᄀ ᅡ ᄐ ᅡ ᄋ ᅭ
지난번에	ᄌ ᅵ ᄂ ᅡ ᆫ ᄇ ᅥ ᄂ ᅦ
후	ᄒ ᅮ
오랜만에	ᄋ ᅩ ᄅ ᅢ ᆫ ᄆ ᅡ ᄂ ᅦ
뵙습니다	ᄇ ᅬ ᆸ ᄊ ᅳ ᆷ ᄂ ᅵ ᄃ ᅡ
그거	ᄀ ᅳ ᄀ ᅥ
맛있어	ᄆ ᅡ ᄉ ᅵ ᄊ ᅥ
보이네	ᄇ ᅩ ᄋ ᅵ ᄂ ᅦ
나이에	ᄂ ᅡ ᄋ ᅵ ᄋ ᅦ
비해	ᄇ ᅵ ᄒ ᅢ
정말	ᄌ ᅥ ᆼ ᄆ ᅡ ᆯ
젊어	ᄌ ᅥ ᆯ ᄆ ᅥ
보인다	ᄇ ᅩ ᄋ ᅵ ᆫ ᄃ ᅡ
그녀가	ᄀ ᅳ ᄂ ᅧ ᄀ ᅡ
나에게	ᄂ ᅡ ᄋ ᅦ ᄀ ᅦ
사진	ᄉ ᅡ ᄌ ᅵ ᆫ
몇	ᄆ ᅧ ᆮ
장을	ᄌ ᅡ ᆼ ᄋ ᅳ ᆯ
보여	ᄇ ᅩ ᄋ ᅧ
주민등록증을	ᄌ ᅮ ᄆ ᅵ ᆫ ᄃ ᅳ ᆼ ᄂ ᅩ ᆨ ᄍ ᅳ ᆼ ᄋ ᅳ ᆯ
주시겠어요	ᄌ ᅮ ᄉ ᅵ ᄀ ᅦ ᄊ ᅥ ᄋ ᅭ
김치가	ᄀ ᅵ ᆷ ᄎ ᅵ ᄀ ᅡ
맛이	ᄆ ᅡ ᄉ ᅵ
없어서	ᄋ ᅥ ᆸ ᄊ ᅥ ᄉ ᅥ
볶았어	ᄇ ᅩ ᄁ ᅡ ᄊ ᅥ
고기를	ᄀ ᅩ ᄀ ᅵ ᄅ ᅳ ᆯ
기름에	ᄀ ᅵ ᄅ ᅳ ᄆ ᅦ
볶지	ᄇ ᅩ ᆨ ᄍ ᅵ
소포를	ᄉ ᅩ ᄑ ᅩ ᄅ ᅳ ᆯ
뉴욕으로	ᄂ ᅲ ᄋ ᅭ ᄀ ᅳ ᄅ ᅩ
보내고	ᄇ ᅩ ᄂ ᅢ ᄀ ᅩ
선생님께	ᄉ ᅥ ᆫ ᄉ ᅢ ᆼ ᄂ ᅵ ᆷ ᄁ ᅦ
부	ᄇ ᅮ
보내	ᄇ ᅩ ᄂ ᅢ
드리겠습니다	ᄃ ᅳ ᄅ ᅵ ᄀ ᅦ ᆮ ᄊ ᅳ ᆷ ᄂ ᅵ ᄃ ᅡ
휴가	ᄒ ᅲ ᄀ ᅡ
보내세요	ᄇ ᅩ ᄂ ᅢ ᄉ ᅦ ᄋ ᅭ
짐	ᄌ ᅵ ᆷ
하나하나에	ᄒ ᅡ ᄂ ᅡ ᄒ ᅡ ᄂ ᅡ ᄋ ᅦ
이름표를	ᄋ ᅵ ᄅ ᅳ ᆷ ᄑ ᅭ ᄅ ᅳ ᆯ
붙였다	ᄇ ᅮ ᄎ ᅧ ᆮ ᄄ ᅡ
침으로	ᄎ ᅵ ᄆ ᅳ ᄅ ᅩ
편지	ᄑ ᅧ ᆫ ᄌ ᅵ
봉투에	ᄇ ᅩ ᆼ ᄐ ᅮ ᄋ ᅦ
우표를	ᄋ ᅮ ᄑ ᅭ ᄅ ᅳ ᆯ
붙이지	ᄇ ᅮ ᄎ ᅵ ᄌ ᅵ
파티	ᄑ ᅡ ᄐ ᅵ
준비를	ᄌ ᅮ ᆫ ᄇ ᅵ ᄅ ᅳ ᆯ
풍선을	ᄑ ᅮ ᆼ ᄉ ᅥ ᄂ ᅳ ᆯ
불었다	ᄇ ᅮ ᄅ ᅥ ᆮ ᄄ ᅡ
바람이	ᄇ ᅡ ᄅ ᅡ ᄆ ᅵ
불어	ᄇ ᅮ ᄅ ᅥ
경찰	ᄀ ᅧ ᆼ ᄎ ᅡ ᆯ
불러	ᄇ ᅮ ᆯ ᄅ ᅥ
사람들은	ᄉ ᅡ ᄅ ᅡ ᆷ ᄃ ᅳ ᄅ ᅳ ᆫ
그를	ᄀ ᅳ ᄅ ᅳ ᆯ
게으른	ᄀ ᅦ ᄋ ᅳ ᄅ ᅳ ᆫ
천재라고	ᄎ ᅥ ᆫ ᄌ ᅢ ᄅ ᅡ ᄀ ᅩ
부른다	ᄇ ᅮ ᄅ ᅳ ᆫ ᄃ ᅡ
노래	ᄂ ᅩ ᄅ ᅢ
곡	ᄀ ᅩ ᆨ
부르세요	ᄇ ᅮ ᄅ ᅳ ᄉ ᅦ ᄋ ᅭ
여행사에	ᄋ ᅧ ᄒ ᅢ ᆼ ᄉ ᅡ ᄋ ᅦ
예약을	ᄋ ᅨ ᄋ ᅣ ᄀ ᅳ ᆯ
부탁하는	ᄇ ᅮ ᄐ ᅡ ᄏ ᅡ ᄂ ᅳ ᆫ
어때	ᄋ ᅥ ᄄ ᅢ
엄마한테	ᄋ ᅥ ᆷ ᄆ ᅡ ᄒ ᅡ ᆫ ᄐ ᅦ
도와달라고	ᄃ ᅩ ᄋ ᅪ ᄃ ᅡ ᆯ ᄅ ᅡ ᄀ ᅩ
부탁해	ᄇ ᅮ ᄐ ᅡ ᄏ ᅢ
봐	ᄇ ᅪ
냄비에	ᄂ ᅢ ᆷ ᄇ ᅵ ᄋ ᅦ
물을	ᄆ ᅮ ᄅ ᅳ ᆯ
부어라	ᄇ ᅮ ᄋ ᅥ ᄅ ᅡ
우유를	ᄋ ᅮ ᄋ ᅲ ᄅ ᅳ ᆯ
부어	ᄇ ᅮ ᄋ ᅥ
신발	ᄉ ᅵ ᆫ ᄇ ᅡ ᆯ
밑창에	ᄆ ᅵ ᆮ ᄎ ᅡ ᆼ ᄋ ᅦ
껌이	ᄁ ᅥ ᄆ ᅵ
붙었다	ᄇ ᅮ ᄐ ᅥ ᆮ ᄄ ᅡ
운전면허	ᄋ ᅮ ᆫ ᄌ ᅥ ᆫ ᄆ ᅧ ᆫ ᄒ ᅥ
세	ᄉ ᅦ
번	ᄇ ᅥ ᆫ
만에	ᄆ ᅡ ᄂ ᅦ
붙었어요	ᄇ ᅮ ᄐ ᅥ ᄊ ᅥ ᄋ ᅭ
밤이	ᄇ ᅡ ᄆ ᅵ
되면	ᄃ ᅬ ᄆ ᅧ ᆫ
괴물로	ᄀ ᅬ ᄆ ᅮ ᆯ ᄅ ᅩ
변한다	ᄇ ᅧ ᆫ ᄒ ᅡ ᆫ ᄃ ᅡ
전혀	ᄌ ᅥ ᆫ ᄒ ᅧ
변하셨네요	ᄇ ᅧ ᆫ ᄒ ᅡ ᄉ ᅧ ᆫ ᄂ ᅦ ᄋ ᅭ
점차	ᄌ ᅥ ᆷ ᄎ ᅡ
냉혹한	ᄂ ᅢ ᆼ ᄒ ᅩ ᄏ ᅡ ᆫ
지도자로	ᄌ ᅵ ᄃ ᅩ ᄌ ᅡ ᄅ ᅩ
변화했다	ᄇ ᅧ ᆫ ᄒ ᅪ ᄒ ᅢ ᆮ ᄄ ᅡ
지구가	ᄌ ᅵ ᄀ ᅮ ᄀ ᅡ
빠르게	ᄈ ᅡ ᄅ ᅳ ᄀ ᅦ
변화하고	ᄇ ᅧ ᆫ ᄒ ᅪ ᄒ ᅡ ᄀ ᅩ
공을	ᄀ ᅩ ᆼ ᄋ ᅳ ᆯ
척하면서	ᄎ ᅥ ᄏ ᅡ ᄆ ᅧ ᆫ ᄉ ᅥ
상대	ᄉ ᅡ ᆼ ᄃ ᅢ
선수를	ᄉ ᅥ ᆫ ᄉ ᅮ ᄅ ᅳ ᆯ
찼다	ᄎ ᅡ ᆮ ᄄ ᅡ
칠	ᄎ ᅵ ᆯ
년간	ᄂ ᅧ ᆫ ᄀ ᅡ ᆫ
사귄	ᄉ ᅡ ᄀ ᅱ ᆫ
남자	ᄂ ᅡ ᆷ ᄌ ᅡ
친구를	ᄎ ᅵ ᆫ ᄀ ᅮ ᄅ ᅳ ᆯ
차	ᄎ ᅡ
버리고	ᄇ ᅥ ᄅ ᅵ ᄀ ᅩ
딴	ᄄ ᅡ ᆫ
남자랑	ᄂ ᅡ ᆷ ᄌ ᅡ ᄅ ᅡ ᆼ
결혼했다	ᄀ ᅧ ᆯ ᄒ ᅩ ᆫ ᄒ ᅢ ᆮ ᄄ ᅡ
소지품을	ᄉ ᅩ ᄌ ᅵ ᄑ ᅮ ᄆ ᅳ ᆯ
챙기세요	ᄎ ᅢ ᆼ ᄀ ᅵ ᄉ ᅦ ᄋ ᅭ
아빠를	ᄋ ᅡ ᄈ ᅡ ᄅ ᅳ ᆯ
엄청	ᄋ ᅥ ᆷ ᄎ ᅥ ᆼ
챙기신다	ᄎ ᅢ ᆼ ᄀ ᅵ ᄉ ᅵ ᆫ ᄃ ᅡ
빈	ᄇ ᅵ ᆫ
칸을	ᄏ ᅡ ᄂ ᅳ ᆯ
채우시오	ᄎ ᅢ ᄋ ᅮ ᄉ ᅵ ᄋ ᅩ
기름을	ᄀ ᅵ ᄅ ᅳ ᄆ ᅳ ᆯ
채워	ᄎ ᅢ ᄋ ᅯ
잔에는	ᄌ ᅡ ᄂ ᅦ ᄂ ᅳ ᆫ
반만	ᄇ ᅡ ᆫ ᄆ ᅡ ᆫ
인터넷	ᄋ ᅵ ᆫ ᄐ ᅥ ᄂ ᅦ ᆮ
찾아봤어	ᄎ ᅡ ᄌ ᅡ ᄇ ᅪ ᄊ ᅥ
찾아봤지만	ᄎ ᅡ ᄌ ᅡ ᄇ ᅪ ᆮ ᄍ ᅵ ᄆ ᅡ ᆫ
찾을	ᄎ ᅡ ᄌ ᅳ ᆯ
내일	ᄂ ᅢ ᄋ ᅵ ᆯ
댁으로	ᄃ ᅢ ᄀ ᅳ ᄅ ᅩ
찾아가겠습니다	ᄎ ᅡ ᄌ ᅡ ᄀ ᅡ ᄀ ᅦ ᆮ ᄊ ᅳ ᆷ ᄂ ᅵ ᄃ ᅡ
내일까지	ᄂ ᅢ ᄋ ᅵ ᆯ ᄁ ᅡ ᄌ ᅵ
짐을	ᄌ ᅵ ᄆ ᅳ ᆯ
찾아가셔야	ᄎ ᅡ ᄌ ᅡ ᄀ ᅡ ᄉ ᅧ ᄋ ᅣ
해요	ᄒ ᅢ ᄋ ᅭ
도움이	ᄃ ᅩ ᄋ ᅮ ᄆ ᅵ
필요하면	ᄑ ᅵ ᄅ ᅭ ᄒ ᅡ ᄆ ᅧ ᆫ
찾아와	ᄎ ᅡ ᄌ ᅡ ᄋ ᅪ
은행에서	ᄋ ᅳ ᆫ ᄒ ᅢ ᆼ ᄋ ᅦ ᄉ ᅥ
돈	ᄃ ᅩ ᆫ
찾아와야	ᄎ ᅡ ᄌ ᅡ ᄋ ᅪ ᄋ ᅣ
배우들이	ᄇ ᅢ ᄋ ᅮ ᄃ ᅳ ᄅ ᅵ
시상식에	ᄉ ᅵ ᄉ ᅡ ᆼ ᄉ ᅵ ᄀ ᅦ
참석하지	ᄎ ᅡ ᆷ ᄉ ᅥ ᄏ ᅡ ᄌ ᅵ
않았다	ᄋ ᅡ ᄂ ᅡ ᆮ ᄄ ᅡ
갑자기	ᄀ ᅡ ᆸ ᄍ ᅡ ᄀ ᅵ
시부모님이	ᄉ ᅵ ᄇ ᅮ ᄆ ᅩ ᄂ ᅵ ᄆ ᅵ
오셔서	ᄋ ᅩ ᄉ ᅧ ᄉ ᅥ
모임에	ᄆ ᅩ ᄋ ᅵ ᄆ ᅦ
못했어요	ᄆ ᅩ ᄐ ᅢ ᄊ ᅥ ᄋ ᅭ
웃음을	ᄋ ᅮ ᄉ ᅳ ᄆ ᅳ ᆯ
참을	ᄎ ᅡ ᄆ ᅳ ᆯ
없었어요	ᄋ ᅥ ᆸ ᄊ ᅥ ᄊ ᅥ ᄋ ᅭ
더	ᄃ ᅥ
이상은	ᄋ ᅵ ᄉ ᅡ ᆼ ᄋ ᅳ ᆫ
못	ᄆ ᅩ ᆮ
참아	ᄎ ᅡ ᄆ ᅡ
엄마랑	ᄋ ᅥ ᆷ ᄆ ᅡ ᄅ ᅡ ᆼ
아빠는	ᄋ ᅡ ᄈ ᅡ ᄂ ᅳ ᆫ
항상	ᄒ ᅡ ᆼ ᄉ ᅡ ᆼ
같이	ᄀ ᅡ ᄎ ᅵ
상을	ᄉ ᅡ ᆼ ᄋ ᅳ ᆯ
차리세요	ᄎ ᅡ ᄅ ᅵ ᄉ ᅦ ᄋ ᅭ
얼른	ᄋ ᅥ ᆯ ᄅ ᅳ ᆫ
기운	ᄀ ᅵ ᄋ ᅮ ᆫ
차리셔야죠	ᄎ ᅡ ᄅ ᅵ ᄉ ᅧ ᄋ ᅣ ᄌ ᅭ
교차로에서	ᄀ ᅭ ᄎ ᅡ ᄅ ᅩ ᄋ ᅦ ᄉ ᅥ
저를	ᄌ ᅥ ᄅ ᅳ ᆯ
거예요	ᄀ ᅥ ᄋ ᅨ ᄋ ᅭ
찾고	ᄎ ᅡ ᆮ ᄁ ᅩ
있어요	ᄋ ᅵ ᄊ ᅥ ᄋ ᅭ
아기는	ᄋ ᅡ ᄀ ᅵ ᄂ ᅳ ᆫ
소리가	ᄉ ᅩ ᄅ ᅵ ᄀ ᅡ
쪽을	ᄍ ᅩ ᄀ ᅳ ᆯ
쳐다본다	ᄎ ᅥ ᄃ ᅡ ᄇ ᅩ ᆫ ᄃ ᅡ
그런	ᄀ ᅳ ᄅ ᅥ ᆫ
식으로	ᄉ ᅵ ᄀ ᅳ ᄅ ᅩ
사람을	ᄉ ᅡ ᄅ ᅡ ᄆ ᅳ ᆯ
빤히	ᄈ ᅡ ᆫ ᄒ ᅵ
쳐다보지	ᄎ ᅥ ᄃ ᅡ ᄇ ᅩ ᄌ ᅵ
마	ᄆ ᅡ
년에	ᄂ ᅧ ᄂ ᅦ
우리	ᄋ ᅮ ᄅ ᅵ
화장실을	ᄒ ᅪ ᄌ ᅡ ᆼ ᄉ ᅵ ᄅ ᅳ ᆯ
청소한다	ᄎ ᅥ ᆼ ᄉ ᅩ ᄒ ᅡ ᆫ ᄃ ᅡ
창문은	ᄎ ᅡ ᆼ ᄆ ᅮ ᄂ ᅳ ᆫ
뭘로	ᄆ ᅯ ᆯ ᄅ ᅩ
청소하나요	ᄎ ᅥ ᆼ ᄉ ᅩ ᄒ ᅡ ᄂ ᅡ ᄋ ᅭ
쳐서	ᄎ ᅥ ᄉ ᅥ
손목을	ᄉ ᅩ ᆫ ᄆ ᅩ ᄀ ᅳ ᆯ
삐었다	ᄈ ᅵ ᄋ ᅥ ᆮ ᄄ ᅡ
테니스를	ᄐ ᅦ ᄂ ᅵ ᄉ ᅳ ᄅ ᅳ ᆯ
치다가	ᄎ ᅵ ᄃ ᅡ ᄀ ᅡ
발목을	ᄇ ᅡ ᆯ ᄆ ᅩ ᄀ ᅳ ᆯ
삐었어요	ᄈ ᅵ ᄋ ᅥ ᄊ ᅥ ᄋ ᅭ
시험	ᄉ ᅵ ᄒ ᅥ ᆷ
쳤어요	ᄎ ᅥ ᄊ ᅥ ᄋ ᅭ
주말	ᄌ ᅮ ᄆ ᅡ ᆯ
생일에	ᄉ ᅢ ᆼ ᄋ ᅵ ᄅ ᅦ
너를	ᄂ ᅥ ᄅ ᅳ ᆯ
초대하고	ᄎ ᅩ ᄃ ᅢ ᄒ ᅡ ᄀ ᅩ
싶은데	ᄉ ᅵ ᄑ ᅳ ᆫ ᄃ ᅦ
집으로	ᄌ ᅵ ᄇ ᅳ ᄅ ᅩ
초대했다	ᄎ ᅩ ᄃ ᅢ ᄒ ᅢ ᆮ ᄄ ᅡ
낯선	ᄂ ᅡ ᆮ ᄊ ᅥ ᆫ
사람들	ᄉ ᅡ ᄅ ᅡ ᆷ ᄃ ᅳ ᆯ
앞에서	ᄋ ᅡ ᄑ ᅦ ᄉ ᅥ
춤을	ᄎ ᅮ ᄆ ᅳ ᆯ
추는	ᄎ ᅮ ᄂ ᅳ ᆫ
건	ᄀ ᅥ ᆫ
나한테는	ᄂ ᅡ ᄒ ᅡ ᆫ ᄐ ᅦ ᄂ ᅳ ᆫ
어려운	ᄋ ᅥ ᄅ ᅧ ᄋ ᅮ ᆫ
일이야	ᄋ ᅵ ᄅ ᅵ ᄋ ᅣ
그녀와	ᄀ ᅳ ᄂ ᅧ ᄋ ᅪ
음악에	ᄋ ᅳ ᄆ ᅡ ᄀ ᅦ
맞추어	ᄆ ᅡ ᆮ ᄎ ᅮ ᄋ ᅥ
탱고를	ᄐ ᅢ ᆼ ᄀ ᅩ ᄅ ᅳ ᆯ
췄다	ᄎ ᅯ ᆮ ᄄ ᅡ
결혼	ᄀ ᅧ ᆯ ᄒ ᅩ ᆫ
축하해	ᄎ ᅮ ᄏ ᅡ ᄒ ᅢ
할아버지의	ᄒ ᅡ ᄅ ᅡ ᄇ ᅥ ᄌ ᅵ ᄋ ᅴ
회갑을	ᄒ ᅬ ᄀ ᅡ ᄇ ᅳ ᆯ
축하하는	ᄎ ᅮ ᄏ ᅡ ᄒ ᅡ ᄂ ᅳ ᆫ
열었다	ᄋ ᅧ ᄅ ᅥ ᆮ ᄄ ᅡ
사람은	ᄉ ᅡ ᄅ ᅡ ᄆ ᅳ ᆫ
시간	ᄉ ᅵ ᄀ ᅡ ᆫ
전에	ᄌ ᅥ ᄂ ᅦ
역으로	ᄋ ᅧ ᄀ ᅳ ᄅ ᅩ
출발했어요	ᄎ ᅮ ᆯ ᄇ ᅡ ᆯ ᄒ ᅢ ᄊ ᅥ ᄋ ᅭ
역에서	ᄋ ᅧ ᄀ ᅦ ᄉ ᅥ
출발하는	ᄎ ᅮ ᆯ ᄇ ᅡ ᆯ ᄒ ᅡ ᄂ ᅳ ᆫ
사람	ᄉ ᅡ ᄅ ᅡ ᆷ
중에는	ᄌ ᅮ ᆼ ᄋ ᅦ ᄂ ᅳ ᆫ
군인이	ᄀ ᅮ ᄂ ᅵ ᄂ ᅵ
많아	ᄆ ᅡ ᄂ ᅡ
기차는	ᄀ ᅵ ᄎ ᅡ ᄂ ᅳ ᆫ
부산을	ᄇ ᅮ ᄉ ᅡ ᄂ ᅳ ᆯ
시에	ᄉ ᅵ ᄋ ᅦ
출발합니다	ᄎ ᅮ ᆯ ᄇ ᅡ ᆯ ᄒ ᅡ ᆷ ᄂ ᅵ ᄃ ᅡ
지금	ᄌ ᅵ ᄀ ᅳ ᆷ
춤출	ᄎ ᅮ ᆷ ᄎ ᅮ ᆯ
기분이	ᄀ ᅵ ᄇ ᅮ ᄂ ᅵ
아냐	ᄋ ᅡ ᄂ ᅣ
밤에	ᄇ ᅡ ᄆ ᅦ
춤추러	ᄎ ᅮ ᆷ ᄎ ᅮ ᄅ ᅥ
갈까요	ᄀ ᅡ ᆯ ᄁ ᅡ ᄋ ᅭ
소주	ᄉ ᅩ ᄌ ᅮ
다섯	ᄃ ᅡ ᄉ ᅥ ᆮ
병에	ᄇ ᅧ ᆼ ᄋ ᅦ
취하고	ᄎ ᅱ ᄒ ᅡ ᄀ ᅩ
말았다	ᄆ ᅡ ᄅ ᅡ ᆮ ᄄ ᅡ
나	ᄂ ᅡ
취했어	ᄎ ᅱ ᄒ ᅢ ᄊ ᅥ
말	ᄆ ᅡ ᆯ
취소하겠어요	ᄎ ᅱ ᄉ ᅩ ᄒ ᅡ ᄀ ᅦ ᄊ ᅥ ᄋ ᅭ
취소하고	ᄎ ᅱ ᄉ ᅩ ᄒ ᅡ ᄀ ᅩ
싶어요	ᄉ ᅵ ᄑ ᅥ ᄋ ᅭ
농구를	ᄂ ᅩ ᆼ ᄀ ᅮ ᄅ ᅳ ᆯ
하다	ᄒ ᅡ ᄃ ᅡ
코를	ᄏ ᅩ ᄅ ᅳ ᆯ
다쳤어요	ᄃ ᅡ ᄎ ᅥ ᄊ ᅥ ᄋ ᅭ
어쩌다	ᄋ ᅥ ᄍ ᅥ ᄃ ᅡ
다친	ᄃ ᅡ ᄎ ᅵ ᆫ
문은	ᄆ ᅮ ᄂ ᅳ ᆫ
닫혀요	ᄃ ᅡ ᄐ ᅧ ᄋ ᅭ
컴퓨터가	ᄏ ᅥ ᆷ ᄑ ᅲ ᄐ ᅥ ᄀ ᅡ
멈춰서	ᄆ ᅥ ᆷ ᄎ ᅯ ᄉ ᅥ
창이	ᄎ ᅡ ᆼ ᄋ ᅵ
닫히지	ᄃ ᅡ ᄎ ᅵ ᄌ ᅵ
않아	ᄋ ᅡ ᄂ ᅡ
단말기	ᄃ ᅡ ᆫ ᄆ ᅡ ᆯ ᄀ ᅵ
위에	ᄋ ᅱ ᄋ ᅦ
대세요	ᄃ ᅢ ᄉ ᅦ ᄋ ᅭ
먹어	ᄆ ᅥ ᄀ ᅥ
대니까	ᄃ ᅢ ᄂ ᅵ ᄁ ᅡ
살이	ᄉ ᅡ ᄅ ᅵ
빠지지	ᄈ ᅡ ᄌ ᅵ ᄌ ᅵ
질문에	ᄌ ᅵ ᆯ ᄆ ᅮ ᄂ ᅦ
대답하세요	ᄃ ᅢ ᄃ ᅡ ᄑ ᅡ ᄉ ᅦ ᄋ ᅭ
어른들에게는	ᄋ ᅥ ᄅ ᅳ ᆫ ᄃ ᅳ ᄅ ᅦ ᄀ ᅦ ᄂ ᅳ ᆫ
예나	ᄋ ᅨ ᄂ ᅡ
아니요라고	ᄋ ᅡ ᄂ ᅵ ᄋ ᅭ ᄅ ᅡ ᄀ ᅩ
대답해야	ᄃ ᅢ ᄃ ᅡ ᄑ ᅢ ᄋ ᅣ
합니다	ᄒ ᅡ ᆷ ᄂ ᅵ ᄃ ᅡ
딸처럼	ᄄ ᅡ ᆯ ᄎ ᅥ ᄅ ᅥ ᆷ
대한다	ᄃ ᅢ ᄒ ᅡ ᆫ ᄃ ᅡ
문제에	ᄆ ᅮ ᆫ ᄌ ᅦ ᄋ ᅦ
볼	ᄇ ᅩ ᆯ
개는	ᄀ ᅢ ᄂ ᅳ ᆫ
사람이	ᄉ ᅡ ᄅ ᅡ ᄆ ᅵ
다가가면	ᄃ ᅡ ᄀ ᅡ ᄀ ᅡ ᄆ ᅧ ᆫ
짖는다	ᄌ ᅵ ᆫ ᄂ ᅳ ᆫ ᄃ ᅡ
그녀에게	ᄀ ᅳ ᄂ ᅧ ᄋ ᅦ ᄀ ᅦ
다가가자	ᄃ ᅡ ᄀ ᅡ ᄀ ᅡ ᄌ ᅡ
얼굴이	ᄋ ᅥ ᆯ ᄀ ᅮ ᄅ ᅵ
창백해졌다	ᄎ ᅡ ᆼ ᄇ ᅢ ᄏ ᅢ ᄌ ᅥ ᆮ ᄄ ᅡ
폭풍이	ᄑ ᅩ ᆨ ᄑ ᅮ ᆼ ᄋ ᅵ
다가오자	ᄃ ᅡ ᄀ ᅡ ᄋ ᅩ ᄌ ᅡ
하늘이	ᄒ ᅡ ᄂ ᅳ ᄅ ᅵ
어두워졌다	ᄋ ᅥ ᄃ ᅮ ᄋ ᅯ ᄌ ᅥ ᆮ ᄄ ᅡ
내게	ᄂ ᅢ ᄀ ᅦ
다가왔다	ᄃ ᅡ ᄀ ᅡ ᄋ ᅪ ᆮ ᄄ ᅡ
힘이	ᄒ ᅵ ᄆ ᅵ
다할	ᄃ ᅡ ᄒ ᅡ ᆯ
때까지	ᄄ ᅢ ᄁ ᅡ ᄌ ᅵ
계속	ᄀ ᅨ ᄉ ᅩ ᆨ
소리쳤다	ᄉ ᅩ ᄅ ᅵ ᄎ ᅥ ᆮ ᄄ ᅡ
부모님을	ᄇ ᅮ ᄆ ᅩ ᄂ ᅵ ᄆ ᅳ ᆯ
실망시키지	ᄉ ᅵ ᆯ ᄆ ᅡ ᆼ ᄉ ᅵ ᄏ ᅵ ᄌ ᅵ
않기	ᄋ ᅡ ᆫ ᄏ ᅵ
최선을	ᄎ ᅬ ᄉ ᅥ ᄂ ᅳ ᆯ
다하겠다	ᄃ ᅡ ᄒ ᅡ ᄀ ᅦ ᆮ ᄄ ᅡ
닦는	ᄃ ᅡ ᆼ ᄂ ᅳ ᆫ
잊지	ᄋ ᅵ ᆮ ᄍ ᅵ
바닥을	ᄇ ᅡ ᄃ ᅡ ᄀ ᅳ ᆯ
닦아라	ᄃ ᅡ ᄁ ᅡ ᄅ ᅡ
블라우스에	ᄇ ᅳ ᆯ ᄅ ᅡ ᄋ ᅮ ᄉ ᅳ ᄋ ᅦ
브로치를	ᄇ ᅳ ᄅ ᅩ ᄎ ᅵ ᄅ ᅳ ᆯ
달았다	ᄃ ᅡ ᄅ ᅡ ᆮ ᄄ ᅡ
태극기를	ᄐ ᅢ ᄀ ᅳ ᆨ ᄁ ᅵ ᄅ ᅳ ᆯ
다세요	ᄃ ᅡ ᄉ ᅦ ᄋ ᅭ
엄마가	ᄋ ᅥ ᆷ ᄆ ᅡ ᄀ ᅡ
돌아가신	ᄃ ᅩ ᄅ ᅡ ᄀ ᅡ ᄉ ᅵ ᆫ
달라졌어요	ᄃ ᅡ ᆯ ᄅ ᅡ ᄌ ᅥ ᄊ ᅥ ᄋ ᅭ
아내	ᄋ ᅡ ᄂ ᅢ
덕분에	ᄃ ᅥ ᆨ ᄈ ᅮ ᄂ ᅦ
달라졌습니다	ᄃ ᅡ ᆯ ᄅ ᅡ ᄌ ᅥ ᆮ ᄊ ᅳ ᆷ ᄂ ᅵ ᄃ ᅡ
결승점을	ᄀ ᅧ ᆯ ᄉ ᅳ ᆼ ᄌ ᅥ ᄆ ᅳ ᆯ
향해	ᄒ ᅣ ᆼ ᄒ ᅢ
전속력으로	ᄌ ᅥ ᆫ ᄉ ᅩ ᆼ ᄂ ᅧ ᄀ ᅳ ᄅ ᅩ
달렸다	ᄃ ᅡ ᆯ ᄅ ᅧ ᆮ ᄄ ᅡ
오토바이는	ᄋ ᅩ ᄐ ᅩ ᄇ ᅡ ᄋ ᅵ ᄂ ᅳ ᆫ
시속	ᄉ ᅵ ᄉ ᅩ ᆨ
육십	ᄋ ᅲ ᆨ ᄊ ᅵ ᆸ
킬로로	ᄏ ᅵ ᆯ ᄅ ᅩ ᄅ ᅩ
달렸어요	ᄃ ᅡ ᆯ ᄅ ᅧ ᄊ ᅥ ᄋ ᅭ
포도가	ᄑ ᅩ ᄃ ᅩ ᄀ ᅡ
나무에	ᄂ ᅡ ᄆ ᅮ ᄋ ᅦ
달려	ᄃ ᅡ ᆯ ᄅ ᅧ
너한테	ᄂ ᅥ ᄒ ᅡ ᆫ ᄐ ᅦ
달렸어	ᄃ ᅡ ᆯ ᄅ ᅧ ᄊ ᅥ
업고	ᄋ ᅥ ᆸ ᄁ ᅩ
병원으로	ᄇ ᅧ ᆼ ᄋ ᅯ ᄂ ᅳ ᄅ ᅩ
달려갔다	ᄃ ᅡ ᆯ ᄅ ᅧ ᄀ ᅡ ᆮ ᄄ ᅡ
딸아이는	ᄄ ᅡ ᄅ ᅡ ᄋ ᅵ ᄂ ᅳ ᆫ
혼나고	ᄒ ᅩ ᆫ ᄂ ᅡ ᄀ ᅩ
나면	ᄂ ᅡ ᄆ ᅧ ᆫ
달려가요	ᄃ ᅡ ᆯ ᄅ ᅧ ᄀ ᅡ ᄋ ᅭ
그릇에	ᄀ ᅳ ᄅ ᅳ ᄉ ᅦ
물이	ᄆ ᅮ ᄅ ᅵ
담겨	ᄃ ᅡ ᆷ ᄀ ᅧ
부모님의	ᄇ ᅮ ᄆ ᅩ ᄂ ᅵ ᄆ ᅴ
꾸중에는	ᄁ ᅮ ᄌ ᅮ ᆼ ᄋ ᅦ ᄂ ᅳ ᆫ
사랑이	ᄉ ᅡ ᄅ ᅡ ᆼ ᄋ ᅵ
아는	ᄋ ᅡ ᄂ ᅳ ᆫ
사람이랑	ᄉ ᅡ ᄅ ᅡ ᄆ ᅵ ᄅ ᅡ ᆼ
닮았어	ᄃ ᅡ ᆯ ᄆ ᅡ ᄊ ᅥ
아주	ᄋ ᅡ ᄌ ᅮ
친한	ᄎ ᅵ ᆫ ᄒ ᅡ ᆫ
사이여서	ᄉ ᅡ ᄋ ᅵ ᄋ ᅧ ᄉ ᅥ
서로를	ᄉ ᅥ ᄅ ᅩ ᄅ ᅳ ᆯ
닮아	ᄃ ᅡ ᆯ ᄆ ᅡ
가고	ᄀ ᅡ ᄀ ᅩ
방금	ᄇ ᅡ ᆼ ᄀ ᅳ ᆷ
상자에	ᄉ ᅡ ᆼ ᄌ ᅡ ᄋ ᅦ
담아	ᄃ ᅡ ᄆ ᅡ
둔	ᄃ ᅮ ᆫ
책이	ᄎ ᅢ ᄀ ᅵ
없어졌어	ᄋ ᅥ ᆸ ᄊ ᅥ ᄌ ᅥ ᄊ ᅥ
고객이	ᄀ ᅩ ᄀ ᅢ ᄀ ᅵ
감사의	ᄀ ᅡ ᆷ ᄉ ᅡ ᄋ ᅴ
마음을	ᄆ ᅡ ᄋ ᅳ ᄆ ᅳ ᆯ
담은	ᄃ ᅡ ᄆ ᅳ ᆫ
편지를	ᄑ ᅧ ᆫ ᄌ ᅵ ᄅ ᅳ ᆯ
왔어	ᄋ ᅪ ᄊ ᅥ
밧줄을	ᄇ ᅡ ᆮ ᄍ ᅮ ᄅ ᅳ ᆯ
당겨서	ᄃ ᅡ ᆼ ᄀ ᅧ ᄉ ᅥ
끊어졌어	ᄁ ᅳ ᄂ ᅥ ᄌ ᅥ ᄊ ᅥ
문을	ᄆ ᅮ ᄂ ᅳ ᆯ
여세요	ᄋ ᅧ ᄉ ᅦ ᄋ ᅭ
동생이	ᄃ ᅩ ᆼ ᄉ ᅢ ᆼ ᄋ ᅵ
교통사고를	ᄀ ᅭ ᄐ ᅩ ᆼ ᄉ ᅡ ᄀ ᅩ ᄅ ᅳ ᆯ
당했어	ᄃ ᅡ ᆼ ᄒ ᅢ ᄊ ᅥ
부하들	ᄇ ᅮ ᄒ ᅡ ᄃ ᅳ ᆯ
창피를	ᄎ ᅡ ᆼ ᄑ ᅵ ᄅ ᅳ ᆯ
당했다	ᄃ ᅡ ᆼ ᄒ ᅢ ᆮ ᄄ ᅡ
어느	ᄋ ᅥ ᄂ ᅳ
학교에	ᄒ ᅡ ᆨ ᄁ ᅭ ᄋ ᅦ
다녔어요	ᄃ ᅡ ᄂ ᅧ ᄊ ᅥ ᄋ ᅭ
학생이세요	ᄒ ᅡ ᆨ ᄊ ᅢ ᆼ ᄋ ᅵ ᄉ ᅦ ᄋ ᅭ
아니면	ᄋ ᅡ ᄂ ᅵ ᄆ ᅧ ᆫ
직장을	ᄌ ᅵ ᆨ ᄍ ᅡ ᆼ ᄋ ᅳ ᆯ
다니세요	ᄃ ᅡ ᄂ ᅵ ᄉ ᅦ ᄋ ᅭ
아버지는	ᄋ ᅡ ᄇ ᅥ ᄌ ᅵ ᄂ ᅳ ᆫ
일요일이면	ᄋ ᅵ ᄅ ᅭ ᄋ ᅵ ᄅ ᅵ ᄆ ᅧ ᆫ
사냥을	ᄉ ᅡ ᄂ ᅣ ᆼ ᄋ ᅳ ᆯ
학교	ᄒ ᅡ ᆨ ᄁ ᅭ
다녀왔어요	ᄃ ᅡ ᄂ ᅧ ᄋ ᅪ ᄊ ᅥ ᄋ ᅭ
추석에는	ᄎ ᅮ ᄉ ᅥ ᄀ ᅦ ᄂ ᅳ ᆫ
사람들이	ᄉ ᅡ ᄅ ᅡ ᆷ ᄃ ᅳ ᄅ ᅵ
고향을	ᄀ ᅩ ᄒ ᅣ ᆼ ᄋ ᅳ ᆯ
다녀온다	ᄃ ᅡ ᄂ ᅧ ᄋ ᅩ ᆫ ᄃ ᅡ
용의자는	ᄋ ᅭ ᆼ ᄋ ᅴ ᄌ ᅡ ᄂ ᅳ ᆫ
부산으로	ᄇ ᅮ ᄉ ᅡ ᄂ ᅳ ᄅ ᅩ
달아났다	ᄃ ᅡ ᄅ ᅡ ᄂ ᅡ ᆮ ᄄ ᅡ
도둑은	ᄃ ᅩ ᄃ ᅮ ᄀ ᅳ ᆫ
개를	ᄀ ᅢ ᄅ ᅳ ᆯ
보고는	ᄇ ᅩ ᄀ ᅩ ᄂ ᅳ ᆫ
달아났습니다	ᄃ ᅡ ᄅ ᅡ ᄂ ᅡ ᆮ ᄊ ᅳ ᆷ ᄂ ᅵ ᄃ ᅡ
신문	ᄉ ᅵ ᆫ ᄆ ᅮ ᆫ
내려주실래요	ᄂ ᅢ ᄅ ᅧ ᄌ ᅮ ᄉ ᅵ ᆯ ᄅ ᅢ ᄋ ᅭ
선반에	ᄉ ᅥ ᆫ ᄇ ᅡ ᄂ ᅦ
손이	ᄉ ᅩ ᄂ ᅵ
닿아서요	ᄃ ᅡ ᄋ ᅡ ᄉ ᅥ ᄋ ᅭ
집은	ᄌ ᅵ ᄇ ᅳ ᆫ
여기에서	ᄋ ᅧ ᄀ ᅵ ᄋ ᅦ ᄉ ᅥ
엎어지면	ᄋ ᅥ ᄑ ᅥ ᄌ ᅵ ᄆ ᅧ ᆫ
코	ᄏ ᅩ
닿을	ᄃ ᅡ ᄋ ᅳ ᆯ
데	ᄃ ᅦ
창문을	ᄎ ᅡ ᆼ ᄆ ᅮ ᄂ ᅳ ᆯ
닫아도	ᄃ ᅡ ᄃ ᅡ ᄃ ᅩ
될까요	ᄃ ᅬ ᆯ ᄁ ᅡ ᄋ ᅭ
가게는	ᄀ ᅡ ᄀ ᅦ ᄂ ᅳ ᆫ
밤	ᄇ ᅡ ᆷ
열	ᄋ ᅧ ᆯ
닫습니다	ᄃ ᅡ ᆮ ᄊ ᅳ ᆷ ᄂ ᅵ ᄃ ᅡ
마음	ᄆ ᅡ ᄋ ᅳ ᆷ
속으로	ᄉ ᅩ ᄀ ᅳ ᄅ ᅩ
생각한	ᄉ ᅢ ᆼ ᄀ ᅡ ᄏ ᅡ ᆫ
수에	ᄉ ᅮ ᄋ ᅦ
이를	ᄋ ᅵ ᄅ ᅳ ᆯ
더하세요	ᄃ ᅥ ᄒ ᅡ ᄉ ᅦ ᄋ ᅭ
더하기	ᄃ ᅥ ᄒ ᅡ ᄀ ᅵ
사는	ᄉ ᅡ ᄂ ᅳ ᆫ
연못에	ᄋ ᅧ ᆫ ᄆ ᅩ ᄉ ᅦ
돌을	ᄃ ᅩ ᄅ ᅳ ᆯ
던지지	ᄃ ᅥ ᆫ ᄌ ᅵ ᄌ ᅵ
투수는	ᄐ ᅮ ᄉ ᅮ ᄂ ᅳ ᆫ
타자가	ᄐ ᅡ ᄌ ᅡ ᄀ ᅡ
아닌	ᄋ ᅡ ᄂ ᅵ ᆫ
포수에게	ᄑ ᅩ ᄉ ᅮ ᄋ ᅦ ᄀ ᅦ
던져야	ᄃ ᅥ ᆫ ᄌ ᅥ ᄋ ᅣ
한다	ᄒ ᅡ ᆫ ᄃ ᅡ
덮으세요	ᄃ ᅥ ᄑ ᅳ ᄉ ᅦ ᄋ ᅭ
컵을	ᄏ ᅥ ᄇ ᅳ ᆯ
종이로	ᄌ ᅩ ᆼ ᄋ ᅵ ᄅ ᅩ
덮어	ᄃ ᅥ ᄑ ᅥ
두어라	ᄃ ᅮ ᄋ ᅥ ᄅ ᅡ
일곱	ᄋ ᅵ ᆯ ᄀ ᅩ ᆸ
시쯤에	ᄉ ᅵ ᄍ ᅳ ᄆ ᅦ
데리러	ᄃ ᅦ ᄅ ᅵ ᄅ ᅥ
갈게	ᄀ ᅡ ᆯ ᄀ ᅦ
딸을	ᄄ ᅡ ᄅ ᅳ ᆯ
데리고	ᄃ ᅦ ᄅ ᅵ ᄀ ᅩ
병원에	ᄇ ᅧ ᆼ ᄋ ᅯ ᄂ ᅦ
데려가야	ᄃ ᅦ ᄅ ᅧ ᄀ ᅡ ᄋ ᅣ
여자	ᄋ ᅧ ᄌ ᅡ
부모님께	ᄇ ᅮ ᄆ ᅩ ᄂ ᅵ ᆷ ᄁ ᅦ
데려갈	ᄃ ᅦ ᄅ ᅧ ᄀ ᅡ ᆯ
집들이	ᄌ ᅵ ᆸ ᄄ ᅳ ᄅ ᅵ
회사	ᄒ ᅬ ᄉ ᅡ
집에	ᄌ ᅵ ᄇ ᅦ
데려와도	ᄃ ᅦ ᄅ ᅧ ᄋ ᅪ ᄃ ᅩ
돼	ᄃ ᅫ
그때	ᄀ ᅳ ᄄ ᅢ
의사를	ᄋ ᅴ ᄉ ᅡ ᄅ ᅳ ᆯ
데려오지	ᄃ ᅦ ᄅ ᅧ ᄋ ᅩ ᄌ ᅵ
않았으면	ᄋ ᅡ ᄂ ᅡ ᄊ ᅳ ᄆ ᅧ ᆫ
죽었을	ᄌ ᅮ ᄀ ᅥ ᄊ ᅳ ᆯ
잊는	ᄋ ᅵ ᆫ ᄂ ᅳ ᆫ
데에	ᄃ ᅦ ᄋ ᅦ
년이	ᄂ ᅧ ᄂ ᅵ
들었어	ᄃ ᅳ ᄅ ᅥ ᄊ ᅥ
비타민	ᄇ ᅵ ᄐ ᅡ ᄆ ᅵ ᆫ
씨가	ᄊ ᅵ ᄀ ᅡ
들어	ᄃ ᅳ ᄅ ᅥ
있는	ᄋ ᅵ ᆫ ᄂ ᅳ ᆫ
과일을	ᄀ ᅪ ᄋ ᅵ ᄅ ᅳ ᆯ
드세요	ᄃ ᅳ ᄉ ᅦ ᄋ ᅭ
감기	ᄀ ᅡ ᆷ ᄀ ᅵ
든	ᄃ ᅳ ᆫ
거니	ᄀ ᅥ ᄂ ᅵ
무거운	ᄆ ᅮ ᄀ ᅥ ᄋ ᅮ ᆫ
들다	ᄃ ᅳ ᆯ ᄃ ᅡ
허리를	ᄒ ᅥ ᄅ ᅵ ᄅ ᅳ ᆯ
삐끗했다	ᄈ ᅵ ᄁ ᅳ ᄐ ᅢ ᆮ ᄄ ᅡ
왼손에	ᄋ ᅬ ᆫ ᄉ ᅩ ᄂ ᅦ
우산을	ᄋ ᅮ ᄉ ᅡ ᄂ ᅳ ᆯ
아내야	ᄋ ᅡ ᄂ ᅢ ᄋ ᅣ
사무실에	ᄉ ᅡ ᄆ ᅮ ᄉ ᅵ ᄅ ᅦ
잠깐	ᄌ ᅡ ᆷ ᄁ ᅡ ᆫ
들러	ᄃ ᅳ ᆯ ᄅ ᅥ
주실	ᄌ ᅮ ᄉ ᅵ ᆯ
있으세요	ᄋ ᅵ ᄊ ᅳ ᄉ ᅦ ᄋ ᅭ
주유소를	ᄌ ᅮ ᄋ ᅲ ᄉ ᅩ ᄅ ᅳ ᆯ
들러서	ᄃ ᅳ ᆯ ᄅ ᅥ ᄉ ᅥ
채웠습니다	ᄎ ᅢ ᄋ ᅯ ᆮ ᄊ ᅳ ᆷ ᄂ ᅵ ᄃ ᅡ
말이	ᄆ ᅡ ᄅ ᅵ
들리세요	ᄃ ᅳ ᆯ ᄅ ᅵ ᄉ ᅦ ᄋ ᅭ
당신	ᄃ ᅡ ᆼ ᄉ ᅵ ᆫ
제안은	ᄌ ᅦ ᄋ ᅡ ᄂ ᅳ ᆫ
흥미롭게	ᄒ ᅳ ᆼ ᄆ ᅵ ᄅ ᅩ ᆸ ᄁ ᅦ
들리네요	ᄃ ᅳ ᆯ ᄅ ᅵ ᄂ ᅦ ᄋ ᅭ
눈에	ᄂ ᅮ ᄂ ᅦ
뭔가가	ᄆ ᅯ ᆫ ᄀ ᅡ ᄀ ᅡ
들어갔어요	ᄃ ᅳ ᄅ ᅥ ᄀ ᅡ ᄊ ᅥ ᄋ ᅭ
열쇠를	ᄋ ᅧ ᆯ ᄉ ᅬ ᄅ ᅳ ᆯ
잃어버려서	ᄋ ᅵ ᄅ ᅥ ᄇ ᅥ ᄅ ᅧ ᄉ ᅥ
창문으로	ᄎ ᅡ ᆼ ᄆ ᅮ ᄂ ᅳ ᄅ ᅩ
들어갔다	ᄃ ᅳ ᄅ ᅥ ᄀ ᅡ ᆮ ᄄ ᅡ
그들의	ᄀ ᅳ ᄃ ᅳ ᄅ ᅴ
음모가	ᄋ ᅳ ᆷ ᄆ ᅩ ᄀ ᅡ
드러나고	ᄃ ᅳ ᄅ ᅥ ᄂ ᅡ ᄀ ᅩ
새하얀	ᄉ ᅢ ᄒ ᅡ ᄋ ᅣ ᆫ
드러내면서	ᄃ ᅳ ᄅ ᅥ ᄂ ᅢ ᄆ ᅧ ᆫ ᄉ ᅥ
웃었다	ᄋ ᅮ ᄉ ᅥ ᆮ ᄄ ᅡ
네가	ᄂ ᅦ ᄀ ᅡ
말은	ᄆ ᅡ ᄅ ᅳ ᆫ
너의	ᄂ ᅥ ᄋ ᅴ
무지를	ᄆ ᅮ ᄌ ᅵ ᄅ ᅳ ᆯ
드러내는	ᄃ ᅳ ᄅ ᅥ ᄂ ᅢ ᄂ ᅳ ᆫ
이곳에	ᄋ ᅵ ᄀ ᅩ ᄉ ᅦ
들어오시면	ᄃ ᅳ ᄅ ᅥ ᄋ ᅩ ᄉ ᅵ ᄆ ᅧ ᆫ
됩니다	ᄃ ᅬ ᆷ ᄂ ᅵ ᄃ ᅡ
오늘은	ᄋ ᅩ ᄂ ᅳ ᄅ ᅳ ᆫ
일찍	ᄋ ᅵ ᆯ ᄍ ᅵ ᆨ
들어와라	ᄃ ᅳ ᄅ ᅥ ᄋ ᅪ ᄅ ᅡ
길을	ᄀ ᅵ ᄅ ᅳ ᆯ
잘못	ᄌ ᅡ ᆯ ᄆ ᅩ ᆮ
들어선	ᄃ ᅳ ᄅ ᅥ ᄉ ᅥ ᆫ
지역에	ᄌ ᅵ ᄋ ᅧ ᄀ ᅦ
새	ᄉ ᅢ
아파트가	ᄋ ᅡ ᄑ ᅡ ᄐ ᅳ ᄀ ᅡ
여기저기	ᄋ ᅧ ᄀ ᅵ ᄌ ᅥ ᄀ ᅵ
들어서고	ᄃ ᅳ ᄅ ᅥ ᄉ ᅥ ᄀ ᅩ
명함을	ᄆ ᅧ ᆼ ᄒ ᅡ ᄆ ᅳ ᆯ
드렸나요	ᄃ ᅳ ᄅ ᅧ ᆫ ᄂ ᅡ ᄋ ᅭ
읽어	ᄋ ᅵ ᆯ ᄀ ᅥ
열고	ᄋ ᅧ ᆯ ᄀ ᅩ
교회	ᄀ ᅭ ᄒ ᅬ
안을	ᄋ ᅡ ᄂ ᅳ ᆯ
들여다봤다	ᄃ ᅳ ᄅ ᅧ ᄃ ᅡ ᄇ ᅪ ᆮ ᄄ ᅡ
하루	ᄒ ᅡ ᄅ ᅮ
종일	ᄌ ᅩ ᆼ ᄋ ᅵ ᆯ
현미경을	ᄒ ᅧ ᆫ ᄆ ᅵ ᄀ ᅧ ᆼ ᄋ ᅳ ᆯ
들여다봐	ᄃ ᅳ ᄅ ᅧ ᄃ ᅡ ᄇ ᅪ
음악을	ᄋ ᅳ ᄆ ᅡ ᄀ ᅳ ᆯ
듣다	ᄃ ᅳ ᆮ ᄄ ᅡ
잠이	ᄌ ᅡ ᄆ ᅵ
들었다	ᄃ ᅳ ᄅ ᅥ ᆮ ᄄ ᅡ
듣고	ᄃ ᅳ ᆮ ᄁ ᅩ
계세요	ᄀ ᅨ ᄉ ᅦ ᄋ ᅭ
인천에	ᄋ ᅵ ᆫ ᄎ ᅥ ᄂ ᅦ
도착하셨어요	ᄃ ᅩ ᄎ ᅡ ᄏ ᅡ ᄉ ᅧ ᄊ ᅥ ᄋ ᅭ
십	ᄉ ᅵ ᆸ
년	ᄂ ᅧ ᆫ
뒤에는	ᄃ ᅱ ᄋ ᅦ ᄂ ᅳ ᆫ
부자가	ᄇ ᅮ ᄌ ᅡ ᄀ ᅡ
될	ᄃ ᅬ ᆯ
사랑하게	ᄉ ᅡ ᄅ ᅡ ᆼ ᄒ ᅡ ᄀ ᅦ
되었어요	ᄃ ᅬ ᄋ ᅥ ᄊ ᅥ ᄋ ᅭ
애완견	ᄋ ᅢ ᄋ ᅪ ᆫ ᄀ ᅧ ᆫ
돌보는	ᄃ ᅩ ᆯ ᄇ ᅩ ᄂ ᅳ ᆫ
좋아해요	ᄌ ᅩ ᄋ ᅡ ᄒ ᅢ ᄋ ᅭ
우리를	ᄋ ᅮ ᄅ ᅵ ᄅ ᅳ ᆯ
때문에	ᄄ ᅢ ᄆ ᅮ ᄂ ᅦ
아침부터	ᄋ ᅡ ᄎ ᅵ ᆷ ᄇ ᅮ ᄐ ᅥ
밤까지	ᄇ ᅡ ᆷ ᄁ ᅡ ᄌ ᅵ
바빠요	ᄇ ᅡ ᄈ ᅡ ᄋ ᅭ
곧장	ᄀ ᅩ ᆮ ᄍ ᅡ ᆼ
가다가	ᄀ ᅡ ᄃ ᅡ ᄀ ᅡ
왼쪽으로	ᄋ ᅬ ᆫ ᄍ ᅩ ᄀ ᅳ ᄅ ᅩ
도세요	ᄃ ᅩ ᄉ ᅦ ᄋ ᅭ
지구는	ᄌ ᅵ ᄀ ᅮ ᄂ ᅳ ᆫ
태양을	ᄐ ᅢ ᄋ ᅣ ᆼ ᄋ ᅳ ᆯ
돈다	ᄃ ᅩ ᆫ ᄃ ᅡ
채널	ᄎ ᅢ ᄂ ᅥ ᆯ
그만	ᄀ ᅳ ᄆ ᅡ ᆫ
돌려라	ᄃ ᅩ ᆯ ᄅ ᅧ ᄅ ᅡ
보자마자	ᄇ ᅩ ᄌ ᅡ ᄆ ᅡ ᄌ ᅡ
차의	ᄎ ᅡ ᄋ ᅴ
방향을	ᄇ ᅡ ᆼ ᄒ ᅣ ᆼ ᄋ ᅳ ᆯ
돌렸다	ᄃ ᅩ ᆯ ᄅ ᅧ ᆮ ᄄ ᅡ
도망가자	ᄃ ᅩ ᄆ ᅡ ᆼ ᄀ ᅡ ᄌ ᅡ
죽이고	ᄌ ᅮ ᄀ ᅵ ᄀ ᅩ
해외로	ᄒ ᅢ ᄋ ᅬ ᄅ ᅩ
도망갔다	ᄃ ᅩ ᄆ ᅡ ᆼ ᄀ ᅡ ᆮ ᄄ ᅡ
뭘	ᄆ ᅯ ᆯ
도와	ᄃ ᅩ ᄋ ᅪ
드릴까요	ᄃ ᅳ ᄅ ᅵ ᆯ ᄁ ᅡ ᄋ ᅭ
하늘은	ᄒ ᅡ ᄂ ᅳ ᄅ ᅳ ᆫ
스스로	ᄉ ᅳ ᄉ ᅳ ᄅ ᅩ
돕는	ᄃ ᅩ ᆷ ᄂ ᅳ ᆫ
자를	ᄌ ᅡ ᄅ ᅳ ᆯ
돕는다	ᄃ ᅩ ᆷ ᄂ ᅳ ᆫ ᄃ ᅡ
뒤를	ᄃ ᅱ ᄅ ᅳ ᆯ
돌아보지	ᄃ ᅩ ᄅ ᅡ ᄇ ᅩ ᄌ ᅵ
올랐다	ᄋ ᅩ ᆯ ᄅ ᅡ ᆮ ᄄ ᅡ
연말에는	ᄋ ᅧ ᆫ ᄆ ᅡ ᄅ ᅦ ᄂ ᅳ ᆫ
해를	ᄒ ᅢ ᄅ ᅳ ᆯ
돌아볼	ᄃ ᅩ ᄅ ᅡ ᄇ ᅩ ᆯ
할머니가	ᄒ ᅡ ᆯ ᄆ ᅥ ᄂ ᅵ ᄀ ᅡ
돌아가셨다는	ᄃ ᅩ ᄅ ᅡ ᄀ ᅡ ᄉ ᅧ ᆮ ᄄ ᅡ ᄂ ᅳ ᆫ
받았어	ᄇ ᅡ ᄃ ᅡ ᄊ ᅥ
열아홉	ᄋ ᅧ ᄅ ᅡ ᄒ ᅩ ᆸ
살에	ᄉ ᅡ ᄅ ᅦ
한국으로	ᄒ ᅡ ᆫ ᄀ ᅮ ᄀ ᅳ ᄅ ᅩ
돌아왔다	ᄃ ᅩ ᄅ ᅡ ᄋ ᅪ ᆮ ᄄ ᅡ
환자의	ᄒ ᅪ ᆫ ᄌ ᅡ ᄋ ᅴ
의식이	ᄋ ᅴ ᄉ ᅵ ᄀ ᅵ
돌아왔어요	ᄃ ᅩ ᄅ ᅡ ᄋ ᅪ ᄊ ᅥ ᄋ ᅭ
숙제	ᄉ ᅮ ᆨ ᄍ ᅦ
도와주세요	ᄃ ᅩ ᄋ ᅪ ᄌ ᅮ ᄉ ᅦ ᄋ ᅭ
도와주셔서	ᄃ ᅩ ᄋ ᅪ ᄌ ᅮ ᄉ ᅧ ᄉ ᅥ
고맙습니다	ᄀ ᅩ ᄆ ᅡ ᆸ ᄊ ᅳ ᆷ ᄂ ᅵ ᄃ ᅡ
약은	ᄋ ᅣ ᄀ ᅳ ᆫ
아이들	ᄋ ᅡ ᄋ ᅵ ᄃ ᅳ ᆯ
닿지	ᄃ ᅡ ᄎ ᅵ
않는	ᄋ ᅡ ᆫ ᄂ ᅳ ᆫ
곳에	ᄀ ᅩ ᄉ ᅦ
두세요	ᄃ ᅮ ᄉ ᅦ ᄋ ᅭ
수업	ᄉ ᅮ ᄋ ᅥ ᆸ
중에	ᄌ ᅮ ᆼ ᄋ ᅦ
휴대폰을	ᄒ ᅲ ᄃ ᅢ ᄑ ᅩ ᄂ ᅳ ᆯ
켜	ᄏ ᅧ
두지	ᄃ ᅮ ᄌ ᅵ
지역	ᄌ ᅵ ᄋ ᅧ ᆨ
주변을	ᄌ ᅮ ᄇ ᅧ ᄂ ᅳ ᆯ
둘러보고	ᄃ ᅮ ᆯ ᄅ ᅥ ᄇ ᅩ ᄀ ᅩ
그냥	ᄀ ᅳ ᄂ ᅣ ᆼ
둘러보는	ᄃ ᅮ ᆯ ᄅ ᅥ ᄇ ᅩ ᄂ ᅳ ᆫ
적군이	ᄌ ᅥ ᆨ ᄁ ᅮ ᄂ ᅵ
둘러쌌다	ᄃ ᅮ ᆯ ᄅ ᅥ ᄊ ᅡ ᆮ ᄄ ᅡ
문제를	ᄆ ᅮ ᆫ ᄌ ᅦ ᄅ ᅳ ᆯ
둘러싸고	ᄃ ᅮ ᆯ ᄅ ᅥ ᄊ ᅡ ᄀ ᅩ
논의가	ᄂ ᅩ ᄂ ᅴ ᄀ ᅡ
얼룩을	ᄋ ᅥ ᆯ ᄅ ᅮ ᄀ ᅳ ᆯ
없앨	ᄋ ᅥ ᆸ ᄊ ᅢ ᆯ
그렇다면	ᄀ ᅳ ᄅ ᅥ ᄐ ᅡ ᄆ ᅧ ᆫ
없애	ᄋ ᅥ ᆸ ᄊ ᅢ
이웃집에서	ᄋ ᅵ ᄋ ᅮ ᆮ ᄍ ᅵ ᄇ ᅦ ᄉ ᅥ
망치를	ᄆ ᅡ ᆼ ᄎ ᅵ ᄅ ᅳ ᆯ
하나	ᄒ ᅡ ᄂ ᅡ
얻어	ᄋ ᅥ ᄃ ᅥ
와라	ᄋ ᅪ ᄅ ᅡ
서점에서	ᄉ ᅥ ᄌ ᅥ ᄆ ᅦ ᄉ ᅥ
아이디어는	ᄋ ᅡ ᄋ ᅵ ᄃ ᅵ ᄋ ᅥ ᄂ ᅳ ᆫ
얻었어	ᄋ ᅥ ᄃ ᅥ ᄊ ᅥ
나쁜	ᄂ ᅡ ᄈ ᅳ ᆫ
친구와	ᄎ ᅵ ᆫ ᄀ ᅮ ᄋ ᅪ
어울려	ᄋ ᅥ ᄋ ᅮ ᆯ ᄅ ᅧ
다니지	ᄃ ᅡ ᄂ ᅵ ᄌ ᅵ
넥타이는	ᄂ ᅦ ᆨ ᄐ ᅡ ᄋ ᅵ ᄂ ᅳ ᆫ
당신에게	ᄃ ᅡ ᆼ ᄉ ᅵ ᄂ ᅦ ᄀ ᅦ
어울리지	ᄋ ᅥ ᄋ ᅮ ᆯ ᄅ ᅵ ᄌ ᅵ
않아요	ᄋ ᅡ ᄂ ᅡ ᄋ ᅭ
일요일마다	ᄋ ᅵ ᄅ ᅭ ᄋ ᅵ ᆯ ᄆ ᅡ ᄃ ᅡ
교회에	ᄀ ᅭ ᄒ ᅬ ᄋ ᅦ
갑니다	ᄀ ᅡ ᆷ ᄂ ᅵ ᄃ ᅡ
건조해서	ᄀ ᅥ ᆫ ᄌ ᅩ ᄒ ᅢ ᄉ ᅥ
농작물이	ᄂ ᅩ ᆼ ᄌ ᅡ ᆼ ᄆ ᅮ ᄅ ᅵ
죽어	ᄌ ᅮ ᄀ ᅥ
가요	ᄀ ᅡ ᄋ ᅭ
상상력을	ᄉ ᅡ ᆼ ᄉ ᅡ ᆼ ᄂ ᅧ ᄀ ᅳ ᆯ
개발하고	ᄀ ᅢ ᄇ ᅡ ᆯ ᄒ ᅡ ᄀ ᅩ
싶으면	ᄉ ᅵ ᄑ ᅳ ᄆ ᅧ ᆫ
시를	ᄉ ᅵ ᄅ ᅳ ᆯ
읽으세요	ᄋ ᅵ ᆯ ᄀ ᅳ ᄉ ᅦ ᄋ ᅭ
정부는	ᄌ ᅥ ᆼ ᄇ ᅮ ᄂ ᅳ ᆫ
관광지로	ᄀ ᅪ ᆫ ᄀ ᅪ ᆼ ᄌ ᅵ ᄅ ᅩ
개발할	ᄀ ᅢ ᄇ ᅡ ᆯ ᄒ ᅡ ᆯ
계획이라고	ᄀ ᅨ ᄒ ᅬ ᄀ ᅵ ᄅ ᅡ ᄀ ᅩ
발표했다	ᄇ ᅡ ᆯ ᄑ ᅭ ᄒ ᅢ ᆮ ᄄ ᅡ
옷은	ᄋ ᅩ ᄉ ᅳ ᆫ
세탁소로	ᄉ ᅦ ᄐ ᅡ ᆨ ᄊ ᅩ ᄅ ᅩ
가져가세요	ᄀ ᅡ ᄌ ᅥ ᄀ ᅡ ᄉ ᅦ ᄋ ᅭ
개인	ᄀ ᅢ ᄋ ᅵ ᆫ
물건들을	ᄆ ᅮ ᆯ ᄀ ᅥ ᆫ ᄃ ᅳ ᄅ ᅳ ᆯ
가져가십시오	ᄀ ᅡ ᄌ ᅥ ᄀ ᅡ ᄉ ᅵ ᆸ ᄊ ᅵ ᄋ ᅩ
펜	ᄑ ᅦ ᆫ
이리로	ᄋ ᅵ ᄅ ᅵ ᄅ ᅩ
가져와라	ᄀ ᅡ ᄌ ᅥ ᄋ ᅪ ᄅ ᅡ
컴퓨터는	ᄏ ᅥ ᆷ ᄑ ᅲ ᄐ ᅥ ᄂ ᅳ ᆫ
생활에	ᄉ ᅢ ᆼ ᄒ ᅪ ᄅ ᅦ
엄청난	ᄋ ᅥ ᆷ ᄎ ᅥ ᆼ ᄂ ᅡ ᆫ
변화를	ᄇ ᅧ ᆫ ᄒ ᅪ ᄅ ᅳ ᆯ
가져왔다	ᄀ ᅡ ᄌ ᅥ ᄋ ᅪ ᆮ ᄄ ᅡ
깜빡	ᄁ ᅡ ᆷ ᄈ ᅡ ᆨ
잊고	ᄋ ᅵ ᆮ ᄁ ᅩ
펜을	ᄑ ᅦ ᄂ ᅳ ᆯ
가지고	ᄀ ᅡ ᄌ ᅵ ᄀ ᅩ
왔어요	ᄋ ᅪ ᄊ ᅥ ᄋ ᅭ
부부는	ᄇ ᅮ ᄇ ᅮ ᄂ ᅳ ᆫ
갖지	ᄀ ᅡ ᆮ ᄍ ᅵ
않기로	ᄋ ᅡ ᆫ ᄏ ᅵ ᄅ ᅩ
결정했어	ᄀ ᅧ ᆯ ᄌ ᅥ ᆼ ᄒ ᅢ ᄊ ᅥ
책	ᄎ ᅢ ᆨ
어디에	ᄋ ᅥ ᄃ ᅵ ᄋ ᅦ
감춘	ᄀ ᅡ ᆷ ᄎ ᅮ ᆫ
왜	ᄋ ᅫ
남자라는	ᄂ ᅡ ᆷ ᄌ ᅡ ᄅ ᅡ ᄂ ᅳ ᆫ
사실을	ᄉ ᅡ ᄉ ᅵ ᄅ ᅳ ᆯ
감추려고	ᄀ ᅡ ᆷ ᄎ ᅮ ᄅ ᅧ ᄀ ᅩ
겁니까	ᄀ ᅥ ᆷ ᄂ ᅵ ᄁ ᅡ
와	ᄋ ᅪ
주신	ᄌ ᅮ ᄉ ᅵ ᆫ
여러분께	ᄋ ᅧ ᄅ ᅥ ᄇ ᅮ ᆫ ᄁ ᅦ
성원에	ᄉ ᅥ ᆼ ᄋ ᅯ ᄂ ᅦ
깊이	ᄀ ᅵ ᄑ ᅵ
감사하고	ᄀ ᅡ ᆷ ᄉ ᅡ ᄒ ᅡ ᄀ ᅩ
잠시만	ᄌ ᅡ ᆷ ᄉ ᅵ ᄆ ᅡ ᆫ
눈	ᄂ ᅮ ᆫ
감아	ᄀ ᅡ ᄆ ᅡ
사진을	ᄉ ᅡ ᄌ ᅵ ᄂ ᅳ ᆯ
찍을	ᄍ ᅵ ᄀ ᅳ ᆯ
한쪽	ᄒ ᅡ ᆫ ᄍ ᅩ ᆨ
눈을	ᄂ ᅮ ᄂ ᅳ ᆯ
감는	ᄀ ᅡ ᆷ ᄂ ᅳ ᆫ
버릇이	ᄇ ᅥ ᄅ ᅳ ᄉ ᅵ
박스를	ᄇ ᅡ ᆨ ᄊ ᅳ ᄅ ᅳ ᆯ
끈으로	ᄁ ᅳ ᄂ ᅳ ᄅ ᅩ
감아라	ᄀ ᅡ ᄆ ᅡ ᄅ ᅡ
실수로	ᄉ ᅵ ᆯ ᄉ ᅮ ᄅ ᅩ
테이프를	ᄐ ᅦ ᄋ ᅵ ᄑ ᅳ ᄅ ᅳ ᆯ
버렸다	ᄇ ᅥ ᄅ ᅧ ᆮ ᄄ ᅡ
선생님은	ᄉ ᅥ ᆫ ᄉ ᅢ ᆼ ᄂ ᅵ ᄆ ᅳ ᆫ
우리들에게	ᄋ ᅮ ᄅ ᅵ ᄃ ᅳ ᄅ ᅦ ᄀ ᅦ
독서의	ᄃ ᅩ ᆨ ᄊ ᅥ ᄋ ᅴ
중요성을	ᄌ ᅮ ᆼ ᄋ ᅭ ᄉ ᅥ ᆼ ᄋ ᅳ ᆯ
늘	ᄂ ᅳ ᆯ
강조하셨어요	ᄀ ᅡ ᆼ ᄌ ᅩ ᄒ ᅡ ᄉ ᅧ ᄊ ᅥ ᄋ ᅭ
태권도는	ᄐ ᅢ ᄀ ᅯ ᆫ ᄃ ᅩ ᄂ ᅳ ᆫ
신체뿐만	ᄉ ᅵ ᆫ ᄎ ᅦ ᄈ ᅮ ᆫ ᄆ ᅡ ᆫ
아니라	ᄋ ᅡ ᄂ ᅵ ᄅ ᅡ
마음의	ᄆ ᅡ ᄋ ᅳ ᄆ ᅴ
수련을	ᄉ ᅮ ᄅ ᅧ ᄂ ᅳ ᆯ
강조한다	ᄀ ᅡ ᆼ ᄌ ᅩ ᄒ ᅡ ᆫ ᄃ ᅡ
옷을	ᄋ ᅩ ᄉ ᅳ ᆯ
갈아입고	ᄀ ᅡ ᄅ ᅡ ᄋ ᅵ ᆸ ᄁ ᅩ
올게요	ᄋ ᅩ ᆯ ᄀ ᅦ ᄋ ᅭ
수영복으로	ᄉ ᅮ ᄋ ᅧ ᆼ ᄇ ᅩ ᄀ ᅳ ᄅ ᅩ
갈아입은	ᄀ ᅡ ᄅ ᅡ ᄋ ᅵ ᄇ ᅳ ᆫ
다음	ᄃ ᅡ ᄋ ᅳ ᆷ
밖으로	ᄇ ᅡ ᄁ ᅳ ᄅ ᅩ
나갔다	ᄂ ᅡ ᄀ ᅡ ᆮ ᄄ ᅡ
생각에는	ᄉ ᅢ ᆼ ᄀ ᅡ ᄀ ᅦ ᄂ ᅳ ᆫ
버스를	ᄇ ᅥ ᄉ ᅳ ᄅ ᅳ ᆯ
갈아타는	ᄀ ᅡ ᄅ ᅡ ᄐ ᅡ ᄂ ᅳ ᆫ
사당역에서	ᄉ ᅡ ᄃ ᅡ ᆼ ᄋ ᅧ ᄀ ᅦ ᄉ ᅥ
사	ᄉ ᅡ
호선으로	ᄒ ᅩ ᄉ ᅥ ᄂ ᅳ ᄅ ᅩ
갈아타세요	ᄀ ᅡ ᄅ ᅡ ᄐ ᅡ ᄉ ᅦ ᄋ ᅭ
학생들을	ᄒ ᅡ ᆨ ᄊ ᅢ ᆼ ᄃ ᅳ ᄅ ᅳ ᆯ
가르치는	ᄀ ᅡ ᄅ ᅳ ᄎ ᅵ ᄂ ᅳ ᆫ
일을	ᄋ ᅵ ᄅ ᅳ ᆯ
좋아합니다	ᄌ ᅩ ᄋ ᅡ ᄒ ᅡ ᆷ ᄂ ᅵ ᄃ ᅡ
외국인에게	ᄋ ᅬ ᄀ ᅮ ᄀ ᅵ ᄂ ᅦ ᄀ ᅦ
태권도를	ᄐ ᅢ ᄀ ᅯ ᆫ ᄃ ᅩ ᄅ ᅳ ᆯ
가르치고	ᄀ ᅡ ᄅ ᅳ ᄎ ᅵ ᄀ ᅩ
화살표가	ᄒ ᅪ ᄉ ᅡ ᆯ ᄑ ᅭ ᄀ ᅡ
북쪽을	ᄇ ᅮ ᆨ ᄍ ᅩ ᄀ ᅳ ᆯ
가리키고	ᄀ ᅡ ᄅ ᅵ ᄏ ᅵ ᄀ ᅩ
시계는	ᄉ ᅵ ᄀ ᅨ ᄂ ᅳ ᆫ
호텔은	ᄒ ᅩ ᄐ ᅦ ᄅ ᅳ ᆫ
호화로운	ᄒ ᅩ ᄒ ᅪ ᄅ ᅩ ᄋ ᅮ ᆫ
시설들을	ᄉ ᅵ ᄉ ᅥ ᆯ ᄃ ᅳ ᄅ ᅳ ᆯ
갖추고	ᄀ ᅡ ᆮ ᄎ ᅮ ᄀ ᅩ
자신이	ᄌ ᅡ ᄉ ᅵ ᄂ ᅵ
업무에	ᄋ ᅥ ᆷ ᄆ ᅮ ᄋ ᅦ
필요한	ᄑ ᅵ ᄅ ᅭ ᄒ ᅡ ᆫ
자질을	ᄌ ᅡ ᄌ ᅵ ᄅ ᅳ ᆯ
있다고	ᄋ ᅵ ᆮ ᄄ ᅡ ᄀ ᅩ
자신합니다	ᄌ ᅡ ᄉ ᅵ ᆫ ᄒ ᅡ ᆷ ᄂ ᅵ ᄃ ᅡ
감독관이	ᄀ ᅡ ᆷ ᄃ ᅩ ᆨ ᄁ ᅪ ᄂ ᅵ
시험지를	ᄉ ᅵ ᄒ ᅥ ᆷ ᄌ ᅵ ᄅ ᅳ ᆯ
거둔	ᄀ ᅥ ᄃ ᅮ ᆫ
시험에서	ᄉ ᅵ ᄒ ᅥ ᄆ ᅦ ᄉ ᅥ
좋은	ᄌ ᅩ ᄋ ᅳ ᆫ
성적을	ᄉ ᅥ ᆼ ᄌ ᅥ ᄀ ᅳ ᆯ
거두려면	ᄀ ᅥ ᄃ ᅮ ᄅ ᅧ ᄆ ᅧ ᆫ
다해야	ᄃ ᅡ ᄒ ᅢ ᄋ ᅣ
회사의	ᄒ ᅬ ᄉ ᅡ ᄋ ᅴ
사장이라고	ᄉ ᅡ ᄌ ᅡ ᆼ ᄋ ᅵ ᄅ ᅡ ᄀ ᅩ
거짓말했다	ᄀ ᅥ ᄌ ᅵ ᆫ ᄆ ᅡ ᆯ ᄒ ᅢ ᆮ ᄄ ᅡ
거짓말하지	ᄀ ᅥ ᄌ ᅵ ᆫ ᄆ ᅡ ᆯ ᄒ ᅡ ᄌ ᅵ
사소한	ᄉ ᅡ ᄉ ᅩ ᄒ ᅡ ᆫ
일은	ᄋ ᅵ ᄅ ᅳ ᆫ
걱정하지	ᄀ ᅥ ᆨ ᄍ ᅥ ᆼ ᄒ ᅡ ᄌ ᅵ
않으려고	ᄋ ᅡ ᄂ ᅳ ᄅ ᅧ ᄀ ᅩ
노력합니다	ᄂ ᅩ ᄅ ᅧ ᄏ ᅡ ᆷ ᄂ ᅵ ᄃ ᅡ
옷걸이에	ᄋ ᅩ ᆮ ᄁ ᅥ ᄅ ᅵ ᄋ ᅦ
코트를	ᄏ ᅩ ᄐ ᅳ ᄅ ᅳ ᆯ
걸어라	ᄀ ᅥ ᄅ ᅥ ᄅ ᅡ
다가가서	ᄃ ᅡ ᄀ ᅡ ᄀ ᅡ ᄉ ᅥ
말을	ᄆ ᅡ ᄅ ᅳ ᆯ
걸었습니다	ᄀ ᅥ ᄅ ᅥ ᆮ ᄊ ᅳ ᆷ ᄂ ᅵ ᄃ ᅡ
전화	ᄌ ᅥ ᆫ ᄒ ᅪ
거셨어요	ᄀ ᅥ ᄉ ᅧ ᄊ ᅥ ᄋ ᅭ
벽에	ᄇ ᅧ ᄀ ᅦ
옷이	ᄋ ᅩ ᄉ ᅵ
걸려	ᄀ ᅥ ᆯ ᄅ ᅧ
감기에	ᄀ ᅡ ᆷ ᄀ ᅵ ᄋ ᅦ
걸렸어요	ᄀ ᅥ ᆯ ᄅ ᅧ ᄊ ᅥ ᄋ ᅭ
끝내려면	ᄁ ᅳ ᆫ ᄂ ᅢ ᄅ ᅧ ᄆ ᅧ ᆫ
두	ᄃ ᅮ
시간쯤	ᄉ ᅵ ᄀ ᅡ ᆫ ᄍ ᅳ ᆷ
걸릴	ᄀ ᅥ ᆯ ᄅ ᅵ ᆯ
집에서	ᄌ ᅵ ᄇ ᅦ ᄉ ᅥ
회사까지	ᄒ ᅬ ᄉ ᅡ ᄁ ᅡ ᄌ ᅵ
지하철로	ᄌ ᅵ ᄒ ᅡ ᄎ ᅥ ᆯ ᄅ ᅩ
얼마나	ᄋ ᅥ ᆯ ᄆ ᅡ ᄂ ᅡ
걸려요	ᄀ ᅥ ᆯ ᄅ ᅧ ᄋ ᅭ
건너면	ᄀ ᅥ ᆫ ᄂ ᅥ ᄆ ᅧ ᆫ
은행이	ᄋ ᅳ ᆫ ᄒ ᅢ ᆼ ᄋ ᅵ
돌다리도	ᄃ ᅩ ᆯ ᄃ ᅡ ᄅ ᅵ ᄃ ᅩ
두드려	ᄃ ᅮ ᄃ ᅳ ᄅ ᅧ
보고	ᄇ ᅩ ᄀ ᅩ
건너라	ᄀ ᅥ ᆫ ᄂ ᅥ ᄅ ᅡ
보통은	ᄇ ᅩ ᄐ ᅩ ᆼ ᄋ ᅳ ᆫ
걸어가요	ᄀ ᅥ ᄅ ᅥ ᄀ ᅡ ᄋ ᅭ
저쪽으로	ᄌ ᅥ ᄍ ᅩ ᄀ ᅳ ᄅ ᅩ
걸어가십시오	ᄀ ᅥ ᄅ ᅥ ᄀ ᅡ ᄉ ᅵ ᆸ ᄊ ᅵ ᄋ ᅩ
여기까지	ᄋ ᅧ ᄀ ᅵ ᄁ ᅡ ᄌ ᅵ
걸어왔어요	ᄀ ᅥ ᄅ ᅥ ᄋ ᅪ ᄊ ᅥ ᄋ ᅭ
우리가	ᄋ ᅮ ᄅ ᅵ ᄀ ᅡ
걸어온	ᄀ ᅥ ᄅ ᅥ ᄋ ᅩ ᆫ
거지	ᄀ ᅥ ᄌ ᅵ
맨발로	ᄆ ᅢ ᆫ ᄇ ᅡ ᆯ ᄅ ᅩ
걷지	ᄀ ᅥ ᆮ ᄍ ᅵ
걷다	ᄀ ᅥ ᆮ ᄄ ᅡ
생각이	ᄉ ᅢ ᆼ ᄀ ᅡ ᄀ ᅵ
떠올랐어요	ᄄ ᅥ ᄋ ᅩ ᆯ ᄅ ᅡ ᄊ ᅥ ᄋ ᅭ
나무	ᄂ ᅡ ᄆ ᅮ
밑에서	ᄆ ᅵ ᄐ ᅦ ᄉ ᅥ
비가	ᄇ ᅵ ᄀ ᅡ
그치기를	ᄀ ᅳ ᄎ ᅵ ᄀ ᅵ ᄅ ᅳ ᆯ
기다렸다	ᄀ ᅵ ᄃ ᅡ ᄅ ᅧ ᆮ ᄄ ᅡ
울음을	ᄋ ᅮ ᄅ ᅳ ᄆ ᅳ ᆯ
그쳤어요	ᄀ ᅳ ᄎ ᅥ ᄊ ᅥ ᄋ ᅭ
예전	ᄋ ᅨ ᄌ ᅥ ᆫ
그만두셨어요	ᄀ ᅳ ᄆ ᅡ ᆫ ᄃ ᅮ ᄉ ᅧ ᄊ ᅥ ᄋ ᅭ
저	ᄌ ᅥ
그만두겠습니다	ᄀ ᅳ ᄆ ᅡ ᆫ ᄃ ᅮ ᄀ ᅦ ᆮ ᄊ ᅳ ᆷ ᄂ ᅵ ᄃ ᅡ
방송국에서	ᄇ ᅡ ᆼ ᄉ ᅩ ᆼ ᄀ ᅮ ᄀ ᅦ ᄉ ᅥ
근무하고	ᄀ ᅳ ᆫ ᄆ ᅮ ᄒ ᅡ ᄀ ᅩ
보통	ᄇ ᅩ ᄐ ᅩ ᆼ
하루에	ᄒ ᅡ ᄅ ᅮ ᄋ ᅦ
근무하세요	ᄀ ᅳ ᆫ ᄆ ᅮ ᄒ ᅡ ᄉ ᅦ ᄋ ᅭ
그러는	ᄀ ᅳ ᄅ ᅥ ᄂ ᅳ ᆫ
좋을	ᄌ ᅩ ᄋ ᅳ ᆯ
그러지	ᄀ ᅳ ᄅ ᅥ ᄌ ᅵ
않겠다고	ᄋ ᅡ ᆫ ᄏ ᅦ ᆮ ᄄ ᅡ ᄀ ᅩ
약속했잖아	ᄋ ᅣ ᆨ ᄊ ᅩ ᄏ ᅢ ᆮ ᄍ ᅡ ᄂ ᅡ
그림을	ᄀ ᅳ ᄅ ᅵ ᄆ ᅳ ᆯ
그리지만	ᄀ ᅳ ᄅ ᅵ ᄌ ᅵ ᄆ ᅡ ᆫ
그림	ᄀ ᅳ ᄅ ᅵ ᆷ
그리는	ᄀ ᅳ ᄅ ᅵ ᄂ ᅳ ᆫ
누구를	ᄂ ᅮ ᄀ ᅮ ᄅ ᅳ ᆯ
그리고	ᄀ ᅳ ᄅ ᅵ ᄀ ᅩ
계신	ᄀ ᅨ ᄉ ᅵ ᆫ
선생님을	ᄉ ᅥ ᆫ ᄉ ᅢ ᆼ ᄂ ᅵ ᄆ ᅳ ᆯ
만나	ᄆ ᅡ ᆫ ᄂ ᅡ
뵙기를	ᄇ ᅬ ᆸ ᄁ ᅵ ᄅ ᅳ ᆯ
기대하고	ᄀ ᅵ ᄃ ᅢ ᄒ ᅡ ᄀ ᅩ
기대하지	ᄀ ᅵ ᄃ ᅢ ᄒ ᅡ ᄌ ᅵ
순서를	ᄉ ᅮ ᆫ ᄉ ᅥ ᄅ ᅳ ᆯ
기다려	ᄀ ᅵ ᄃ ᅡ ᄅ ᅧ
기다리는	ᄀ ᅵ ᄃ ᅡ ᄅ ᅵ ᄂ ᅳ ᆫ
중입니다	ᄌ ᅮ ᆼ ᄋ ᅵ ᆷ ᄂ ᅵ ᄃ ᅡ
아빠가	ᄋ ᅡ ᄈ ᅡ ᄀ ᅡ
결혼기념일을	ᄀ ᅧ ᆯ ᄒ ᅩ ᆫ ᄀ ᅵ ᄂ ᅧ ᄆ ᅵ ᄅ ᅳ ᆯ
기억하지	ᄀ ᅵ ᄋ ᅥ ᄏ ᅡ ᄌ ᅵ
못해	ᄆ ᅩ ᄐ ᅢ
기억하시겠어요	ᄀ ᅵ ᄋ ᅥ ᄏ ᅡ ᄉ ᅵ ᄀ ᅦ ᄊ ᅥ ᄋ ᅭ
낯은	ᄂ ᅡ ᄎ ᅳ ᆫ
익은데	ᄋ ᅵ ᄀ ᅳ ᆫ ᄃ ᅦ
이름이	ᄋ ᅵ ᄅ ᅳ ᄆ ᅵ
기억나지	ᄀ ᅵ ᄋ ᅥ ᆼ ᄂ ᅡ ᄌ ᅵ
기억나세요	ᄀ ᅵ ᄋ ᅥ ᆼ ᄂ ᅡ ᄉ ᅦ ᄋ ᅭ
어머님이	ᄋ ᅥ ᄆ ᅥ ᄂ ᅵ ᄆ ᅵ
기뻐하시겠어요	ᄀ ᅵ ᄈ ᅥ ᄒ ᅡ ᄉ ᅵ ᄀ ᅦ ᄊ ᅥ ᄋ ᅭ
아직	ᄋ ᅡ ᄌ ᅵ ᆨ
이긴	ᄋ ᅵ ᄀ ᅵ ᆫ
아니니까	ᄋ ᅡ ᄂ ᅵ ᄂ ᅵ ᄁ ᅡ
기뻐하기에는	ᄀ ᅵ ᄈ ᅥ ᄒ ᅡ ᄀ ᅵ ᄋ ᅦ ᄂ ᅳ ᆫ
이릅니다	ᄋ ᅵ ᄅ ᅳ ᆷ ᄂ ᅵ ᄃ ᅡ
엄마	ᄋ ᅥ ᆷ ᄆ ᅡ
고양이를	ᄀ ᅩ ᄋ ᅣ ᆼ ᄋ ᅵ ᄅ ᅳ ᆯ
기르게	ᄀ ᅵ ᄅ ᅳ ᄀ ᅦ
턱수염을	ᄐ ᅥ ᆨ ᄊ ᅮ ᄋ ᅧ ᄆ ᅳ ᆯ
기른	ᄀ ᅵ ᄅ ᅳ ᆫ
집중력을	ᄌ ᅵ ᆸ ᄍ ᅮ ᆼ ᄂ ᅧ ᄀ ᅳ ᆯ
기르는	ᄀ ᅵ ᄅ ᅳ ᄂ ᅳ ᆫ
공부를	ᄀ ᅩ ᆼ ᄇ ᅮ ᄅ ᅳ ᆯ
잘하는	ᄌ ᅡ ᆯ ᄒ ᅡ ᄂ ᅳ ᆫ
비결입니다	ᄇ ᅵ ᄀ ᅧ ᄅ ᅵ ᆷ ᄂ ᅵ ᄃ ᅡ
일기장에	ᄋ ᅵ ᆯ ᄀ ᅵ ᄌ ᅡ ᆼ ᄋ ᅦ
있었던	ᄋ ᅵ ᄊ ᅥ ᆮ ᄄ ᅥ ᆫ
모두	ᄆ ᅩ ᄃ ᅮ
기록합니다	ᄀ ᅵ ᄅ ᅩ ᄏ ᅡ ᆷ ᄂ ᅵ ᄃ ᅡ
한국의	ᄒ ᅡ ᆫ ᄀ ᅮ ᄀ ᅴ
자동차	ᄌ ᅡ ᄃ ᅩ ᆼ ᄎ ᅡ
산업은	ᄉ ᅡ ᄂ ᅥ ᄇ ᅳ ᆫ
세계	ᄉ ᅦ ᄀ ᅨ
위를	ᄋ ᅱ ᄅ ᅳ ᆯ
기록하고	ᄀ ᅵ ᄅ ᅩ ᄏ ᅡ ᄀ ᅩ
몸을	ᄆ ᅩ ᄆ ᅳ ᆯ
옆으로	ᄋ ᅧ ᄑ ᅳ ᄅ ᅩ
기울여	ᄀ ᅵ ᄋ ᅮ ᄅ ᅧ
대체로	ᄃ ᅢ ᄎ ᅦ ᄅ ᅩ
선생님의	ᄉ ᅥ ᆫ ᄉ ᅢ ᆼ ᄂ ᅵ ᄆ ᅴ
말씀에	ᄆ ᅡ ᆯ ᄊ ᅳ ᄆ ᅦ
주의를	ᄌ ᅮ ᄋ ᅴ ᄅ ᅳ ᆯ
기울이지	ᄀ ᅵ ᄋ ᅮ ᄅ ᅵ ᄌ ᅵ
라디오	ᄅ ᅡ ᄃ ᅵ ᄋ ᅩ
고치는	ᄀ ᅩ ᄎ ᅵ ᄂ ᅳ ᆫ
걸릴까요	ᄀ ᅥ ᆯ ᄅ ᅵ ᆯ ᄁ ᅡ ᄋ ᅭ
문장에서	ᄆ ᅮ ᆫ ᄌ ᅡ ᆼ ᄋ ᅦ ᄉ ᅥ
틀린	ᄐ ᅳ ᆯ ᄅ ᅵ ᆫ
부분을	ᄇ ᅮ ᄇ ᅮ ᄂ ᅳ ᆯ
고치세요	ᄀ ᅩ ᄎ ᅵ ᄉ ᅦ ᄋ ᅭ
밑줄	ᄆ ᅵ ᆮ ᄍ ᅮ ᆯ
친	ᄎ ᅵ ᆫ
이탤릭으로	ᄋ ᅵ ᄐ ᅢ ᆯ ᄅ ᅵ ᄀ ᅳ ᄅ ᅩ
고쳐라	ᄀ ᅩ ᄎ ᅥ ᄅ ᅡ
대학에서	ᄃ ᅢ ᄒ ᅡ ᄀ ᅦ ᄉ ᅥ
국문학을	ᄀ ᅮ ᆼ ᄆ ᅮ ᆫ ᄒ ᅡ ᄀ ᅳ ᆯ
공부할	ᄀ ᅩ ᆼ ᄇ ᅮ ᄒ ᅡ ᆯ
가을은	ᄀ ᅡ ᄋ ᅳ ᄅ ᅳ ᆫ
공부하기에	ᄀ ᅩ ᆼ ᄇ ᅮ ᄒ ᅡ ᄀ ᅵ ᄋ ᅦ
제일	ᄌ ᅦ ᄋ ᅵ ᆯ
계절이	ᄀ ᅨ ᄌ ᅥ ᄅ ᅵ
중에서	ᄌ ᅮ ᆼ ᄋ ᅦ ᄉ ᅥ
하나를	ᄒ ᅡ ᄂ ᅡ ᄅ ᅳ ᆯ
고르세요	ᄀ ᅩ ᄅ ᅳ ᄉ ᅦ ᄋ ᅭ
고르셨어요	ᄀ ᅩ ᄅ ᅳ ᄉ ᅧ ᄊ ᅥ ᄋ ᅭ
나이를	ᄂ ᅡ ᄋ ᅵ ᄅ ᅳ ᆯ
고려해	ᄀ ᅩ ᄅ ᅧ ᄒ ᅢ
주셨으면	ᄌ ᅮ ᄉ ᅧ ᄊ ᅳ ᄆ ᅧ ᆫ
좋겠어요	ᄌ ᅩ ᄏ ᅦ ᄊ ᅥ ᄋ ᅭ
점을	ᄌ ᅥ ᄆ ᅳ ᆯ
고려했을	ᄀ ᅩ ᄅ ᅧ ᄒ ᅢ ᄊ ᅳ ᆯ
가지	ᄀ ᅡ ᄌ ᅵ
낫다	ᄂ ᅡ ᆮ ᄄ ᅡ
사서	ᄉ ᅡ ᄉ ᅥ
고생해	ᄀ ᅩ ᄉ ᅢ ᆼ ᄒ ᅢ
오시느라	ᄋ ᅩ ᄉ ᅵ ᄂ ᅳ ᄅ ᅡ
고생하지	ᄀ ᅩ ᄉ ᅢ ᆼ ᄒ ᅡ ᄌ ᅵ
않으셨어요	ᄋ ᅡ ᄂ ᅳ ᄉ ᅧ ᄊ ᅥ ᄋ ᅭ
부산은	ᄇ ᅮ ᄉ ᅡ ᄂ ᅳ ᆫ
구경할	ᄀ ᅮ ᄀ ᅧ ᆼ ᄒ ᅡ ᆯ
곳이	ᄀ ᅩ ᄉ ᅵ
많아요	ᄆ ᅡ ᄂ ᅡ ᄋ ᅭ
어디를	ᄋ ᅥ ᄃ ᅵ ᄅ ᅳ ᆯ
구경하고	ᄀ ᅮ ᄀ ᅧ ᆼ ᄒ ᅡ ᄀ ᅩ
싶으세요	ᄉ ᅵ ᄑ ᅳ ᄉ ᅦ ᄋ ᅭ
일자리를	ᄋ ᅵ ᆯ ᄌ ᅡ ᄅ ᅵ ᄅ ᅳ ᆯ
구하고	ᄀ ᅮ ᄒ ᅡ ᄀ ᅩ
직장은	ᄌ ᅵ ᆨ ᄍ ᅡ ᆼ ᄋ ᅳ ᆫ
구하셨어요	ᄀ ᅮ ᄒ ᅡ ᄉ ᅧ ᄊ ᅥ ᄋ ᅭ
주인을	ᄌ ᅮ ᄋ ᅵ ᄂ ᅳ ᆯ
구하기	ᄀ ᅮ ᄒ ᅡ ᄀ ᅵ
강으로	ᄀ ᅡ ᆼ ᄋ ᅳ ᄅ ᅩ
뛰어들었다	ᄄ ᅱ ᄋ ᅥ ᄃ ᅳ ᄅ ᅥ ᆮ ᄄ ᅡ
의사가	ᄋ ᅴ ᄉ ᅡ ᄀ ᅡ
목숨을	ᄆ ᅩ ᆨ ᄊ ᅮ ᄆ ᅳ ᆯ
구해	ᄀ ᅮ ᄒ ᅢ
냈다	ᄂ ᅢ ᆮ ᄄ ᅡ
빵을	ᄈ ᅡ ᆼ ᄋ ᅳ ᆯ
굽고	ᄀ ᅮ ᆸ ᄁ ᅩ
소시지를	ᄉ ᅩ ᄉ ᅵ ᄌ ᅵ ᄅ ᅳ ᆯ
튀기는	ᄐ ᅱ ᄀ ᅵ ᄂ ᅳ ᆫ
것보다	ᄀ ᅥ ᆮ ᄈ ᅩ ᄃ ᅡ
석쇠에	ᄉ ᅥ ᆨ ᄊ ᅬ ᄋ ᅦ
굽는	ᄀ ᅮ ᆷ ᄂ ᅳ ᆫ
좋아해	ᄌ ᅩ ᄋ ᅡ ᄒ ᅢ
축구는	ᄎ ᅮ ᆨ ᄁ ᅮ ᄂ ᅳ ᆫ
열한	ᄋ ᅧ ᆯ ᄒ ᅡ ᆫ
명으로	ᄆ ᅧ ᆼ ᄋ ᅳ ᄅ ᅩ
구성돼	ᄀ ᅮ ᄉ ᅥ ᆼ ᄃ ᅫ
문제	ᄆ ᅮ ᆫ ᄌ ᅦ
위원회가	ᄋ ᅱ ᄋ ᅯ ᆫ ᄒ ᅬ ᄀ ᅡ
구성됐습니다	ᄀ ᅮ ᄉ ᅥ ᆼ ᄃ ᅫ ᆮ ᄊ ᅳ ᆷ ᄂ ᅵ ᄃ ᅡ
사건은	ᄉ ᅡ ᄀ ᅥ ᄂ ᅳ ᆫ
마약과	ᄆ ᅡ ᄋ ᅣ ᆨ ᄁ ᅪ
관련되어	ᄀ ᅪ ᆯ ᄅ ᅧ ᆫ ᄃ ᅬ ᄋ ᅥ
동생과	ᄃ ᅩ ᆼ ᄉ ᅢ ᆼ ᄀ ᅪ
관련돼	ᄀ ᅪ ᆯ ᄅ ᅧ ᆫ ᄃ ᅫ
취미는	ᄎ ᅱ ᄆ ᅵ ᄂ ᅳ ᆫ
길거리의	ᄀ ᅵ ᆯ ᄀ ᅥ ᄅ ᅵ ᄋ ᅴ
사람들을	ᄉ ᅡ ᄅ ᅡ ᆷ ᄃ ᅳ ᄅ ᅳ ᆯ
관찰하는	ᄀ ᅪ ᆫ ᄎ ᅡ ᆯ ᄒ ᅡ ᄂ ᅳ ᆫ
이상한	ᄋ ᅵ ᄉ ᅡ ᆼ ᄒ ᅡ ᆫ
남자는	ᄂ ᅡ ᆷ ᄌ ᅡ ᄂ ᅳ ᆫ
개미에	ᄀ ᅢ ᄆ ᅵ ᄋ ᅦ
관찰하면서	ᄀ ᅪ ᆫ ᄎ ᅡ ᆯ ᄒ ᅡ ᄆ ᅧ ᆫ ᄉ ᅥ
즐거움을	ᄌ ᅳ ᆯ ᄀ ᅥ ᄋ ᅮ ᄆ ᅳ ᆯ
찾았다	ᄎ ᅡ ᄌ ᅡ ᆮ ᄄ ᅡ
사고에	ᄉ ᅡ ᄀ ᅩ ᄋ ᅦ
관해	ᄀ ᅪ ᆫ ᄒ ᅢ
없습니다	ᄋ ᅥ ᆸ ᄊ ᅳ ᆷ ᄂ ᅵ ᄃ ᅡ
한국에	ᄒ ᅡ ᆫ ᄀ ᅮ ᄀ ᅦ
관한	ᄀ ᅪ ᆫ ᄒ ᅡ ᆫ
책들은	ᄎ ᅢ ᆨ ᄄ ᅳ ᄅ ᅳ ᆫ
있나요	ᄋ ᅵ ᆫ ᄂ ᅡ ᄋ ᅭ
어렸을	ᄋ ᅥ ᄅ ᅧ ᄊ ᅳ ᆯ
어려움을	ᄋ ᅥ ᄅ ᅧ ᄋ ᅮ ᄆ ᅳ ᆯ
겪었어요	ᄀ ᅧ ᄁ ᅥ ᄊ ᅥ ᄋ ᅭ
결혼한	ᄀ ᅧ ᆯ ᄒ ᅩ ᆫ ᄒ ᅡ ᆫ
차례	ᄎ ᅡ ᄅ ᅨ
위기를	ᄋ ᅱ ᄀ ᅵ ᄅ ᅳ ᆯ
겪었습니다	ᄀ ᅧ ᄁ ᅥ ᆮ ᄊ ᅳ ᆷ ᄂ ᅵ ᄃ ᅡ
그와	ᄀ ᅳ ᄋ ᅪ
결혼하기로	ᄀ ᅧ ᆯ ᄒ ᅩ ᆫ ᄒ ᅡ ᄀ ᅵ ᄅ ᅩ
마음먹었다	ᄆ ᅡ ᄋ ᅳ ᆷ ᄆ ᅥ ᄀ ᅥ ᆮ ᄄ ᅡ
막	ᄆ ᅡ ᆨ
결혼했어요	ᄀ ᅧ ᆯ ᄒ ᅩ ᆫ ᄒ ᅢ ᄊ ᅥ ᄋ ᅭ
결정된	ᄀ ᅧ ᆯ ᄌ ᅥ ᆼ ᄃ ᅬ ᆫ
이사회에서	ᄋ ᅵ ᄉ ᅡ ᄒ ᅬ ᄋ ᅦ ᄉ ᅥ
해고하기로	ᄒ ᅢ ᄀ ᅩ ᄒ ᅡ ᄀ ᅵ ᄅ ᅩ
결정됐다	ᄀ ᅧ ᆯ ᄌ ᅥ ᆼ ᄃ ᅫ ᆮ ᄄ ᅡ
어디로	ᄋ ᅥ ᄃ ᅵ ᄅ ᅩ
피서를	ᄑ ᅵ ᄉ ᅥ ᄅ ᅳ ᆯ
갈	ᄀ ᅡ ᆯ
지	ᄌ ᅵ
결정하지	ᄀ ᅧ ᆯ ᄌ ᅥ ᆼ ᄒ ᅡ ᄌ ᅵ
심사위원들이	ᄉ ᅵ ᆷ ᄉ ᅡ ᄋ ᅱ ᄋ ᅯ ᆫ ᄃ ᅳ ᄅ ᅵ
우승자로	ᄋ ᅮ ᄉ ᅳ ᆼ ᄌ ᅡ ᄅ ᅩ
결정했어요	ᄀ ᅧ ᆯ ᄌ ᅥ ᆼ ᄒ ᅢ ᄊ ᅥ ᄋ ᅭ
이혼을	ᄋ ᅵ ᄒ ᅩ ᄂ ᅳ ᆯ
결심했다	ᄀ ᅧ ᆯ ᄉ ᅵ ᆷ ᄒ ᅢ ᆮ ᄄ ᅡ
다이어트를	ᄃ ᅡ ᄋ ᅵ ᄋ ᅥ ᄐ ᅳ ᄅ ᅳ ᆯ
엄격하게	ᄋ ᅥ ᆷ ᄀ ᅧ ᄏ ᅡ ᄀ ᅦ
하기로	ᄒ ᅡ ᄀ ᅵ ᄅ ᅩ
결심했어요	ᄀ ᅧ ᆯ ᄉ ᅵ ᆷ ᄒ ᅢ ᄊ ᅥ ᄋ ᅭ
이민자들은	ᄋ ᅵ ᄆ ᅵ ᆫ ᄌ ᅡ ᄃ ᅳ ᄅ ᅳ ᆫ
육체적	ᄋ ᅲ ᆨ ᄎ ᅦ ᄌ ᅥ ᆨ
정신적	ᄌ ᅥ ᆼ ᄉ ᅵ ᆫ ᄌ ᅥ ᆨ
고통을	ᄀ ᅩ ᄐ ᅩ ᆼ ᄋ ᅳ ᆯ
견뎌	ᄀ ᅧ ᆫ ᄃ ᅧ
이상	ᄋ ᅵ ᄉ ᅡ ᆼ
견디겠어	ᄀ ᅧ ᆫ ᄃ ᅵ ᄀ ᅦ ᄊ ᅥ
오자마자	ᄋ ᅩ ᄌ ᅡ ᄆ ᅡ ᄌ ᅡ
문화적	ᄆ ᅮ ᆫ ᄒ ᅪ ᄌ ᅥ ᆨ
충격을	ᄎ ᅮ ᆼ ᄀ ᅧ ᄀ ᅳ ᆯ
경험했어요	ᄀ ᅧ ᆼ ᄒ ᅥ ᆷ ᄒ ᅢ ᄊ ᅥ ᄋ ᅭ
여러	ᄋ ᅧ ᄅ ᅥ
생활방식을	ᄉ ᅢ ᆼ ᄒ ᅪ ᆯ ᄇ ᅡ ᆼ ᄉ ᅵ ᄀ ᅳ ᆯ
경험할	ᄀ ᅧ ᆼ ᄒ ᅥ ᆷ ᄒ ᅡ ᆯ
계산했나	ᄀ ᅨ ᄉ ᅡ ᆫ ᄒ ᅢ ᆫ ᄂ ᅡ
카드로	ᄏ ᅡ ᄃ ᅳ ᄅ ᅩ
계산하겠습니다	ᄀ ᅨ ᄉ ᅡ ᆫ ᄒ ᅡ ᄀ ᅦ ᆮ ᄊ ᅳ ᆷ ᄂ ᅵ ᄃ ᅡ
사장님이	ᄉ ᅡ ᄌ ᅡ ᆼ ᄂ ᅵ ᄆ ᅵ
기다리고	ᄀ ᅵ ᄃ ᅡ ᄅ ᅵ ᄀ ᅩ
계십니다	ᄀ ᅨ ᄉ ᅵ ᆷ ᄂ ᅵ ᄃ ᅡ
누워	ᄂ ᅮ ᄋ ᅯ
밤새도록	ᄇ ᅡ ᆷ ᄉ ᅢ ᄃ ᅩ ᄅ ᅩ ᆨ
얘기를	ᄋ ᅤ ᄀ ᅵ ᄅ ᅳ ᆯ
계속했습니다	ᄀ ᅨ ᄉ ᅩ ᄏ ᅢ ᆮ ᄊ ᅳ ᆷ ᄂ ᅵ ᄃ ᅡ
계속해서	ᄀ ᅨ ᄉ ᅩ ᄏ ᅢ ᄉ ᅥ
새로운	ᄉ ᅢ ᄅ ᅩ ᄋ ᅮ ᆫ
변명거리를	ᄇ ᅧ ᆫ ᄆ ᅧ ᆼ ᄀ ᅥ ᄅ ᅵ ᄅ ᅳ ᆯ
만들어	ᄆ ᅡ ᆫ ᄃ ᅳ ᄅ ᅥ
이렇게	ᄋ ᅵ ᄅ ᅥ ᄏ ᅦ
무더운	ᄆ ᅮ ᄃ ᅥ ᄋ ᅮ ᆫ
날씨가	ᄂ ᅡ ᆯ ᄊ ᅵ ᄀ ᅡ
오래	ᄋ ᅩ ᄅ ᅢ
계속되지는	ᄀ ᅨ ᄉ ᅩ ᆨ ᄄ ᅬ ᄌ ᅵ ᄂ ᅳ ᆫ
않을	ᄋ ᅡ ᄂ ᅳ ᆯ
회의가	ᄒ ᅬ ᄋ ᅴ ᄀ ᅡ
늦도록	ᄂ ᅳ ᆮ ᄄ ᅩ ᄅ ᅩ ᆨ
계속됐다	ᄀ ᅨ ᄉ ᅩ ᆨ ᄄ ᅫ ᆮ ᄄ ᅡ
당장은	ᄃ ᅡ ᆼ ᄌ ᅡ ᆼ ᄋ ᅳ ᆫ
할	ᄒ ᅡ ᆯ
일이	ᄋ ᅵ ᄅ ᅵ
숙제는	ᄉ ᅮ ᆨ ᄍ ᅦ ᄂ ᅳ ᆫ
언제	ᄋ ᅥ ᆫ ᄌ ᅦ
해결하기	ᄒ ᅢ ᄀ ᅧ ᆯ ᄒ ᅡ ᄀ ᅵ
전에는	ᄌ ᅥ ᄂ ᅦ ᄂ ᅳ ᆫ
가	ᄀ ᅡ
직장	ᄌ ᅵ ᆨ ᄍ ᅡ ᆼ
상사와의	ᄉ ᅡ ᆼ ᄉ ᅡ ᄋ ᅪ ᄋ ᅴ
갈등은	ᄀ ᅡ ᆯ ᄄ ᅳ ᆼ ᄋ ᅳ ᆫ
해결하세요	ᄒ ᅢ ᄀ ᅧ ᆯ ᄒ ᅡ ᄉ ᅦ ᄋ ᅭ
아내는	ᄋ ᅡ ᄂ ᅢ ᄂ ᅳ ᆫ
기쁨의	ᄀ ᅵ ᄈ ᅳ ᄆ ᅴ
눈물을	ᄂ ᅮ ᆫ ᄆ ᅮ ᄅ ᅳ ᆯ
흘렸다	ᄒ ᅳ ᆯ ᄅ ᅧ ᆮ ᄄ ᅡ
흘린	ᄒ ᅳ ᆯ ᄅ ᅵ ᆫ
탬버린을	ᄐ ᅢ ᆷ ᄇ ᅥ ᄅ ᅵ ᄂ ᅳ ᆯ
흔들면서	ᄒ ᅳ ᆫ ᄃ ᅳ ᆯ ᄆ ᅧ ᆫ ᄉ ᅥ
노래를	ᄂ ᅩ ᄅ ᅢ ᄅ ᅳ ᆯ
불렀다	ᄇ ᅮ ᆯ ᄅ ᅥ ᆮ ᄄ ᅡ
아니라고	ᄋ ᅡ ᄂ ᅵ ᄅ ᅡ ᄀ ᅩ
말하는	ᄆ ᅡ ᆯ ᄒ ᅡ ᄂ ᅳ ᆫ
대신	ᄃ ᅢ ᄉ ᅵ ᆫ
고개를	ᄀ ᅩ ᄀ ᅢ ᄅ ᅳ ᆯ
흔들었다	ᄒ ᅳ ᆫ ᄃ ᅳ ᄅ ᅥ ᆮ ᄄ ᅡ
물은	ᄆ ᅮ ᄅ ᅳ ᆫ
높은	ᄂ ᅩ ᄑ ᅳ ᆫ
곳에서	ᄀ ᅩ ᄉ ᅦ ᄉ ᅥ
낮은	ᄂ ᅡ ᄌ ᅳ ᆫ
곳으로	ᄀ ᅩ ᄉ ᅳ ᄅ ᅩ
흐른다	ᄒ ᅳ ᄅ ᅳ ᆫ ᄃ ᅡ
시간이	ᄉ ᅵ ᄀ ᅡ ᄂ ᅵ
흐르면	ᄒ ᅳ ᄅ ᅳ ᄆ ᅧ ᆫ
괜찮아질	ᄀ ᅫ ᆫ ᄎ ᅡ ᄂ ᅡ ᄌ ᅵ ᆯ
가방	ᄀ ᅡ ᄇ ᅡ ᆼ
산	ᄉ ᅡ ᆫ
후회하고	ᄒ ᅮ ᄒ ᅬ ᄒ ᅡ ᄀ ᅩ
버린	ᄇ ᅥ ᄅ ᅵ ᆫ
지금은	ᄌ ᅵ ᄀ ᅳ ᄆ ᅳ ᆫ
후회해요	ᄒ ᅮ ᄒ ᅬ ᄒ ᅢ ᄋ ᅭ
영수증을	ᄋ ᅧ ᆼ ᄉ ᅮ ᄌ ᅳ ᆼ ᄋ ᅳ ᆯ
확인하고	ᄒ ᅪ ᄀ ᅵ ᆫ ᄒ ᅡ ᄀ ᅩ
환불해	ᄒ ᅪ ᆫ ᄇ ᅮ ᆯ ᄒ ᅢ
방을	ᄇ ᅡ ᆼ ᄋ ᅳ ᆯ
창고로	ᄎ ᅡ ᆼ ᄀ ᅩ ᄅ ᅩ
활용하고	ᄒ ᅪ ᄅ ᅭ ᆼ ᄒ ᅡ ᄀ ᅩ
성공은	ᄉ ᅥ ᆼ ᄀ ᅩ ᆼ ᄋ ᅳ ᆫ
시간을	ᄉ ᅵ ᄀ ᅡ ᄂ ᅳ ᆯ
활용하는가에	ᄒ ᅪ ᄅ ᅭ ᆼ ᄒ ᅡ ᄂ ᅳ ᆫ ᄀ ᅡ ᄋ ᅦ
화나신	ᄒ ᅪ ᄂ ᅡ ᄉ ᅵ ᆫ
화났어	ᄒ ᅪ ᄂ ᅡ ᄊ ᅥ
배는	ᄇ ᅢ ᄂ ᅳ ᆫ
일본을	ᄋ ᅵ ᆯ ᄇ ᅩ ᄂ ᅳ ᆯ
향하고	ᄒ ᅣ ᆼ ᄒ ᅡ ᄀ ᅩ
앉아	ᄋ ᅡ ᆫ ᄌ ᅡ
이번에는	ᄋ ᅵ ᄇ ᅥ ᄂ ᅦ ᄂ ᅳ ᆫ
너에게	ᄂ ᅥ ᄋ ᅦ ᄀ ᅦ
이기고	ᄋ ᅵ ᄀ ᅵ ᄀ ᅩ
싶어	ᄉ ᅵ ᄑ ᅥ
이겨	ᄋ ᅵ ᄀ ᅧ
내지	ᄂ ᅢ ᄌ ᅵ
못하면	ᄆ ᅩ ᄐ ᅡ ᄆ ᅧ ᆫ
성공할	ᄉ ᅥ ᆼ ᄀ ᅩ ᆼ ᄒ ᅡ ᆯ
없어	ᄋ ᅥ ᆸ ᄊ ᅥ
연극은	ᄋ ᅧ ᆫ ᄀ ᅳ ᄀ ᅳ ᆫ
이해하기가	ᄋ ᅵ ᄒ ᅢ ᄒ ᅡ ᄀ ᅵ ᄀ ᅡ
어려웠다	ᄋ ᅥ ᄅ ᅧ ᄋ ᅯ ᆮ ᄄ ᅡ
교사는	ᄀ ᅭ ᄉ ᅡ ᄂ ᅳ ᆫ
이해할	ᄋ ᅵ ᄒ ᅢ ᄒ ᅡ ᆯ
실은	ᄉ ᅵ ᄅ ᅳ ᆫ
이혼했어	ᄋ ᅵ ᄒ ᅩ ᆫ ᄒ ᅢ ᄊ ᅥ
부모님이	ᄇ ᅮ ᄆ ᅩ ᄂ ᅵ ᄆ ᅵ
이혼하신	ᄋ ᅵ ᄒ ᅩ ᆫ ᄒ ᅡ ᄉ ᅵ ᆫ
이후로	ᄋ ᅵ ᄒ ᅮ ᄅ ᅩ
살고	ᄉ ᅡ ᆯ ᄀ ᅩ
야	ᄋ ᅣ
오랜만이야	ᄋ ᅩ ᄅ ᅢ ᆫ ᄆ ᅡ ᄂ ᅵ ᄋ ᅣ
얼굴	ᄋ ᅥ ᆯ ᄀ ᅮ ᆯ
잊어버리겠어	ᄋ ᅵ ᄌ ᅥ ᄇ ᅥ ᄅ ᅵ ᄀ ᅦ ᄊ ᅥ
우산	ᄋ ᅮ ᄉ ᅡ ᆫ
가져오는	ᄀ ᅡ ᄌ ᅥ ᄋ ᅩ ᄂ ᅳ ᆫ
잊어버렸어	ᄋ ᅵ ᄌ ᅥ ᄇ ᅥ ᄅ ᅧ ᄊ ᅥ
만화책	ᄆ ᅡ ᆫ ᄒ ᅪ ᄎ ᅢ ᆨ
읽는	ᄋ ᅵ ᆼ ᄂ ᅳ ᆫ
좋아하세요	ᄌ ᅩ ᄋ ᅡ ᄒ ᅡ ᄉ ᅦ ᄋ ᅭ
글을	ᄀ ᅳ ᄅ ᅳ ᆯ
읽을	ᄋ ᅵ ᆯ ᄀ ᅳ ᆯ
줄은	ᄌ ᅮ ᄅ ᅳ ᆫ
알지만	ᄋ ᅡ ᆯ ᄌ ᅵ ᄆ ᅡ ᆫ
쓸	ᄊ ᅳ ᆯ
몰라요	ᄆ ᅩ ᆯ ᄅ ᅡ ᄋ ᅭ
편의점에서	ᄑ ᅧ ᄂ ᅴ ᄌ ᅥ ᄆ ᅦ ᄉ ᅥ
일하고	ᄋ ᅵ ᆯ ᄒ ᅡ ᄀ ᅩ
일해	ᄋ ᅵ ᆯ ᄒ ᅢ
처음	ᄎ ᅥ ᄋ ᅳ ᆷ
왔을	ᄋ ᅪ ᄊ ᅳ ᆯ
서울에서	ᄉ ᅥ ᄋ ᅮ ᄅ ᅦ ᄉ ᅥ
잃었습니다	ᄋ ᅵ ᄅ ᅥ ᆮ ᄊ ᅳ ᆷ ᄂ ᅵ ᄃ ᅡ
태풍으로	ᄐ ᅢ ᄑ ᅮ ᆼ ᄋ ᅳ ᄅ ᅩ
전	ᄌ ᅥ ᆫ
재산을	ᄌ ᅢ ᄉ ᅡ ᄂ ᅳ ᆯ
잃었어요	ᄋ ᅵ ᄅ ᅥ ᄊ ᅥ ᄋ ᅭ
이모한테	ᄋ ᅵ ᄆ ᅩ ᄒ ᅡ ᆫ ᄐ ᅦ
인사해라	ᄋ ᅵ ᆫ ᄉ ᅡ ᄒ ᅢ ᄅ ᅡ
신랑이랑	ᄉ ᅵ ᆯ ᄅ ᅡ ᆼ ᄋ ᅵ ᄅ ᅡ ᆼ
인사한	ᄋ ᅵ ᆫ ᄉ ᅡ ᄒ ᅡ ᆫ
적	ᄌ ᅥ ᆨ
입어야	ᄋ ᅵ ᄇ ᅥ ᄋ ᅣ
교통사고로	ᄀ ᅭ ᄐ ᅩ ᆼ ᄉ ᅡ ᄀ ᅩ ᄅ ᅩ
가슴에	ᄀ ᅡ ᄉ ᅳ ᄆ ᅦ
상처를	ᄉ ᅡ ᆼ ᄎ ᅥ ᄅ ᅳ ᆯ
입었어요	ᄋ ᅵ ᄇ ᅥ ᄊ ᅥ ᄋ ᅭ
잃어버렸어요	ᄋ ᅵ ᄅ ᅥ ᄇ ᅥ ᄅ ᅧ ᄊ ᅥ ᄋ ᅭ
여권을	ᄋ ᅧ ᄀ ᅯ ᄂ ᅳ ᆯ
자리에서	ᄌ ᅡ ᄅ ᅵ ᄋ ᅦ ᄉ ᅥ
일어나	ᄋ ᅵ ᄅ ᅥ ᄂ ᅡ
대통령을	ᄃ ᅢ ᄐ ᅩ ᆼ ᄂ ᅧ ᆼ ᄋ ᅳ ᆯ
맞아	ᄆ ᅡ ᄌ ᅡ
주십시오	ᄌ ᅮ ᄉ ᅵ ᆸ ᄊ ᅵ ᄋ ᅩ
무슨	ᄆ ᅮ ᄉ ᅳ ᆫ
일어난	ᄋ ᅵ ᄅ ᅥ ᄂ ᅡ ᆫ
일어서서	ᄋ ᅵ ᄅ ᅥ ᄉ ᅥ ᄉ ᅥ
말씀해	ᄆ ᅡ ᆯ ᄊ ᅳ ᆷ ᄒ ᅢ
짚고	ᄌ ᅵ ᆸ ᄁ ᅩ
간신히	ᄀ ᅡ ᆫ ᄉ ᅵ ᆫ ᄒ ᅵ
일어섰다	ᄋ ᅵ ᄅ ᅥ ᄉ ᅥ ᆮ ᄄ ᅡ
천천히	ᄎ ᅥ ᆫ ᄎ ᅥ ᆫ ᄒ ᅵ
일으켜	ᄋ ᅵ ᄅ ᅳ ᄏ ᅧ
늘상	ᄂ ᅳ ᆯ ᄉ ᅡ ᆼ
말썽을	ᄆ ᅡ ᆯ ᄊ ᅥ ᆼ ᄋ ᅳ ᆯ
일으키니	ᄋ ᅵ ᄅ ᅳ ᄏ ᅵ ᄂ ᅵ
수소와	ᄉ ᅮ ᄉ ᅩ ᄋ ᅪ
산소가	ᄉ ᅡ ᆫ ᄉ ᅩ ᄀ ᅡ
결합해서	ᄀ ᅧ ᆯ ᄒ ᅡ ᄑ ᅢ ᄉ ᅥ
이룬다	ᄋ ᅵ ᄅ ᅮ ᆫ ᄃ ᅡ
작가라는	ᄌ ᅡ ᆨ ᄁ ᅡ ᄅ ᅡ ᄂ ᅳ ᆫ
어릴	ᄋ ᅥ ᄅ ᅵ ᆯ
꿈을	ᄁ ᅮ ᄆ ᅳ ᆯ
이뤘어요	ᄋ ᅵ ᄅ ᅯ ᄊ ᅥ ᄋ ᅭ
축구에서	ᄎ ᅮ ᆨ ᄁ ᅮ ᄋ ᅦ ᄉ ᅥ
팀은	ᄐ ᅵ ᄆ ᅳ ᆫ
이루어진다	ᄋ ᅵ ᄅ ᅮ ᄋ ᅥ ᄌ ᅵ ᆫ ᄃ ᅡ
꿈은	ᄁ ᅮ ᄆ ᅳ ᆫ
사실은	ᄉ ᅡ ᄉ ᅵ ᄅ ᅳ ᆫ
시골로	ᄉ ᅵ ᄀ ᅩ ᆯ ᄅ ᅩ
이사하는	ᄋ ᅵ ᄉ ᅡ ᄒ ᅡ ᄂ ᅳ ᆫ
싫어	ᄉ ᅵ ᄅ ᅥ
이사하신다고	ᄋ ᅵ ᄉ ᅡ ᄒ ᅡ ᄉ ᅵ ᆫ ᄃ ᅡ ᄀ ᅩ
들었어요	ᄃ ᅳ ᄅ ᅥ ᄊ ᅥ ᄋ ᅭ
짧은	ᄍ ᅡ ᆯ ᄇ ᅳ ᆫ
끈을	ᄁ ᅳ ᄂ ᅳ ᆯ
이어서	ᄋ ᅵ ᄋ ᅥ ᄉ ᅥ
사용합시다	ᄉ ᅡ ᄋ ᅭ ᆼ ᄒ ᅡ ᆸ ᄊ ᅵ ᄃ ᅡ
필기시험에	ᄑ ᅵ ᆯ ᄀ ᅵ ᄉ ᅵ ᄒ ᅥ ᄆ ᅦ
이어	ᄋ ᅵ ᄋ ᅥ
면접이	ᄆ ᅧ ᆫ ᄌ ᅥ ᄇ ᅵ
있겠습니다	ᄋ ᅵ ᆮ ᄁ ᅦ ᆮ ᄊ ᅳ ᆷ ᄂ ᅵ ᄃ ᅡ
리모컨은	ᄅ ᅵ ᄆ ᅩ ᄏ ᅥ ᄂ ᅳ ᆫ
침대	ᄎ ᅵ ᆷ ᄃ ᅢ
자고	ᄌ ᅡ ᄀ ᅩ
깨어	ᄁ ᅢ ᄋ ᅥ
있니	ᄋ ᅵ ᆫ ᄂ ᅵ
아침에	ᄋ ᅡ ᄎ ᅵ ᄆ ᅦ
바빠서	ᄇ ᅡ ᄈ ᅡ ᄉ ᅥ
렌즈	ᄅ ᅦ ᆫ ᄌ ᅳ
끼는	ᄁ ᅵ ᄂ ᅳ ᆫ
잊었어	ᄋ ᅵ ᄌ ᅥ ᄊ ᅥ
당신과	ᄃ ᅡ ᆼ ᄉ ᅵ ᆫ ᄀ ᅪ
이야기하고	ᄋ ᅵ ᄋ ᅣ ᄀ ᅵ ᄒ ᅡ ᄀ ᅩ
싶지	ᄉ ᅵ ᆸ ᄍ ᅵ
아무한테도	ᄋ ᅡ ᄆ ᅮ ᄒ ᅡ ᆫ ᄐ ᅦ ᄃ ᅩ
이야기하지	ᄋ ᅵ ᄋ ᅣ ᄀ ᅵ ᄒ ᅡ ᄌ ᅵ
알았지	ᄋ ᅡ ᄅ ᅡ ᆮ ᄍ ᅵ
영화는	ᄋ ᅧ ᆼ ᄒ ᅪ ᄂ ᅳ ᆫ
특수효과를	ᄐ ᅳ ᆨ ᄊ ᅮ ᄒ ᅭ ᄀ ᅪ ᄅ ᅳ ᆯ
이용해	ᄋ ᅵ ᄋ ᅭ ᆼ ᄒ ᅢ
만들어졌다	ᄆ ᅡ ᆫ ᄃ ᅳ ᄅ ᅥ ᄌ ᅥ ᆮ ᄄ ᅡ
베개로	ᄇ ᅦ ᄀ ᅢ ᄅ ᅩ
이용하는구나	ᄋ ᅵ ᄋ ᅭ ᆼ ᄒ ᅡ ᄂ ᅳ ᆫ ᄀ ᅮ ᄂ ᅡ
늦게까지	ᄂ ᅳ ᆮ ᄁ ᅦ ᄁ ᅡ ᄌ ᅵ
정도	ᄌ ᅥ ᆼ ᄃ ᅩ
낮잠을	ᄂ ᅡ ᆮ ᄍ ᅡ ᄆ ᅳ ᆯ
잡니다	ᄌ ᅡ ᆷ ᄂ ᅵ ᄃ ᅡ
잘되기를	ᄌ ᅡ ᆯ ᄃ ᅬ ᄀ ᅵ ᄅ ᅳ ᆯ
빈다	ᄇ ᅵ ᆫ ᄃ ᅡ
공부	ᄀ ᅩ ᆼ ᄇ ᅮ
되고	ᄃ ᅬ ᄀ ᅩ
요리를	ᄋ ᅭ ᄅ ᅵ ᄅ ᅳ ᆯ
잘하시네요	ᄌ ᅡ ᆯ ᄒ ᅡ ᄉ ᅵ ᄂ ᅦ ᄋ ᅭ
잘못했는지	ᄌ ᅡ ᆯ ᄆ ᅩ ᄐ ᅢ ᆫ ᄂ ᅳ ᆫ ᄌ ᅵ
몰라	ᄆ ᅩ ᆯ ᄅ ᅡ
잘못한	ᄌ ᅡ ᆯ ᄆ ᅩ ᄐ ᅡ ᆫ
계산이	ᄀ ᅨ ᄉ ᅡ ᄂ ᅵ
잘못된	ᄌ ᅡ ᆯ ᄆ ᅩ ᆮ ᄄ ᅬ ᆫ
같은데요	ᄀ ᅡ ᄐ ᅳ ᆫ ᄃ ᅦ ᄋ ᅭ
만일	ᄆ ᅡ ᄂ ᅵ ᆯ
잘못되면	ᄌ ᅡ ᆯ ᄆ ᅩ ᆮ ᄄ ᅬ ᄆ ᅧ ᆫ
탓이야	ᄐ ᅡ ᄉ ᅵ ᄋ ᅣ
잠들었으면	ᄌ ᅡ ᆷ ᄃ ᅳ ᄅ ᅥ ᄊ ᅳ ᄆ ᅧ ᆫ
깨우지	ᄁ ᅢ ᄋ ᅮ ᄌ ᅵ
잠들기가	ᄌ ᅡ ᆷ ᄃ ᅳ ᆯ ᄀ ᅵ ᄀ ᅡ
힘들어	ᄒ ᅵ ᆷ ᄃ ᅳ ᄅ ᅥ
잠자는	ᄌ ᅡ ᆷ ᄌ ᅡ ᄂ ᅳ ᆫ
척하는	ᄎ ᅥ ᄏ ᅡ ᄂ ᅳ ᆫ
쉬운	ᄉ ᅱ ᄋ ᅮ ᆫ
아니야	ᄋ ᅡ ᄂ ᅵ ᄋ ᅣ
잠	ᄌ ᅡ ᆷ
시간이야	ᄉ ᅵ ᄀ ᅡ ᄂ ᅵ ᄋ ᅣ
범인이	ᄇ ᅥ ᄆ ᅵ ᄂ ᅵ
누구한테	ᄂ ᅮ ᄀ ᅮ ᄒ ᅡ ᆫ ᄐ ᅦ
잡혔어요	ᄌ ᅡ ᄑ ᅧ ᄊ ᅥ ᄋ ᅭ
경찰에게	ᄀ ᅧ ᆼ ᄎ ᅡ ᄅ ᅦ ᄀ ᅦ
잡힌	ᄌ ᅡ ᄑ ᅵ ᆫ
혐의를	ᄒ ᅧ ᄆ ᅴ ᄅ ᅳ ᆯ
부인했다	ᄇ ᅮ ᄋ ᅵ ᆫ ᄒ ᅢ ᆮ ᄄ ᅡ
손	ᄉ ᅩ ᆫ
잡아	ᄌ ᅡ ᄇ ᅡ
거의	ᄀ ᅥ ᄋ ᅴ
도둑을	ᄃ ᅩ ᄃ ᅮ ᄀ ᅳ ᆯ
잡을	ᄌ ᅡ ᄇ ᅳ ᆯ
뻔했다고	ᄈ ᅥ ᆫ ᄒ ᅢ ᆮ ᄄ ᅡ ᄀ ᅩ
말했다	ᄆ ᅡ ᆯ ᄒ ᅢ ᆮ ᄄ ᅡ
머리가	ᄆ ᅥ ᄅ ᅵ ᄀ ᅡ
귀찮아	ᄀ ᅱ ᄎ ᅡ ᄂ ᅡ
자라	ᄌ ᅡ ᄅ ᅡ
부산에서	ᄇ ᅮ ᄉ ᅡ ᄂ ᅦ ᄉ ᅥ
자랐어요	ᄌ ᅡ ᄅ ᅡ ᄊ ᅥ ᄋ ᅭ
딸	ᄄ ᅡ ᆯ
자랑하는	ᄌ ᅡ ᄅ ᅡ ᆼ ᄒ ᅡ ᄂ ᅳ ᆫ
질렸어	ᄌ ᅵ ᆯ ᄅ ᅧ ᄊ ᅥ
살	ᄉ ᅡ ᆯ
한글을	ᄒ ᅡ ᆫ ᄀ ᅳ ᄅ ᅳ ᆯ
깨쳤다고	ᄁ ᅢ ᄎ ᅥ ᆮ ᄄ ᅡ ᄀ ᅩ
자랑했다	ᄌ ᅡ ᄅ ᅡ ᆼ ᄒ ᅢ ᆮ ᄄ ᅡ
머리	ᄆ ᅥ ᄅ ᅵ
잘랐어	ᄌ ᅡ ᆯ ᄅ ᅡ ᄊ ᅥ
단단한	ᄃ ᅡ ᆫ ᄃ ᅡ ᆫ ᄒ ᅡ ᆫ
물질을	ᄆ ᅮ ᆯ ᄍ ᅵ ᄅ ᅳ ᆯ
자르는	ᄌ ᅡ ᄅ ᅳ ᄂ ᅳ ᆫ
사용된다는	ᄉ ᅡ ᄋ ᅭ ᆼ ᄃ ᅬ ᆫ ᄃ ᅡ ᄂ ᅳ ᆫ
집이	ᄌ ᅵ ᄇ ᅵ
없는	ᄋ ᅥ ᆷ ᄂ ᅳ ᆫ
사람들에게	ᄉ ᅡ ᄅ ᅡ ᆷ ᄃ ᅳ ᄅ ᅦ ᄀ ᅦ
먹을	ᄆ ᅥ ᄀ ᅳ ᆯ
무료로	ᄆ ᅮ ᄅ ᅭ ᄅ ᅩ
제공하고	ᄌ ᅦ ᄀ ᅩ ᆼ ᄒ ᅡ ᄀ ᅩ
후보자는	ᄒ ᅮ ᄇ ᅩ ᄌ ᅡ ᄂ ᅳ ᆫ
제공하겠다고	ᄌ ᅦ ᄀ ᅩ ᆼ ᄒ ᅡ ᄀ ᅦ ᆮ ᄄ ᅡ ᄀ ᅩ
약속했다	ᄋ ᅣ ᆨ ᄊ ᅩ ᄏ ᅢ ᆮ ᄄ ᅡ
주로	ᄌ ᅮ ᄅ ᅩ
것들을	ᄀ ᅥ ᆮ ᄄ ᅳ ᄅ ᅳ ᆯ
일기에	ᄋ ᅵ ᆯ ᄀ ᅵ ᄋ ᅦ
적는다	ᄌ ᅥ ᆼ ᄂ ᅳ ᆫ ᄃ ᅡ
성함을	ᄉ ᅥ ᆼ ᄒ ᅡ ᄆ ᅳ ᆯ
영어로	ᄋ ᅧ ᆼ ᄋ ᅥ ᄅ ᅩ
적어	ᄌ ᅥ ᄀ ᅥ
누가	ᄂ ᅮ ᄀ ᅡ
낼	ᄂ ᅢ ᆯ
건지	ᄀ ᅥ ᆫ ᄌ ᅵ
가위바위보로	ᄀ ᅡ ᄋ ᅱ ᄇ ᅡ ᄋ ᅱ ᄇ ᅩ ᄅ ᅩ
정하자	ᄌ ᅥ ᆼ ᄒ ᅡ ᄌ ᅡ
약속	ᄋ ᅣ ᆨ ᄊ ᅩ ᆨ
장소는	ᄌ ᅡ ᆼ ᄉ ᅩ ᄂ ᅳ ᆫ
정했어	ᄌ ᅥ ᆼ ᄒ ᅢ ᄊ ᅥ
서류들을	ᄉ ᅥ ᄅ ᅲ ᄃ ᅳ ᄅ ᅳ ᆯ
알파벳	ᄋ ᅡ ᆯ ᄑ ᅡ ᄇ ᅦ ᆮ
순으로	ᄉ ᅮ ᄂ ᅳ ᄅ ᅩ
정리하세요	ᄌ ᅥ ᆼ ᄂ ᅵ ᄒ ᅡ ᄉ ᅦ ᄋ ᅭ
정리하는	ᄌ ᅥ ᆼ ᄂ ᅵ ᄒ ᅡ ᄂ ᅳ ᆫ
걸렸습니다	ᄀ ᅥ ᆯ ᄅ ᅧ ᆮ ᄊ ᅳ ᆷ ᄂ ᅵ ᄃ ᅡ
안부	ᄋ ᅡ ᆫ ᄇ ᅮ
전해	ᄌ ᅥ ᆫ ᄒ ᅢ
사람에게	ᄉ ᅡ ᄅ ᅡ ᄆ ᅦ ᄀ ᅦ
몰래	ᄆ ᅩ ᆯ ᄅ ᅢ
전해야	ᄌ ᅥ ᆫ ᄒ ᅢ ᄋ ᅣ
회사에는	ᄒ ᅬ ᄉ ᅡ ᄋ ᅦ ᄂ ᅳ ᆫ
전화했어	ᄌ ᅥ ᆫ ᄒ ᅪ ᄒ ᅢ ᄊ ᅥ
나중에	ᄂ ᅡ ᄌ ᅮ ᆼ ᄋ ᅦ
다시	ᄃ ᅡ ᄉ ᅵ
전화할게요	ᄌ ᅥ ᆫ ᄒ ᅪ ᄒ ᅡ ᆯ ᄀ ᅦ ᄋ ᅭ
비에	ᄇ ᅵ ᄋ ᅦ
젖으셨네요	ᄌ ᅥ ᄌ ᅳ ᄉ ᅧ ᆫ ᄂ ᅦ ᄋ ᅭ
젖은	ᄌ ᅥ ᄌ ᅳ ᆫ
말리지	ᄆ ᅡ ᆯ ᄅ ᅵ ᄌ ᅵ
걸릴지도	ᄀ ᅥ ᆯ ᄅ ᅵ ᆯ ᄌ ᅵ ᄃ ᅩ
인생을	ᄋ ᅵ ᆫ ᄉ ᅢ ᆼ ᄋ ᅳ ᆯ
즐기라고	ᄌ ᅳ ᆯ ᄀ ᅵ ᄅ ᅡ ᄀ ᅩ
말씀하시곤	ᄆ ᅡ ᆯ ᄊ ᅳ ᆷ ᄒ ᅡ ᄉ ᅵ ᄀ ᅩ ᆫ
했어	ᄒ ᅢ ᄊ ᅥ
맥주를	ᄆ ᅢ ᆨ ᄍ ᅮ ᄅ ᅳ ᆯ
즐겨	ᄌ ᅳ ᆯ ᄀ ᅧ
마십니다	ᄆ ᅡ ᄉ ᅵ ᆷ ᄂ ᅵ ᄃ ᅡ
올해	ᄋ ᅩ ᆯ ᄒ ᅢ
범죄가	ᄇ ᅥ ᆷ ᄌ ᅬ ᄀ ᅡ
띄게	ᄄ ᅵ ᄀ ᅦ
증가했어요	ᄌ ᅳ ᆼ ᄀ ᅡ ᄒ ᅢ ᄊ ᅥ ᄋ ᅭ
제품에	ᄌ ᅦ ᄑ ᅮ ᄆ ᅦ
대한	ᄃ ᅢ ᄒ ᅡ ᆫ
수요가	ᄉ ᅮ ᄋ ᅭ ᄀ ᅡ
증가하고	ᄌ ᅳ ᆼ ᄀ ᅡ ᄒ ᅡ ᄀ ᅩ
벌써	ᄇ ᅥ ᆯ ᄊ ᅥ
지친	ᄌ ᅵ ᄎ ᅵ ᆫ
당신한테	ᄃ ᅡ ᆼ ᄉ ᅵ ᆫ ᄒ ᅡ ᆫ ᄐ ᅦ
잔소리하는	ᄌ ᅡ ᆫ ᄉ ᅩ ᄅ ᅵ ᄒ ᅡ ᄂ ᅳ ᆫ
지쳤어요	ᄌ ᅵ ᄎ ᅥ ᄊ ᅥ ᄋ ᅭ
여자에게	ᄋ ᅧ ᄌ ᅡ ᄋ ᅦ ᄀ ᅦ
지는	ᄌ ᅵ ᄂ ᅳ ᆫ
굉장히	ᄀ ᅬ ᆼ ᄌ ᅡ ᆼ ᄒ ᅵ
싫어한다	ᄉ ᅵ ᄅ ᅥ ᄒ ᅡ ᆫ ᄃ ᅡ
게임에서	ᄀ ᅦ ᄋ ᅵ ᄆ ᅦ ᄉ ᅥ
지다니	ᄌ ᅵ ᄃ ᅡ ᄂ ᅵ
믿을	ᄆ ᅵ ᄃ ᅳ ᆯ
약속을	ᄋ ᅣ ᆨ ᄊ ᅩ ᄀ ᅳ ᆯ
지키는	ᄌ ᅵ ᄏ ᅵ ᄂ ᅳ ᆫ
청년들이	ᄎ ᅥ ᆼ ᄂ ᅧ ᆫ ᄃ ᅳ ᄅ ᅵ
나라를	ᄂ ᅡ ᄅ ᅡ ᄅ ᅳ ᆯ
지키기	ᄌ ᅵ ᄏ ᅵ ᄀ ᅵ
자원입대했다	ᄌ ᅡ ᄋ ᅯ ᄂ ᅵ ᆸ ᄄ ᅢ ᄒ ᅢ ᆮ ᄄ ᅡ
어머니는	ᄋ ᅥ ᄆ ᅥ ᄂ ᅵ ᄂ ᅳ ᆫ
먹는	ᄆ ᅥ ᆼ ᄂ ᅳ ᆫ
지켜보셨다	ᄌ ᅵ ᄏ ᅧ ᄇ ᅩ ᄉ ᅧ ᆮ ᄄ ᅡ
형사는	ᄒ ᅧ ᆼ ᄉ ᅡ ᄂ ᅳ ᆫ
용의자를	ᄋ ᅭ ᆼ ᄋ ᅴ ᄌ ᅡ ᄅ ᅳ ᆯ
주의	ᄌ ᅮ ᄋ ᅴ
깊게	ᄀ ᅵ ᆸ ᄁ ᅦ
지켜보았다	ᄌ ᅵ ᄏ ᅧ ᄇ ᅩ ᄋ ᅡ ᆮ ᄄ ᅡ
주저하지	ᄌ ᅮ ᄌ ᅥ ᄒ ᅡ ᄌ ᅵ
말고	ᄆ ᅡ ᆯ ᄀ ᅩ
모르는	ᄆ ᅩ ᄅ ᅳ ᄂ ᅳ ᆫ
질문해라	ᄌ ᅵ ᆯ ᄆ ᅮ ᆫ ᄒ ᅢ ᄅ ᅡ
질문하실	ᄌ ᅵ ᆯ ᄆ ᅮ ᆫ ᄒ ᅡ ᄉ ᅵ ᆯ
계신가요	ᄀ ᅨ ᄉ ᅵ ᆫ ᄀ ᅡ ᄋ ᅭ
마지막으로	ᄆ ᅡ ᄌ ᅵ ᄆ ᅡ ᄀ ᅳ ᄅ ᅩ
본	ᄇ ᅩ ᆫ
지났다	ᄌ ᅵ ᄂ ᅡ ᆮ ᄄ ᅡ
졸다가	ᄌ ᅩ ᆯ ᄃ ᅡ ᄀ ᅡ
정거장을	ᄌ ᅥ ᆼ ᄀ ᅥ ᄌ ᅡ ᆼ ᄋ ᅳ ᆯ
지났어요	ᄌ ᅵ ᄂ ᅡ ᄊ ᅥ ᄋ ᅭ
지내니	ᄌ ᅵ ᄂ ᅢ ᄂ ᅵ
아내와	ᄋ ᅡ ᄂ ᅢ ᄋ ᅪ
행복하게	ᄒ ᅢ ᆼ ᄇ ᅩ ᄏ ᅡ ᄀ ᅦ
지내고	ᄌ ᅵ ᄂ ᅢ ᄀ ᅩ
여름	ᄋ ᅧ ᄅ ᅳ ᆷ
방학이	ᄇ ᅡ ᆼ ᄒ ᅡ ᄀ ᅵ
깜짝할	ᄁ ᅡ ᆷ ᄍ ᅡ ᄏ ᅡ ᆯ
지나갔어	ᄌ ᅵ ᄂ ᅡ ᄀ ᅡ ᄊ ᅥ
버스가	ᄇ ᅥ ᄉ ᅳ ᄀ ᅡ
종로를	ᄌ ᅩ ᆼ ᄂ ᅩ ᄅ ᅳ ᆯ
지나갑니까	ᄌ ᅵ ᄂ ᅡ ᄀ ᅡ ᆷ ᄂ ᅵ ᄁ ᅡ
진행되고	ᄌ ᅵ ᆫ ᄒ ᅢ ᆼ ᄃ ᅬ ᄀ ᅩ
계획한	ᄀ ᅨ ᄒ ᅬ ᄏ ᅡ ᆫ
대로	ᄃ ᅢ ᄅ ᅩ
젓가락으로	ᄌ ᅥ ᆮ ᄁ ᅡ ᄅ ᅡ ᄀ ᅳ ᄅ ᅩ
콩	ᄏ ᅩ ᆼ
조각	ᄌ ᅩ ᄀ ᅡ ᆨ
집을	ᄌ ᅵ ᄇ ᅳ ᆯ
노트	ᄂ ᅩ ᄐ ᅳ
집어	ᄌ ᅵ ᄇ ᅥ
뱀을	ᄇ ᅢ ᄆ ᅳ ᆯ
비명을	ᄇ ᅵ ᄆ ᅧ ᆼ ᄋ ᅳ ᆯ
지르기	ᄌ ᅵ ᄅ ᅳ ᄀ ᅵ
시작했습니다	ᄉ ᅵ ᄌ ᅡ ᄏ ᅢ ᆮ ᄊ ᅳ ᆷ ᄂ ᅵ ᄃ ᅡ
불이	ᄇ ᅮ ᄅ ᅵ
나지	ᄂ ᅡ ᄌ ᅵ
고함	ᄀ ᅩ ᄒ ᅡ ᆷ
지르지	ᄌ ᅵ ᄅ ᅳ ᄌ ᅵ
교회를	ᄀ ᅭ ᄒ ᅬ ᄅ ᅳ ᆯ
지을지는	ᄌ ᅵ ᄋ ᅳ ᆯ ᄌ ᅵ ᄂ ᅳ ᆫ
결정되지	ᄀ ᅧ ᆯ ᄌ ᅥ ᆼ ᄃ ᅬ ᄌ ᅵ
않았습니다	ᄋ ᅡ ᄂ ᅡ ᆮ ᄊ ᅳ ᆷ ᄂ ᅵ ᄃ ᅡ
따님	ᄄ ᅡ ᄂ ᅵ ᆷ
이름은	ᄋ ᅵ ᄅ ᅳ ᄆ ᅳ ᆫ
뭐라고	ᄆ ᅯ ᄅ ᅡ ᄀ ᅩ
지었어요	ᄌ ᅵ ᄋ ᅥ ᄊ ᅥ ᄋ ᅭ
억지로	ᄋ ᅥ ᆨ ᄍ ᅵ ᄅ ᅩ
미소를	ᄆ ᅵ ᄉ ᅩ ᄅ ᅳ ᆯ
짓고	ᄌ ᅵ ᆮ ᄁ ᅩ
화장은	ᄒ ᅪ ᄌ ᅡ ᆼ ᄋ ᅳ ᆫ
하는	ᄒ ᅡ ᄂ ᅳ ᆫ
지우는	ᄌ ᅵ ᄋ ᅮ ᄂ ᅳ ᆫ
훨씬	ᄒ ᅯ ᆯ ᄊ ᅵ ᆫ
중요하다	ᄌ ᅮ ᆼ ᄋ ᅭ ᄒ ᅡ ᄃ ᅡ
누군가가	ᄂ ᅮ ᄀ ᅮ ᆫ ᄀ ᅡ ᄀ ᅡ
전화기의	ᄌ ᅥ ᆫ ᄒ ᅪ ᄀ ᅵ ᄋ ᅴ
메시지를	ᄆ ᅦ ᄉ ᅵ ᄌ ᅵ ᄅ ᅳ ᆯ
자꾸	ᄌ ᅡ ᄁ ᅮ
포크로	ᄑ ᅩ ᄏ ᅳ ᄅ ᅩ
음식을	ᄋ ᅳ ᆷ ᄉ ᅵ ᄀ ᅳ ᆯ
찍어	ᄍ ᅵ ᄀ ᅥ
좋아하지	ᄌ ᅩ ᄋ ᅡ ᄒ ᅡ ᄌ ᅵ
않으세요	ᄋ ᅡ ᄂ ᅳ ᄉ ᅦ ᄋ ᅭ
나라에	ᄂ ᅡ ᄅ ᅡ ᄋ ᅦ
가려면	ᄀ ᅡ ᄅ ᅧ ᄆ ᅧ ᆫ
지문을	ᄌ ᅵ ᄆ ᅮ ᄂ ᅳ ᆯ
찍어야	ᄍ ᅵ ᄀ ᅥ ᄋ ᅣ
여기서	ᄋ ᅧ ᄀ ᅵ ᄉ ᅥ
찍어도	ᄍ ᅵ ᄀ ᅥ ᄃ ᅩ
됩니까	ᄃ ᅬ ᆷ ᄂ ᅵ ᄁ ᅡ
여름을	ᄋ ᅧ ᄅ ᅳ ᄆ ᅳ ᆯ
별로	ᄇ ᅧ ᆯ ᄅ ᅩ
가수를	ᄀ ᅡ ᄉ ᅮ ᄅ ᅳ ᆯ
좋아하니	ᄌ ᅩ ᄋ ᅡ ᄒ ᅡ ᄂ ᅵ
지나쳤다	ᄌ ᅵ ᄂ ᅡ ᄎ ᅥ ᆮ ᄄ ᅡ
줄곧	ᄌ ᅮ ᆯ ᄀ ᅩ ᆮ
졸았어요	ᄌ ᅩ ᄅ ᅡ ᄊ ᅥ ᄋ ᅭ
서울대학교를	ᄉ ᅥ ᄋ ᅮ ᆯ ᄃ ᅢ ᄒ ᅡ ᆨ ᄁ ᅭ ᄅ ᅳ ᆯ
졸업했습니다	ᄌ ᅩ ᄅ ᅥ ᄑ ᅢ ᆮ ᄊ ᅳ ᆷ ᄂ ᅵ ᄃ ᅡ
졸업하고	ᄌ ᅩ ᄅ ᅥ ᄑ ᅡ ᄀ ᅩ
나서	ᄂ ᅡ ᄉ ᅥ
하고	ᄒ ᅡ ᄀ ᅩ
경찰이	ᄀ ᅧ ᆼ ᄎ ᅡ ᄅ ᅵ
사건	ᄉ ᅡ ᄀ ᅥ ᆫ
현장을	ᄒ ᅧ ᆫ ᄌ ᅡ ᆼ ᄋ ᅳ ᆯ
조사하고	ᄌ ᅩ ᄉ ᅡ ᄒ ᅡ ᄀ ᅩ
오늘의	ᄋ ᅩ ᄂ ᅳ ᄅ ᅴ
과제는	ᄀ ᅪ ᄌ ᅦ ᄂ ᅳ ᆫ
환경오염에	ᄒ ᅪ ᆫ ᄀ ᅧ ᆼ ᄋ ᅩ ᄋ ᅧ ᄆ ᅦ
조사하는	ᄌ ᅩ ᄉ ᅡ ᄒ ᅡ ᄂ ᅳ ᆫ
겁니다	ᄀ ᅥ ᆷ ᄂ ᅵ ᄃ ᅡ
조심해	ᄌ ᅩ ᄉ ᅵ ᆷ ᄒ ᅢ
조심하세요	ᄌ ᅩ ᄉ ᅵ ᆷ ᄒ ᅡ ᄉ ᅦ ᄋ ᅭ
제게	ᄌ ᅦ ᄀ ᅦ
기회를	ᄀ ᅵ ᄒ ᅬ ᄅ ᅳ ᆯ
감사합니다	ᄀ ᅡ ᆷ ᄉ ᅡ ᄒ ᅡ ᆷ ᄂ ᅵ ᄃ ᅡ
운전	ᄋ ᅮ ᆫ ᄌ ᅥ ᆫ
죽인	ᄌ ᅮ ᄀ ᅵ ᆫ
죽이려고	ᄌ ᅮ ᄀ ᅵ ᄅ ᅧ ᄀ ᅩ
일본은	ᄋ ᅵ ᆯ ᄇ ᅩ ᄂ ᅳ ᆫ
독도를	ᄃ ᅩ ᆨ ᄄ ᅩ ᄅ ᅳ ᆯ
땅이라고	ᄄ ᅡ ᆼ ᄋ ᅵ ᄅ ᅡ ᄀ ᅩ
주장하고	ᄌ ᅮ ᄌ ᅡ ᆼ ᄒ ᅡ ᄀ ᅩ
죄가	ᄌ ᅬ ᄀ ᅡ
없다고	ᄋ ᅥ ᆸ ᄄ ᅡ ᄀ ᅩ
주장했다	ᄌ ᅮ ᄌ ᅡ ᆼ ᄒ ᅢ ᆮ ᄄ ᅡ
아내가	ᄋ ᅡ ᄂ ᅢ ᄀ ᅡ
죽은	ᄌ ᅮ ᄀ ᅳ ᆫ
됐어요	ᄃ ᅫ ᄊ ᅥ ᄋ ᅭ
풀이	ᄑ ᅮ ᄅ ᅵ
죽었어	ᄌ ᅮ ᄀ ᅥ ᄊ ᅥ
당신을	ᄃ ᅡ ᆼ ᄉ ᅵ ᄂ ᅳ ᆯ
뭔가를	ᄆ ᅯ ᆫ ᄀ ᅡ ᄅ ᅳ ᆯ
준비했어요	ᄌ ᅮ ᆫ ᄇ ᅵ ᄒ ᅢ ᄊ ᅥ ᄋ ᅭ
매일	ᄆ ᅢ ᄋ ᅵ ᆯ
저녁	ᄌ ᅥ ᄂ ᅧ ᆨ
준비하시는	ᄌ ᅮ ᆫ ᄇ ᅵ ᄒ ᅡ ᄉ ᅵ ᄂ ᅳ ᆫ
도와드려요	ᄃ ᅩ ᄋ ᅪ ᄃ ᅳ ᄅ ᅧ ᄋ ᅭ
스웨터가	ᄉ ᅳ ᄋ ᅰ ᄐ ᅥ ᄀ ᅡ
줄어들었어	ᄌ ᅮ ᄅ ᅥ ᄃ ᅳ ᄅ ᅥ ᄊ ᅥ
농촌	ᄂ ᅩ ᆼ ᄎ ᅩ ᆫ
인구가	ᄋ ᅵ ᆫ ᄀ ᅮ ᄀ ᅡ
줄어들고	ᄌ ᅮ ᄅ ᅥ ᄃ ᅳ ᆯ ᄀ ᅩ
소리	ᄉ ᅩ ᄅ ᅵ
줄여	ᄌ ᅮ ᄅ ᅧ
주실래요	ᄌ ᅮ ᄉ ᅵ ᆯ ᄅ ᅢ ᄋ ᅭ
운동은	ᄋ ᅮ ᆫ ᄃ ᅩ ᆼ ᄋ ᅳ ᆫ
질병의	ᄌ ᅵ ᆯ ᄇ ᅧ ᆼ ᄋ ᅴ
위험을	ᄋ ᅱ ᄒ ᅥ ᄆ ᅳ ᆯ
줄이기	ᄌ ᅮ ᄅ ᅵ ᄀ ᅵ
필요하다	ᄑ ᅵ ᄅ ᅭ ᄒ ᅡ ᄃ ᅡ
쥐어라	ᄌ ᅱ ᄋ ᅥ ᄅ ᅡ
흥분하여	ᄒ ᅳ ᆼ ᄇ ᅮ ᆫ ᄒ ᅡ ᄋ ᅧ
주먹을	ᄌ ᅮ ᄆ ᅥ ᄀ ᅳ ᆯ
불끈	ᄇ ᅮ ᆯ ᄁ ᅳ ᆫ
쥐었다	ᄌ ᅱ ᄋ ᅥ ᆮ ᄄ ᅡ
요즘에는	ᄋ ᅭ ᄌ ᅳ ᄆ ᅦ ᄂ ᅳ ᆫ
아이들의	ᄋ ᅡ ᄋ ᅵ ᄃ ᅳ ᄅ ᅴ
키도	ᄏ ᅵ ᄃ ᅩ
커지고	ᄏ ᅥ ᄌ ᅵ ᄀ ᅩ
덩치도	ᄃ ᅥ ᆼ ᄎ ᅵ ᄃ ᅩ
커졌다	ᄏ ᅥ ᄌ ᅥ ᆮ ᄄ ᅡ
홈쇼핑	ᄒ ᅩ ᆷ ᄉ ᅭ ᄑ ᅵ ᆼ
사업은	ᄉ ᅡ ᄋ ᅥ ᄇ ᅳ ᆫ
점점	ᄌ ᅥ ᆷ ᄌ ᅥ ᆷ
너	ᄂ ᅥ
다음에	ᄃ ᅡ ᄋ ᅳ ᄆ ᅦ
커서	ᄏ ᅥ ᄉ ᅥ
뭐가	ᄆ ᅯ ᄀ ᅡ
싶니	ᄉ ᅵ ᆷ ᄂ ᅵ
시골에서	ᄉ ᅵ ᄀ ᅩ ᄅ ᅦ ᄉ ᅥ
컸어요	ᄏ ᅥ ᄊ ᅥ ᄋ ᅭ
열두	ᄋ ᅧ ᆯ ᄃ ᅮ
마리	ᄆ ᅡ ᄅ ᅵ
키워요	ᄏ ᅵ ᄋ ᅯ ᄋ ᅭ
혼자서	ᄒ ᅩ ᆫ ᄌ ᅡ ᄉ ᅥ
나와	ᄂ ᅡ ᄋ ᅪ
형을	ᄒ ᅧ ᆼ ᄋ ᅳ ᆯ
키우셨다	ᄏ ᅵ ᄋ ᅮ ᄉ ᅧ ᆮ ᄄ ᅡ
한밤중에	ᄒ ᅡ ᆫ ᄇ ᅡ ᆷ ᄌ ᅮ ᆼ ᄋ ᅦ
잠에서	ᄌ ᅡ ᄆ ᅦ ᄉ ᅥ
깼습니다	ᄁ ᅢ ᆮ ᄊ ᅳ ᆷ ᄂ ᅵ ᄃ ᅡ
술이	ᄉ ᅮ ᄅ ᅵ
깬	ᄁ ᅢ ᆫ
얘기하자	ᄋ ᅤ ᄀ ᅵ ᄒ ᅡ ᄌ ᅡ
접시를	ᄌ ᅥ ᆸ ᄊ ᅵ ᄅ ᅳ ᆯ
깼어요	ᄁ ᅢ ᄊ ᅥ ᄋ ᅭ
걔는	ᄀ ᅤ ᄂ ᅳ ᆫ
분위기를	ᄇ ᅮ ᄂ ᅱ ᄀ ᅵ ᄅ ᅳ ᆯ
깨	ᄁ ᅢ
이제서야	ᄋ ᅵ ᄌ ᅦ ᄉ ᅥ ᄋ ᅣ
실수를	ᄉ ᅵ ᆯ ᄉ ᅮ ᄅ ᅳ ᆯ
깨달았어요	ᄁ ᅢ ᄃ ᅡ ᄅ ᅡ ᄊ ᅥ ᄋ ᅭ
사랑한다는	ᄉ ᅡ ᄅ ᅡ ᆼ ᄒ ᅡ ᆫ ᄃ ᅡ ᄂ ᅳ ᆫ
깨달았다	ᄁ ᅢ ᄃ ᅡ ᄅ ᅡ ᆮ ᄄ ᅡ
사과	ᄉ ᅡ ᄀ ᅪ
깎을	ᄁ ᅡ ᄁ ᅳ ᆯ
줄	ᄌ ᅮ ᆯ
머리를	ᄆ ᅥ ᄅ ᅵ ᄅ ᅳ ᆯ
깎았어요	ᄁ ᅡ ᄁ ᅡ ᄊ ᅥ ᄋ ᅭ
조금만	ᄌ ᅩ ᄀ ᅳ ᆷ ᄆ ᅡ ᆫ
깎아	ᄁ ᅡ ᄁ ᅡ
지갑을	ᄌ ᅵ ᄀ ᅡ ᄇ ᅳ ᆯ
꺼내려고	ᄁ ᅥ ᄂ ᅢ ᄅ ᅧ ᄀ ᅩ
갔어요	ᄀ ᅡ ᄊ ᅥ ᄋ ᅭ
호주머니에서	ᄒ ᅩ ᄌ ᅮ ᄆ ᅥ ᄂ ᅵ ᄋ ᅦ ᄉ ᅥ
반지를	ᄇ ᅡ ᆫ ᄌ ᅵ ᄅ ᅳ ᆯ
꺼내	ᄁ ᅥ ᄂ ᅢ
청혼했다	ᄎ ᅥ ᆼ ᄒ ᅩ ᆫ ᄒ ᅢ ᆮ ᄄ ᅡ
껐는지	ᄁ ᅥ ᆫ ᄂ ᅳ ᆫ ᄌ ᅵ
확인해라	ᄒ ᅪ ᄀ ᅵ ᆫ ᄒ ᅢ ᄅ ᅡ
나갈	ᄂ ᅡ ᄀ ᅡ ᆯ
때에는	ᄄ ᅢ ᄋ ᅦ ᄂ ᅳ ᆫ
불을	ᄇ ᅮ ᄅ ᅳ ᆯ
꺼라	ᄁ ᅥ ᄅ ᅡ
끄덕이면서	ᄁ ᅳ ᄃ ᅥ ᄀ ᅵ ᄆ ᅧ ᆫ ᄉ ᅥ
나라에서는	ᄂ ᅡ ᄅ ᅡ ᄋ ᅦ ᄉ ᅥ ᄂ ᅳ ᆫ
끄덕이는	ᄁ ᅳ ᄃ ᅥ ᄀ ᅵ ᄂ ᅳ ᆫ
부정을	ᄇ ᅮ ᄌ ᅥ ᆼ ᄋ ᅳ ᆯ
의미합니다	ᄋ ᅴ ᄆ ᅵ ᄒ ᅡ ᆷ ᄂ ᅵ ᄃ ᅡ
아이가	ᄋ ᅡ ᄋ ᅵ ᄀ ᅡ
소매를	ᄉ ᅩ ᄆ ᅢ ᄅ ᅳ ᆯ
끌었다	ᄁ ᅳ ᄅ ᅥ ᆮ ᄄ ᅡ
여배우는	ᄋ ᅧ ᄇ ᅢ ᄋ ᅮ ᄂ ᅳ ᆫ
사람들의	ᄉ ᅡ ᄅ ᅡ ᆷ ᄃ ᅳ ᄅ ᅴ
시선을	ᄉ ᅵ ᄉ ᅥ ᄂ ᅳ ᆯ
끈다	ᄁ ᅳ ᆫ ᄃ ᅡ
연설이	ᄋ ᅧ ᆫ ᄉ ᅥ ᄅ ᅵ
끄니까	ᄁ ᅳ ᄂ ᅵ ᄁ ᅡ
자리를	ᄌ ᅡ ᄅ ᅵ ᄅ ᅳ ᆯ
뜨기	ᄄ ᅳ ᄀ ᅵ
시작했어요	ᄉ ᅵ ᄌ ᅡ ᄏ ᅢ ᄊ ᅥ ᄋ ᅭ
실이	ᄉ ᅵ ᄅ ᅵ
끊어졌다	ᄁ ᅳ ᄂ ᅥ ᄌ ᅥ ᆮ ᄄ ᅡ
전화가	ᄌ ᅥ ᆫ ᄒ ᅪ ᄀ ᅡ
끊어졌어요	ᄁ ᅳ ᄂ ᅥ ᄌ ᅥ ᄊ ᅥ ᄋ ᅭ
사이는	ᄉ ᅡ ᄋ ᅵ ᄂ ᅳ ᆫ
끝났어	ᄁ ᅳ ᆫ ᄂ ᅡ ᄊ ᅥ
영화가	ᄋ ᅧ ᆼ ᄒ ᅪ ᄀ ᅡ
끝나	ᄁ ᅳ ᆫ ᄂ ᅡ
즈음에	ᄌ ᅳ ᄋ ᅳ ᄆ ᅦ
끝냈어	ᄁ ᅳ ᆫ ᄂ ᅢ ᄊ ᅥ
안으로	ᄋ ᅡ ᄂ ᅳ ᄅ ᅩ
과제를	ᄀ ᅪ ᄌ ᅦ ᄅ ᅳ ᆯ
끝내야	ᄁ ᅳ ᆫ ᄂ ᅢ ᄋ ᅣ
수리공이	ᄉ ᅮ ᄅ ᅵ ᄀ ᅩ ᆼ ᄋ ᅵ
선을	ᄉ ᅥ ᄂ ᅳ ᆯ
끊어	ᄁ ᅳ ᄂ ᅥ
술	ᄉ ᅮ ᆯ
끊었어요	ᄁ ᅳ ᄂ ᅥ ᄊ ᅥ ᄋ ᅭ
끊었다	ᄁ ᅳ ᄂ ᅥ ᆮ ᄄ ᅡ
걸게	ᄀ ᅥ ᆯ ᄀ ᅦ
끓인	ᄁ ᅳ ᄅ ᅵ ᆫ
후에	ᄒ ᅮ ᄋ ᅦ
라면을	ᄅ ᅡ ᄆ ᅧ ᄂ ᅳ ᆯ
넣으세요	ᄂ ᅥ ᄋ ᅳ ᄉ ᅦ ᄋ ᅭ
커피	ᄏ ᅥ ᄑ ᅵ
끓여	ᄁ ᅳ ᄅ ᅧ
놓았어	ᄂ ᅩ ᄋ ᅡ ᄊ ᅥ
꾸미는	ᄁ ᅮ ᄆ ᅵ ᄂ ᅳ ᆫ
전부	ᄌ ᅥ ᆫ ᄇ ᅮ
꾸며	ᄁ ᅮ ᄆ ᅧ
낸	ᄂ ᅢ ᆫ
행복해지기를	ᄒ ᅢ ᆼ ᄇ ᅩ ᄏ ᅢ ᄌ ᅵ ᄀ ᅵ ᄅ ᅳ ᆯ
꿈꾼다	ᄁ ᅮ ᆷ ᄁ ᅮ ᆫ ᄃ ᅡ
오는	ᄋ ᅩ ᄂ ᅳ ᆫ
꿈꿔	ᄁ ᅮ ᆷ ᄁ ᅯ
더워서	ᄃ ᅥ ᄋ ᅯ ᄉ ᅥ
에어컨을	ᄋ ᅦ ᄋ ᅥ ᄏ ᅥ ᄂ ᅳ ᆯ
켰어	ᄏ ᅧ ᄊ ᅥ
가스	ᄀ ᅡ ᄉ ᅳ
레인지	ᄅ ᅦ ᄋ ᅵ ᆫ ᄌ ᅵ
소영이는	ᄉ ᅩ ᄋ ᅧ ᆼ ᄋ ᅵ ᄂ ᅳ ᆫ
마치고	ᄆ ᅡ ᄎ ᅵ ᄀ ᅩ
돌아갔어요	ᄃ ᅩ ᄅ ᅡ ᄀ ᅡ ᄊ ᅥ ᄋ ᅭ
마치면	ᄆ ᅡ ᄎ ᅵ ᄆ ᅧ ᆫ
쉬어	ᄉ ᅱ ᄋ ᅥ
겨우	ᄀ ᅧ ᄋ ᅮ
개	ᄀ ᅢ
맞혔어	ᄆ ᅡ ᄎ ᅧ ᄊ ᅥ
맞히면	ᄆ ᅡ ᄎ ᅵ ᄆ ᅧ ᆫ
뭐	ᄆ ᅯ
안전벨트를	ᄋ ᅡ ᆫ ᄌ ᅥ ᆫ ᄇ ᅦ ᆯ ᄐ ᅳ ᄅ ᅳ ᆯ
매세요	ᄆ ᅢ ᄉ ᅦ ᄋ ᅭ
회사에서는	ᄒ ᅬ ᄉ ᅡ ᄋ ᅦ ᄉ ᅥ ᄂ ᅳ ᆫ
넥타이를	ᄂ ᅦ ᆨ ᄐ ᅡ ᄋ ᅵ ᄅ ᅳ ᆯ
매지	ᄆ ᅢ ᄌ ᅵ
않아도	ᄋ ᅡ ᄂ ᅡ ᄃ ᅩ
싱크대가	ᄉ ᅵ ᆼ ᄏ ᅳ ᄃ ᅢ ᄀ ᅡ
막혔어	ᄆ ᅡ ᄏ ᅧ ᄊ ᅥ
코가	ᄏ ᅩ ᄀ ᅡ
막혀요	ᄆ ᅡ ᄏ ᅧ ᄋ ᅭ
차가	ᄎ ᅡ ᄀ ᅡ
막혀서	ᄆ ᅡ ᄏ ᅧ ᄉ ᅥ
늦었습니다	ᄂ ᅳ ᄉ ᅥ ᆮ ᄊ ᅳ ᆷ ᄂ ᅵ ᄃ ᅡ
쥐가	ᄌ ᅱ ᄀ ᅡ
들어오지	ᄃ ᅳ ᄅ ᅥ ᄋ ᅩ ᄌ ᅵ
못하게	ᄆ ᅩ ᄐ ᅡ ᄀ ᅦ
구멍을	ᄀ ᅮ ᄆ ᅥ ᆼ ᄋ ᅳ ᆯ
막아라	ᄆ ᅡ ᄀ ᅡ ᄅ ᅡ
가족	ᄀ ᅡ ᄌ ᅩ ᆨ
누구도	ᄂ ᅮ ᄀ ᅮ ᄃ ᅩ
아버지를	ᄋ ᅡ ᄇ ᅥ ᄌ ᅵ ᄅ ᅳ ᆯ
막을	ᄆ ᅡ ᄀ ᅳ ᆯ
들어가지	ᄃ ᅳ ᄅ ᅥ ᄀ ᅡ ᄌ ᅵ
마십시오	ᄆ ᅡ ᄉ ᅵ ᆸ ᄊ ᅵ ᄋ ᅩ
회사가	ᄒ ᅬ ᄉ ᅡ ᄀ ᅡ
망하고	ᄆ ᅡ ᆼ ᄒ ᅡ ᄀ ᅩ
원하는	ᄋ ᅯ ᆫ ᄒ ᅡ ᄂ ᅳ ᆫ
아내에게	ᄋ ᅡ ᄂ ᅢ ᄋ ᅦ ᄀ ᅦ
바가지	ᄇ ᅡ ᄀ ᅡ ᄌ ᅵ
긁으라고	ᄀ ᅳ ᆯ ᄀ ᅳ ᄅ ᅡ ᄀ ᅩ
뭔지	ᄆ ᅯ ᆫ ᄌ ᅵ
재혼하지	ᄌ ᅢ ᄒ ᅩ ᆫ ᄒ ᅡ ᄌ ᅵ
말씀하셨다	ᄆ ᅡ ᆯ ᄊ ᅳ ᆷ ᄒ ᅡ ᄉ ᅧ ᆮ ᄄ ᅡ
눈사람을	ᄂ ᅮ ᆫ ᄉ ᅡ ᄅ ᅡ ᄆ ᅳ ᆯ
만들었어	ᄆ ᅡ ᆫ ᄃ ᅳ ᄅ ᅥ ᄊ ᅥ
질리게	ᄌ ᅵ ᆯ ᄅ ᅵ ᄀ ᅦ
만든다	ᄆ ᅡ ᆫ ᄃ ᅳ ᆫ ᄃ ᅡ
만져	ᄆ ᅡ ᆫ ᄌ ᅥ
만지지	ᄆ ᅡ ᆫ ᄌ ᅵ ᄌ ᅵ
마시오	ᄆ ᅡ ᄉ ᅵ ᄋ ᅩ
계약에	ᄀ ᅨ ᄋ ᅣ ᄀ ᅦ
만족하실	ᄆ ᅡ ᆫ ᄌ ᅩ ᄏ ᅡ ᄉ ᅵ ᆯ
거라고	ᄀ ᅥ ᄅ ᅡ ᄀ ᅩ
확신합니다	ᄒ ᅪ ᆨ ᄊ ᅵ ᆫ ᄒ ᅡ ᆷ ᄂ ᅵ ᄃ ᅡ
멤버들에게	ᄆ ᅦ ᆷ ᄇ ᅥ ᄃ ᅳ ᄅ ᅦ ᄀ ᅦ
만족합니다	ᄆ ᅡ ᆫ ᄌ ᅩ ᄏ ᅡ ᆷ ᄂ ᅵ ᄃ ᅡ
영화관	ᄋ ᅧ ᆼ ᄒ ᅪ ᄀ ᅪ ᆫ
만나기로	ᄆ ᅡ ᆫ ᄂ ᅡ ᄀ ᅵ ᄅ ᅩ
했습니다	ᄒ ᅢ ᆮ ᄊ ᅳ ᆷ ᄂ ᅵ ᄃ ᅡ
만나다니	ᄆ ᅡ ᆫ ᄂ ᅡ ᄃ ᅡ ᄂ ᅵ
세상	ᄉ ᅦ ᄉ ᅡ ᆼ
좁구나	ᄌ ᅩ ᆸ ᄁ ᅮ ᄂ ᅡ
접착제는	ᄌ ᅥ ᆸ ᄎ ᅡ ᆨ ᄍ ᅦ ᄂ ᅳ ᆫ
마르고	ᄆ ᅡ ᄅ ᅳ ᄀ ᅩ
시간만	ᄉ ᅵ ᄀ ᅡ ᆫ ᄆ ᅡ ᆫ
지나면	ᄌ ᅵ ᄂ ᅡ ᄆ ᅧ ᆫ
굳는다	ᄀ ᅮ ᆫ ᄂ ᅳ ᆫ ᄃ ᅡ
말랐어	ᄆ ᅡ ᆯ ᄅ ᅡ ᄊ ᅥ
마련했어	ᄆ ᅡ ᄅ ᅧ ᆫ ᄒ ᅢ ᄊ ᅥ
편하신	ᄑ ᅧ ᆫ ᄒ ᅡ ᄉ ᅵ ᆫ
때로	ᄄ ᅢ ᄅ ᅩ
마련하겠습니다	ᄆ ᅡ ᄅ ᅧ ᆫ ᄒ ᅡ ᄀ ᅦ ᆮ ᄊ ᅳ ᆷ ᄂ ᅵ ᄃ ᅡ
커피를	ᄏ ᅥ ᄑ ᅵ ᄅ ᅳ ᆯ
마시다	ᄆ ᅡ ᄉ ᅵ ᄃ ᅡ
입이	ᄋ ᅵ ᄇ ᅵ
헐었다	ᄒ ᅥ ᄅ ᅥ ᆮ ᄄ ᅡ
술을	ᄉ ᅮ ᄅ ᅳ ᆯ
마셔서	ᄆ ᅡ ᄉ ᅧ ᄉ ᅥ
걱정입니다	ᄀ ᅥ ᆨ ᄍ ᅥ ᆼ ᄋ ᅵ ᆷ ᄂ ᅵ ᄃ ᅡ
시험이	ᄉ ᅵ ᄒ ᅥ ᄆ ᅵ
끝난	ᄁ ᅳ ᆫ ᄂ ᅡ ᆫ
맞춰	ᄆ ᅡ ᆮ ᄎ ᅯ
알람	ᄋ ᅡ ᆯ ᄅ ᅡ ᆷ
시계를	ᄉ ᅵ ᄀ ᅨ ᄅ ᅳ ᆯ
여섯	ᄋ ᅧ ᄉ ᅥ ᆮ
맞춰라	ᄆ ᅡ ᆮ ᄎ ᅯ ᄅ ᅡ
귀중품은	ᄀ ᅱ ᄌ ᅮ ᆼ ᄑ ᅮ ᄆ ᅳ ᆫ
카운터에	ᄏ ᅡ ᄋ ᅮ ᆫ ᄐ ᅥ ᄋ ᅦ
맡기세요	ᄆ ᅡ ᆮ ᄁ ᅵ ᄉ ᅦ ᄋ ᅭ
맡겨	ᄆ ᅡ ᆮ ᄁ ᅧ
맞아요	ᄆ ᅡ ᄌ ᅡ ᄋ ᅭ
옷	ᄋ ᅩ ᆮ
맞을	ᄆ ᅡ ᄌ ᅳ ᆯ
같은데	ᄀ ᅡ ᄐ ᅳ ᆫ ᄃ ᅦ
가끔	ᄀ ᅡ ᄁ ᅳ ᆷ
아버지한테	ᄋ ᅡ ᄇ ᅥ ᄌ ᅵ ᄒ ᅡ ᆫ ᄐ ᅦ
매를	ᄆ ᅢ ᄅ ᅳ ᆯ
맞았어요	ᄆ ᅡ ᄌ ᅡ ᄊ ᅥ ᄋ ᅭ
점	ᄌ ᅥ ᆷ
맞았어	ᄆ ᅡ ᄌ ᅡ ᄊ ᅥ
휴일을	ᄒ ᅲ ᄋ ᅵ ᄅ ᅳ ᆯ
대청소를	ᄃ ᅢ ᄎ ᅥ ᆼ ᄉ ᅩ ᄅ ᅳ ᆯ
했어요	ᄒ ᅢ ᄊ ᅥ ᄋ ᅭ
손님을	ᄉ ᅩ ᆫ ᄂ ᅵ ᄆ ᅳ ᆯ
따뜻하게	ᄄ ᅡ ᄄ ᅳ ᄐ ᅡ ᄀ ᅦ
맞으세요	ᄆ ᅡ ᄌ ᅳ ᄉ ᅦ ᄋ ᅭ
맡기를	ᄆ ᅡ ᆮ ᄁ ᅵ ᄅ ᅳ ᆯ
꺼려했다	ᄁ ᅥ ᄅ ᅧ ᄒ ᅢ ᆮ ᄄ ᅡ
시까지	ᄉ ᅵ ᄁ ᅡ ᄌ ᅵ
가방을	ᄀ ᅡ ᄇ ᅡ ᆼ ᄋ ᅳ ᆯ
맡아	ᄆ ᅡ ᄐ ᅡ
꽃	ᄁ ᅩ ᆮ
향기를	ᄒ ᅣ ᆼ ᄀ ᅵ ᄅ ᅳ ᆯ
축농증이	ᄎ ᅮ ᆼ ᄂ ᅩ ᆼ ᄌ ᅳ ᆼ ᄋ ᅵ
있어서	ᄋ ᅵ ᄊ ᅥ ᄉ ᅥ
냄새를	ᄂ ᅢ ᆷ ᄉ ᅢ ᄅ ᅳ ᆯ
맡아요	ᄆ ᅡ ᄐ ᅡ ᄋ ᅭ
아이들에게	ᄋ ᅡ ᄋ ᅵ ᄃ ᅳ ᄅ ᅦ ᄀ ᅦ
먹이지	ᄆ ᅥ ᄀ ᅵ ᄌ ᅵ
새벽	ᄉ ᅢ ᄇ ᅧ ᆨ
아기에게	ᄋ ᅡ ᄀ ᅵ ᄋ ᅦ ᄀ ᅦ
젖을	ᄌ ᅥ ᄌ ᅳ ᆯ
먹이려고	ᄆ ᅥ ᄀ ᅵ ᄅ ᅧ ᄀ ᅩ
일어난다	ᄋ ᅵ ᄅ ᅥ ᄂ ᅡ ᆫ ᄃ ᅡ
중국	ᄌ ᅮ ᆼ ᄀ ᅮ ᆨ
먹고	ᄆ ᅥ ᆨ ᄁ ᅩ
넌	ᄂ ᅥ ᆫ
잊어	ᄋ ᅵ ᄌ ᅥ
먹었어요	ᄆ ᅥ ᄀ ᅥ ᄊ ᅥ ᄋ ᅭ
횡단보도	ᄒ ᅬ ᆼ ᄃ ᅡ ᆫ ᄇ ᅩ ᄃ ᅩ
멈췄다	ᄆ ᅥ ᆷ ᄎ ᅯ ᆮ ᄄ ᅡ
멈출	ᄆ ᅥ ᆷ ᄎ ᅮ ᆯ
없었어	ᄋ ᅥ ᆸ ᄊ ᅥ ᄊ ᅥ
머무르실	ᄆ ᅥ ᄆ ᅮ ᄅ ᅳ ᄉ ᅵ ᆯ
건가요	ᄀ ᅥ ᆫ ᄀ ᅡ ᄋ ᅭ
하룻밤	ᄒ ᅡ ᄅ ᅮ ᆮ ᄈ ᅡ ᆷ
머무를	ᄆ ᅥ ᄆ ᅮ ᄅ ᅳ ᆯ
미쳤어	ᄆ ᅵ ᄎ ᅥ ᄊ ᅥ
미치겠어	ᄆ ᅵ ᄎ ᅵ ᄀ ᅦ ᄊ ᅥ
책상을	ᄎ ᅢ ᆨ ᄊ ᅡ ᆼ ᄋ ᅳ ᆯ
밀고	ᄆ ᅵ ᆯ ᄀ ᅩ
중이다	ᄌ ᅮ ᆼ ᄋ ᅵ ᄃ ᅡ
뒤에서	ᄃ ᅱ ᄋ ᅦ ᄉ ᅥ
밀지	ᄆ ᅵ ᆯ ᄌ ᅵ
내일로	ᄂ ᅢ ᄋ ᅵ ᆯ ᄅ ᅩ
미루지	ᄆ ᅵ ᄅ ᅮ ᄌ ᅵ
책임을	ᄎ ᅢ ᄀ ᅵ ᄆ ᅳ ᆯ
믿으셔도	ᄆ ᅵ ᄃ ᅳ ᄉ ᅧ ᄃ ᅩ
녀석을	ᄂ ᅧ ᄉ ᅥ ᄀ ᅳ ᆯ
믿다니	ᄆ ᅵ ᆮ ᄄ ᅡ ᄂ ᅵ
어리석었구나	ᄋ ᅥ ᄅ ᅵ ᄉ ᅥ ᄀ ᅥ ᆮ ᄁ ᅮ ᄂ ᅡ
널	ᄂ ᅥ ᆯ
미워하겠니	ᄆ ᅵ ᄋ ᅯ ᄒ ᅡ ᄀ ᅦ ᆫ ᄂ ᅵ
남편과	ᄂ ᅡ ᆷ ᄑ ᅧ ᆫ ᄀ ᅪ
미워해요	ᄆ ᅵ ᄋ ᅯ ᄒ ᅢ ᄋ ᅭ
피우기	ᄑ ᅵ ᄋ ᅮ ᄀ ᅵ
나무를	ᄂ ᅡ ᄆ ᅮ ᄅ ᅳ ᆯ
모으고	ᄆ ᅩ ᄋ ᅳ ᄀ ᅩ
올해에는	ᄋ ᅩ ᆯ ᄒ ᅢ ᄋ ᅦ ᄂ ᅳ ᆫ
클럽은	ᄏ ᅳ ᆯ ᄅ ᅥ ᄇ ᅳ ᆫ
일주일에	ᄋ ᅵ ᆯ ᄌ ᅮ ᄋ ᅵ ᄅ ᅦ
정기적으로	ᄌ ᅥ ᆼ ᄀ ᅵ ᄌ ᅥ ᄀ ᅳ ᄅ ᅩ
모입니다	ᄆ ᅩ ᄋ ᅵ ᆷ ᄂ ᅵ ᄃ ᅡ
시위대가	ᄉ ᅵ ᄋ ᅱ ᄃ ᅢ ᄀ ᅡ
시청	ᄉ ᅵ ᄎ ᅥ ᆼ
앞	ᄋ ᅡ ᆸ
광장에	ᄀ ᅪ ᆼ ᄌ ᅡ ᆼ ᄋ ᅦ
모였다	ᄆ ᅩ ᄋ ᅧ ᆮ ᄄ ᅡ
비타민이	ᄇ ᅵ ᄐ ᅡ ᄆ ᅵ ᄂ ᅵ
모자라면	ᄆ ᅩ ᄌ ᅡ ᄅ ᅡ ᄆ ᅧ ᆫ
걸리기	ᄀ ᅥ ᆯ ᄅ ᅵ ᄀ ᅵ
쉽다	ᄉ ᅱ ᆸ ᄄ ᅡ
거스름돈이	ᄀ ᅥ ᄉ ᅳ ᄅ ᅳ ᆷ ᄃ ᅩ ᄂ ᅵ
모자란	ᄆ ᅩ ᄌ ᅡ ᄅ ᅡ ᆫ
몰고	ᄆ ᅩ ᆯ ᄀ ᅩ
오실	ᄋ ᅩ ᄉ ᅵ ᆯ
스무	ᄉ ᅳ ᄆ ᅮ
때부터	ᄄ ᅢ ᄇ ᅮ ᄐ ᅥ
모셨다	ᄆ ᅩ ᄉ ᅧ ᆮ ᄄ ᅡ
저녁마다	ᄌ ᅥ ᄂ ᅧ ᆼ ᄆ ᅡ ᄃ ᅡ
아들	ᄋ ᅡ ᄃ ᅳ ᆯ
녀석이	ᄂ ᅧ ᄉ ᅥ ᄀ ᅵ
방에서	ᄇ ᅡ ᆼ ᄋ ᅦ ᄉ ᅥ
하는지	ᄒ ᅡ ᄂ ᅳ ᆫ ᄌ ᅵ
모르겠어	ᄆ ᅩ ᄅ ᅳ ᄀ ᅦ ᄊ ᅥ
관해서는	ᄀ ᅪ ᆫ ᄒ ᅢ ᄉ ᅥ ᄂ ᅳ ᆫ
아무것도	ᄋ ᅡ ᄆ ᅮ ᄀ ᅥ ᆮ ᄄ ᅩ
시부모님을	ᄉ ᅵ ᄇ ᅮ ᄆ ᅩ ᄂ ᅵ ᄆ ᅳ ᆯ
모시고	ᄆ ᅩ ᄉ ᅵ ᄀ ᅩ
사세요	ᄉ ᅡ ᄉ ᅦ ᄋ ᅭ
손님들을	ᄉ ᅩ ᆫ ᄂ ᅵ ᆷ ᄃ ᅳ ᄅ ᅳ ᆯ
전철	ᄌ ᅥ ᆫ ᄎ ᅥ ᆯ
역까지	ᄋ ᅧ ᆨ ᄁ ᅡ ᄌ ᅵ
모셔	ᄆ ᅩ ᄉ ᅧ
드리세요	ᄃ ᅳ ᄅ ᅵ ᄉ ᅦ ᄋ ᅭ
못해요	ᄆ ᅩ ᄐ ᅢ ᄋ ᅭ
배가	ᄇ ᅢ ᄀ ᅡ
아파서	ᄋ ᅡ ᄑ ᅡ ᄉ ᅥ
못합니다	ᄆ ᅩ ᄐ ᅡ ᆷ ᄂ ᅵ ᄃ ᅡ
친구는	ᄎ ᅵ ᆫ ᄀ ᅮ ᄂ ᅳ ᆫ
감으면	ᄀ ᅡ ᄆ ᅳ ᄆ ᅧ ᆫ
묶고	ᄆ ᅮ ᆨ ᄁ ᅩ
다닌다	ᄃ ᅡ ᄂ ᅵ ᆫ ᄃ ᅡ
테러리스트들은	ᄐ ᅦ ᄅ ᅥ ᄅ ᅵ ᄉ ᅳ ᄐ ᅳ ᄃ ᅳ ᄅ ᅳ ᆫ
인질들의	ᄋ ᅵ ᆫ ᄌ ᅵ ᆯ ᄃ ᅳ ᄅ ᅴ
손과	ᄉ ᅩ ᆫ ᄀ ᅪ
밧줄로	ᄇ ᅡ ᆮ ᄍ ᅮ ᆯ ᄅ ᅩ
묶었다	ᄆ ᅮ ᄁ ᅥ ᆮ ᄄ ᅡ
물었어	ᄆ ᅮ ᄅ ᅥ ᄊ ᅥ
입에	ᄋ ᅵ ᄇ ᅦ
담배를	ᄃ ᅡ ᆷ ᄇ ᅢ ᄅ ᅳ ᆯ
물고	ᄆ ᅮ ᆯ ᄀ ᅩ
테러로	ᄐ ᅦ ᄅ ᅥ ᄅ ᅩ
다리가	ᄃ ᅡ ᄅ ᅵ ᄀ ᅡ
무너졌다	ᄆ ᅮ ᄂ ᅥ ᄌ ᅥ ᆮ ᄄ ᅡ
무너져도	ᄆ ᅮ ᄂ ᅥ ᄌ ᅥ ᄃ ᅩ
솟아날	ᄉ ᅩ ᄉ ᅡ ᄂ ᅡ ᆯ
구멍이	ᄀ ᅮ ᄆ ᅥ ᆼ ᄋ ᅵ
토요일에	ᄐ ᅩ ᄋ ᅭ ᄋ ᅵ ᄅ ᅦ
올	ᄋ ᅩ ᆯ
있나	ᄋ ᅵ ᆫ ᄂ ᅡ
물어보려고	ᄆ ᅮ ᄅ ᅥ ᄇ ᅩ ᄅ ᅧ ᄀ ᅩ
물어봐도	ᄆ ᅮ ᄅ ᅥ ᄇ ᅪ ᄃ ᅩ
상사는	ᄉ ᅡ ᆼ ᄉ ᅡ ᄂ ᅳ ᆫ
요구를	ᄋ ᅭ ᄀ ᅮ ᄅ ᅳ ᆯ
무시했다	ᄆ ᅮ ᄉ ᅵ ᄒ ᅢ ᆮ ᄄ ᅡ
자신을	ᄌ ᅡ ᄉ ᅵ ᄂ ᅳ ᆯ
무시할	ᄆ ᅮ ᄉ ᅵ ᄒ ᅡ ᆯ
화가	ᄒ ᅪ ᄀ ᅡ
법이다	ᄇ ᅥ ᄇ ᅵ ᄃ ᅡ
묻고	ᄆ ᅮ ᆮ ᄁ ᅩ
싶은	ᄉ ᅵ ᄑ ᅳ ᆫ
그걸	ᄀ ᅳ ᄀ ᅥ ᆯ
물어	ᄆ ᅮ ᄅ ᅥ
새싹이	ᄉ ᅢ ᄊ ᅡ ᄀ ᅵ
났어요	ᄂ ᅡ ᄊ ᅥ ᄋ ᅭ
인도네시아에서	ᄋ ᅵ ᆫ ᄃ ᅩ ᄂ ᅦ ᄉ ᅵ ᄋ ᅡ ᄋ ᅦ ᄉ ᅥ
지진이	ᄌ ᅵ ᄌ ᅵ ᄂ ᅵ
났다	ᄂ ᅡ ᆮ ᄄ ᅡ
숙제부터	ᄉ ᅮ ᆨ ᄍ ᅦ ᄇ ᅮ ᄐ ᅥ
놀아라	ᄂ ᅩ ᄅ ᅡ ᄅ ᅡ
신문에	ᄉ ᅵ ᆫ ᄆ ᅮ ᄂ ᅦ
광고를	ᄀ ᅪ ᆼ ᄀ ᅩ ᄅ ᅳ ᆯ
답안지를	ᄃ ᅡ ᄇ ᅡ ᆫ ᄌ ᅵ ᄅ ᅳ ᆯ
내세요	ᄂ ᅢ ᄉ ᅦ ᄋ ᅭ
배송료는	ᄇ ᅢ ᄉ ᅩ ᆼ ᄂ ᅭ ᄂ ᅳ ᆫ
골키퍼가	ᄀ ᅩ ᆯ ᄏ ᅵ ᄑ ᅥ ᄀ ᅡ
슛을	ᄉ ᅲ ᄉ ᅳ ᆯ
막아	ᄆ ᅡ ᄀ ᅡ
냈어요	ᄂ ᅢ ᄊ ᅥ ᄋ ᅭ
손을	ᄉ ᅩ ᄂ ᅳ ᆯ
내밀어	ᄂ ᅢ ᄆ ᅵ ᄅ ᅥ
악수를	ᄋ ᅡ ᆨ ᄊ ᅮ ᄅ ᅳ ᆯ
청했다	ᄎ ᅥ ᆼ ᄒ ᅢ ᆮ ᄄ ᅡ
창	ᄎ ᅡ ᆼ
내밀지	ᄂ ᅢ ᄆ ᅵ ᆯ ᄌ ᅵ
음식물	ᄋ ᅳ ᆷ ᄉ ᅵ ᆼ ᄆ ᅮ ᆯ
쓰레기를	ᄊ ᅳ ᄅ ᅦ ᄀ ᅵ ᄅ ᅳ ᆯ
바깥에	ᄇ ᅡ ᄁ ᅡ ᄐ ᅦ
내놓아라	ᄂ ᅢ ᄂ ᅩ ᄋ ᅡ ᄅ ᅡ
의자	ᄋ ᅴ ᄌ ᅡ
팔려고	ᄑ ᅡ ᆯ ᄅ ᅧ ᄀ ᅩ
내놓은	ᄂ ᅢ ᄂ ᅩ ᄋ ᅳ ᆫ
내리기	ᄂ ᅢ ᄅ ᅵ ᄀ ᅵ
시작했다	ᄉ ᅵ ᄌ ᅡ ᄏ ᅢ ᆮ ᄄ ᅡ
엘리베이터를	ᄋ ᅦ ᆯ ᄅ ᅵ ᄇ ᅦ ᄋ ᅵ ᄐ ᅥ ᄅ ᅳ ᆯ
타고	ᄐ ᅡ ᄀ ᅩ
오	ᄋ ᅩ
층에서	ᄎ ᅳ ᆼ ᄋ ᅦ ᄉ ᅥ
내리세요	ᄂ ᅢ ᄅ ᅵ ᄉ ᅦ ᄋ ᅭ
총을	ᄎ ᅩ ᆼ ᄋ ᅳ ᆯ
내려	ᄂ ᅢ ᄅ ᅧ
놓아	ᄂ ᅩ ᄋ ᅡ
주말에	ᄌ ᅮ ᄆ ᅡ ᄅ ᅦ
내려갈	ᄂ ᅢ ᄅ ᅧ ᄀ ᅡ ᆯ
최근	ᄎ ᅬ ᄀ ᅳ ᆫ
물가가	ᄆ ᅮ ᆯ ᄀ ᅡ ᄀ ᅡ
내려갔어요	ᄂ ᅢ ᄅ ᅧ ᄀ ᅡ ᄊ ᅥ ᄋ ᅭ
산을	ᄉ ᅡ ᄂ ᅳ ᆯ
올라가는	ᄋ ᅩ ᆯ ᄅ ᅡ ᄀ ᅡ ᄂ ᅳ ᆫ
내려가는	ᄂ ᅢ ᄅ ᅧ ᄀ ᅡ ᄂ ᅳ ᆫ
힘들어요	ᄒ ᅵ ᆷ ᄃ ᅳ ᄅ ᅥ ᄋ ᅭ
고향으로	ᄀ ᅩ ᄒ ᅣ ᆼ ᄋ ᅳ ᄅ ᅩ
내려오는	ᄂ ᅢ ᄅ ᅧ ᄋ ᅩ ᄂ ᅳ ᆫ
젊은	ᄌ ᅥ ᆯ ᄆ ᅳ ᆫ
많다	ᄆ ᅡ ᆫ ᄐ ᅡ
계단을	ᄀ ᅨ ᄃ ᅡ ᄂ ᅳ ᆯ
내려올	ᄂ ᅢ ᄅ ᅧ ᄋ ᅩ ᆯ
발	ᄇ ᅡ ᆯ
밖에	ᄇ ᅡ ᄁ ᅦ
나가	ᄂ ᅡ ᄀ ᅡ
놀자	ᄂ ᅩ ᆯ ᄌ ᅡ
모임을	ᄆ ᅩ ᄋ ᅵ ᄆ ᅳ ᆯ
나간	ᄂ ᅡ ᄀ ᅡ ᆫ
잘린	ᄌ ᅡ ᆯ ᄅ ᅵ ᆫ
발로	ᄇ ᅡ ᆯ ᄅ ᅩ
회사에서	ᄒ ᅬ ᄉ ᅡ ᄋ ᅦ ᄉ ᅥ
마리가	ᄆ ᅡ ᄅ ᅵ ᄀ ᅡ
사무실	ᄉ ᅡ ᄆ ᅮ ᄉ ᅵ ᆯ
건물	ᄀ ᅥ ᆫ ᄆ ᅮ ᆯ
위로	ᄋ ᅱ ᄅ ᅩ
날고	ᄂ ᅡ ᆯ ᄀ ᅩ
누구나	ᄂ ᅮ ᄀ ᅮ ᄂ ᅡ
하늘을	ᄒ ᅡ ᄂ ᅳ ᄅ ᅳ ᆯ
소망이	ᄉ ᅩ ᄆ ᅡ ᆼ ᄋ ᅵ
있지요	ᄋ ᅵ ᆮ ᄍ ᅵ ᄋ ᅭ
남기시겠어요	ᄂ ᅡ ᆷ ᄀ ᅵ ᄉ ᅵ ᄀ ᅦ ᄊ ᅥ ᄋ ᅭ
미국에	ᄆ ᅵ ᄀ ᅮ ᄀ ᅦ
남겨	ᄂ ᅡ ᆷ ᄀ ᅧ
두고	ᄃ ᅮ ᄀ ᅩ
혼자	ᄒ ᅩ ᆫ ᄌ ᅡ
왔습니다	ᄋ ᅪ ᆮ ᄊ ᅳ ᆷ ᄂ ᅵ ᄃ ᅡ
흉터가	ᄒ ᅲ ᆼ ᄐ ᅥ ᄀ ᅡ
남지	ᄂ ᅡ ᆷ ᄌ ᅵ
거라니	ᄀ ᅥ ᄅ ᅡ ᄂ ᅵ
다행이야	ᄃ ᅡ ᄒ ᅢ ᆼ ᄋ ᅵ ᄋ ᅣ
바구니	ᄇ ᅡ ᄀ ᅮ ᄂ ᅵ
속에	ᄉ ᅩ ᄀ ᅦ
샌드위치가	ᄉ ᅢ ᆫ ᄃ ᅳ ᄋ ᅱ ᄎ ᅵ ᄀ ᅡ
남아	ᄂ ᅡ ᄆ ᅡ
반으로	ᄇ ᅡ ᄂ ᅳ ᄅ ᅩ
나누자	ᄂ ᅡ ᄂ ᅮ ᄌ ᅡ
나눠	ᄂ ᅡ ᄂ ᅯ
먹어라	ᄆ ᅥ ᄀ ᅥ ᄅ ᅡ
주말에는	ᄌ ᅮ ᄆ ᅡ ᄅ ᅦ ᄂ ᅳ ᆫ
나오지	ᄂ ᅡ ᄋ ᅩ ᄌ ᅵ
대학	ᄃ ᅢ ᄒ ᅡ ᆨ
나오셨어요	ᄂ ᅡ ᄋ ᅩ ᄉ ᅧ ᄊ ᅥ ᄋ ᅭ
계속하려고	ᄀ ᅨ ᄉ ᅩ ᄏ ᅡ ᄅ ᅧ ᄀ ᅩ
나왔습니다	ᄂ ᅡ ᄋ ᅪ ᆮ ᄊ ᅳ ᆷ ᄂ ᅵ ᄃ ᅡ
어머니의	ᄋ ᅥ ᄆ ᅥ ᄂ ᅵ ᄋ ᅴ
건강이	ᄀ ᅥ ᆫ ᄀ ᅡ ᆼ ᄋ ᅵ
나빠지고	ᄂ ᅡ ᄈ ᅡ ᄌ ᅵ ᄀ ᅩ
시력이	ᄉ ᅵ ᄅ ᅧ ᄀ ᅵ
나빠졌어요	ᄂ ᅡ ᄈ ᅡ ᄌ ᅥ ᄊ ᅥ ᄋ ᅭ
제비들은	ᄌ ᅦ ᄇ ᅵ ᄃ ᅳ ᄅ ᅳ ᆫ
여름이	ᄋ ᅧ ᄅ ᅳ ᄆ ᅵ
북쪽으로	ᄇ ᅮ ᆨ ᄍ ᅩ ᄀ ᅳ ᄅ ᅩ
날아간다	ᄂ ᅡ ᄅ ᅡ ᄀ ᅡ ᆫ ᄃ ᅡ
파일이	ᄑ ᅡ ᄋ ᅵ ᄅ ᅵ
날아가	ᄂ ᅡ ᄅ ᅡ ᄀ ᅡ
버렸음을	ᄇ ᅥ ᄅ ᅧ ᄊ ᅳ ᄆ ᅳ ᆯ
알았다	ᄋ ᅡ ᄅ ᅡ ᆮ ᄄ ᅡ
가려고	ᄀ ᅡ ᄅ ᅧ ᄀ ᅩ
나섰다	ᄂ ᅡ ᄉ ᅥ ᆮ ᄄ ᅡ
남의	ᄂ ᅡ ᄆ ᅴ
일에	ᄋ ᅵ ᄅ ᅦ
나서지	ᄂ ᅡ ᄉ ᅥ ᄌ ᅵ
어젯밤	ᄋ ᅥ ᄌ ᅦ ᆮ ᄈ ᅡ ᆷ
사내	ᄉ ᅡ ᄂ ᅢ
낳았다	ᄂ ᅡ ᄋ ᅡ ᆮ ᄄ ᅡ
농장의	ᄂ ᅩ ᆼ ᄌ ᅡ ᆼ ᄋ ᅴ
암탉은	ᄋ ᅡ ᆷ ᄐ ᅡ ᆯ ᄀ ᅳ ᆫ
알을	ᄋ ᅡ ᄅ ᅳ ᆯ
개씩	ᄀ ᅢ ᄊ ᅵ ᆨ
낳는다	ᄂ ᅡ ᆫ ᄂ ᅳ ᆫ ᄃ ᅡ
폭력은	ᄑ ᅩ ᆼ ᄂ ᅧ ᄀ ᅳ ᆫ
폭력을	ᄑ ᅩ ᆼ ᄂ ᅧ ᄀ ᅳ ᆯ
낳는	ᄂ ᅡ ᆫ ᄂ ᅳ ᆫ
법입니다	ᄇ ᅥ ᄇ ᅵ ᆷ ᄂ ᅵ ᄃ ᅡ
그가	ᄀ ᅳ ᄀ ᅡ
파티에	ᄑ ᅡ ᄐ ᅵ ᄋ ᅦ
나타나서	ᄂ ᅡ ᄐ ᅡ ᄂ ᅡ ᄉ ᅥ
깜짝	ᄁ ᅡ ᆷ ᄍ ᅡ ᆨ
놀랐다	ᄂ ᅩ ᆯ ᄅ ᅡ ᆮ ᄄ ᅡ
고양이는	ᄀ ᅩ ᄋ ᅣ ᆼ ᄋ ᅵ ᄂ ᅳ ᆫ
언제나	ᄋ ᅥ ᆫ ᄌ ᅦ ᄂ ᅡ
밥	ᄇ ᅡ ᆸ
시간에	ᄉ ᅵ ᄀ ᅡ ᄂ ᅦ
딱	ᄄ ᅡ ᆨ
맞춰서	ᄆ ᅡ ᆮ ᄎ ᅯ ᄉ ᅥ
나타난다	ᄂ ᅡ ᄐ ᅡ ᄂ ᅡ ᆫ ᄃ ᅡ
법정에	ᄇ ᅥ ᆸ ᄍ ᅥ ᆼ ᄋ ᅦ
모습을	ᄆ ᅩ ᄉ ᅳ ᄇ ᅳ ᆯ
나타내지	ᄂ ᅡ ᄐ ᅡ ᄂ ᅢ ᄌ ᅵ
에이치	ᄋ ᅦ ᄋ ᅵ ᄎ ᅵ
투	ᄐ ᅮ
나타내는	ᄂ ᅡ ᄐ ᅡ ᄂ ᅢ ᄂ ᅳ ᆫ
기호이다	ᄀ ᅵ ᄒ ᅩ ᄋ ᅵ ᄃ ᅡ
맥주가	ᄆ ᅢ ᆨ ᄍ ᅮ ᄀ ᅡ
넘쳐요	ᄂ ᅥ ᆷ ᄎ ᅥ ᄋ ᅭ
자신감이	ᄌ ᅡ ᄉ ᅵ ᆫ ᄀ ᅡ ᄆ ᅵ
넘쳤다	ᄂ ᅥ ᆷ ᄎ ᅥ ᆮ ᄄ ᅡ
고개만	ᄀ ᅩ ᄀ ᅢ ᄆ ᅡ ᆫ
넘어가자	ᄂ ᅥ ᄆ ᅥ ᄀ ᅡ ᄌ ᅡ
장으로	ᄌ ᅡ ᆼ ᄋ ᅳ ᄅ ᅩ
넘어갑시다	ᄂ ᅥ ᄆ ᅥ ᄀ ᅡ ᆸ ᄊ ᅵ ᄃ ᅡ
정도를	ᄌ ᅥ ᆼ ᄃ ᅩ ᄅ ᅳ ᆯ
넘어선	ᄂ ᅥ ᄆ ᅥ ᄉ ᅥ ᆫ
한계를	ᄒ ᅡ ᆫ ᄀ ᅨ ᄅ ᅳ ᆯ
넘어섰어요	ᄂ ᅥ ᄆ ᅥ ᄉ ᅥ ᄊ ᅥ ᄋ ᅭ
셔틀콕을	ᄉ ᅧ ᄐ ᅳ ᆯ ᄏ ᅩ ᄀ ᅳ ᆯ
네트	ᄂ ᅦ ᄐ ᅳ
넘기는	ᄂ ᅥ ᆷ ᄀ ᅵ ᄂ ᅳ ᆫ
실패했다	ᄉ ᅵ ᆯ ᄑ ᅢ ᄒ ᅢ ᆮ ᄄ ᅡ
페이지를	ᄑ ᅦ ᄋ ᅵ ᄌ ᅵ ᄅ ᅳ ᆯ
장	ᄌ ᅡ ᆼ
넘겨라	ᄂ ᅥ ᆷ ᄀ ᅧ ᄅ ᅡ
시가	ᄉ ᅵ ᄀ ᅡ
넘었어	ᄂ ᅥ ᄆ ᅥ ᄊ ᅥ
예산을	ᄋ ᅨ ᄉ ᅡ ᄂ ᅳ ᆯ
강도는	ᄀ ᅡ ᆼ ᄃ ᅩ ᄂ ᅳ ᆫ
담을	ᄃ ᅡ ᄆ ᅳ ᆯ
넘어	ᄂ ᅥ ᄆ ᅥ
들어온	ᄃ ᅳ ᄅ ᅥ ᄋ ᅩ ᆫ
분명합니다	ᄇ ᅮ ᆫ ᄆ ᅧ ᆼ ᄒ ᅡ ᆷ ᄂ ᅵ ᄃ ᅡ
세탁기에	ᄉ ᅦ ᄐ ᅡ ᆨ ᄁ ᅵ ᄋ ᅦ
넣지	ᄂ ᅥ ᄎ ᅵ
넣어	ᄂ ᅥ ᄋ ᅥ
팔에	ᄑ ᅡ ᄅ ᅦ
심한	ᄉ ᅵ ᆷ ᄒ ᅡ ᆫ
통증을	ᄐ ᅩ ᆼ ᄌ ᅳ ᆼ ᄋ ᅳ ᆯ
느꼈다	ᄂ ᅳ ᄁ ᅧ ᆮ ᄄ ᅡ
시작하고	ᄉ ᅵ ᄌ ᅡ ᄏ ᅡ ᄀ ᅩ
좋아지는	ᄌ ᅩ ᄋ ᅡ ᄌ ᅵ ᄂ ᅳ ᆫ
느끼고	ᄂ ᅳ ᄁ ᅵ ᄀ ᅩ
늙어	ᄂ ᅳ ᆯ ᄀ ᅥ
보이세요	ᄇ ᅩ ᄋ ᅵ ᄉ ᅦ ᄋ ᅭ
할아버지는	ᄒ ᅡ ᄅ ᅡ ᄇ ᅥ ᄌ ᅵ ᄂ ᅳ ᆫ
하시기에는	ᄒ ᅡ ᄉ ᅵ ᄀ ᅵ ᄋ ᅦ ᄂ ᅳ ᆫ
늙으셨어	ᄂ ᅳ ᆯ ᄀ ᅳ ᄉ ᅧ ᄊ ᅥ
몸무게가	ᄆ ᅩ ᆷ ᄆ ᅮ ᄀ ᅦ ᄀ ᅡ
약간	ᄋ ᅣ ᆨ ᄁ ᅡ ᆫ
늘었어요	ᄂ ᅳ ᄅ ᅥ ᄊ ᅥ ᄋ ᅭ
아내의	ᄋ ᅡ ᄂ ᅢ ᄋ ᅴ
요리	ᄋ ᅭ ᄅ ᅵ
솜씨가	ᄉ ᅩ ᆷ ᄊ ᅵ ᄀ ᅡ
늘고	ᄂ ᅳ ᆯ ᄀ ᅩ
치마	ᄎ ᅵ ᄆ ᅡ
길이를	ᄀ ᅵ ᄅ ᅵ ᄅ ᅳ ᆯ
늘리고	ᄂ ᅳ ᆯ ᄅ ᅵ ᄀ ᅩ
미국이	ᄆ ᅵ ᄀ ᅮ ᄀ ᅵ
수출을	ᄉ ᅮ ᄎ ᅮ ᄅ ᅳ ᆯ
늘리기	ᄂ ᅳ ᆯ ᄅ ᅵ ᄀ ᅵ
압력을	ᄋ ᅡ ᆷ ᄂ ᅧ ᄀ ᅳ ᆯ
가하고	ᄀ ᅡ ᄒ ᅡ ᄀ ᅩ
셔츠가	ᄉ ᅧ ᄎ ᅳ ᄀ ᅡ
늘어나서	ᄂ ᅳ ᄅ ᅥ ᄂ ᅡ ᄉ ᅥ
속상해요	ᄉ ᅩ ᆨ ᄊ ᅡ ᆼ ᄒ ᅢ ᄋ ᅭ
이혼율이	ᄋ ᅵ ᄒ ᅩ ᄂ ᅲ ᄅ ᅵ
늘어나고	ᄂ ᅳ ᄅ ᅥ ᄂ ᅡ ᄀ ᅩ
녀석은	ᄂ ᅧ ᄉ ᅥ ᄀ ᅳ ᆫ
늦는다	ᄂ ᅳ ᆫ ᄂ ᅳ ᆫ ᄃ ᅡ
늦었어	ᄂ ᅳ ᄉ ᅥ ᄊ ᅥ
책상	ᄎ ᅢ ᆨ ᄊ ᅡ ᆼ
놓여	ᄂ ᅩ ᄋ ᅧ
있던	ᄋ ᅵ ᆮ ᄄ ᅥ ᆫ
연필	ᄋ ᅧ ᆫ ᄑ ᅵ ᆯ
어디	ᄋ ᅥ ᄃ ᅵ
갔어	ᄀ ᅡ ᄊ ᅥ
소식을	ᄉ ᅩ ᄉ ᅵ ᄀ ᅳ ᆯ
들으니	ᄃ ᅳ ᄅ ᅳ ᄂ ᅵ
마음이	ᄆ ᅡ ᄋ ᅳ ᄆ ᅵ
놓였다	ᄂ ᅩ ᄋ ᅧ ᆮ ᄄ ᅡ
인형을	ᄋ ᅵ ᆫ ᄒ ᅧ ᆼ ᄋ ᅳ ᆯ
노는	ᄂ ᅩ ᄂ ᅳ ᆫ
아이들과	ᄋ ᅡ ᄋ ᅵ ᄃ ᅳ ᆯ ᄀ ᅪ
놀	ᄂ ᅩ ᆯ
편하다	ᄑ ᅧ ᆫ ᄒ ᅡ ᄃ ᅡ
갑작스러운	ᄀ ᅡ ᆸ ᄍ ᅡ ᆨ ᄊ ᅳ ᄅ ᅥ ᄋ ᅮ ᆫ
청혼에	ᄎ ᅥ ᆼ ᄒ ᅩ ᄂ ᅦ
소식은	ᄉ ᅩ ᄉ ᅵ ᄀ ᅳ ᆫ
놀라게	ᄂ ᅩ ᆯ ᄅ ᅡ ᄀ ᅦ
했다	ᄒ ᅢ ᆮ ᄄ ᅡ
막으려면	ᄆ ᅡ ᄀ ᅳ ᄅ ᅧ ᄆ ᅧ ᆫ
높여야	ᄂ ᅩ ᄑ ᅧ ᄋ ᅣ
야간에	ᄋ ᅣ ᄀ ᅡ ᄂ ᅦ
운전자들은	ᄋ ᅮ ᆫ ᄌ ᅥ ᆫ ᄌ ᅡ ᄃ ᅳ ᄅ ᅳ ᆫ
속도를	ᄉ ᅩ ᆨ ᄄ ᅩ ᄅ ᅳ ᆯ
높이면	ᄂ ᅩ ᄑ ᅵ ᄆ ᅧ ᆫ
된다	ᄃ ᅬ ᆫ ᄃ ᅡ
춤추는	ᄎ ᅮ ᆷ ᄎ ᅮ ᄂ ᅳ ᆫ
노래하는	ᄂ ᅩ ᄅ ᅢ ᄒ ᅡ ᄂ ᅳ ᆫ
좋다	ᄌ ᅩ ᄐ ᅡ
밤새	ᄇ ᅡ ᆷ ᄉ ᅢ
춤추고	ᄎ ᅮ ᆷ ᄎ ᅮ ᄀ ᅩ
노래해도	ᄂ ᅩ ᄅ ᅢ ᄒ ᅢ ᄃ ᅩ
지치는	ᄌ ᅵ ᄎ ᅵ ᄂ ᅳ ᆫ
법이	ᄇ ᅥ ᄇ ᅵ
경제	ᄀ ᅧ ᆼ ᄌ ᅦ
활성화에	ᄒ ᅪ ᆯ ᄉ ᅥ ᆼ ᄒ ᅪ ᄋ ᅦ
노력하고	ᄂ ᅩ ᄅ ᅧ ᄏ ᅡ ᄀ ᅩ
합격을	ᄒ ᅡ ᆸ ᄁ ᅧ ᄀ ᅳ ᆯ
열심히	ᄋ ᅧ ᆯ ᄉ ᅵ ᆷ ᄒ ᅵ
노력했어	ᄂ ᅩ ᄅ ᅧ ᄏ ᅢ ᄊ ᅥ
식탁	ᄉ ᅵ ᆨ ᄐ ᅡ ᆨ
놓아라	ᄂ ᅩ ᄋ ᅡ ᄅ ᅡ
열어	ᄋ ᅧ ᄅ ᅥ
놓으세요	ᄂ ᅩ ᄋ ᅳ ᄉ ᅦ ᄋ ᅭ
좋아하는	ᄌ ᅩ ᄋ ᅡ ᄒ ᅡ ᄂ ᅳ ᆫ
연속극을	ᄋ ᅧ ᆫ ᄉ ᅩ ᆨ ᄁ ᅳ ᄀ ᅳ ᆯ
놓치고	ᄂ ᅩ ᄎ ᅵ ᄀ ᅩ
놓치지	ᄂ ᅩ ᄎ ᅵ ᄌ ᅵ
비행기를	ᄇ ᅵ ᄒ ᅢ ᆼ ᄀ ᅵ ᄅ ᅳ ᆯ
놓칠	ᄂ ᅩ ᄎ ᅵ ᆯ
뻔했어요	ᄈ ᅥ ᆫ ᄒ ᅢ ᄊ ᅥ ᄋ ᅭ
침대에	ᄎ ᅵ ᆷ ᄃ ᅢ ᄋ ᅦ
계신다	ᄀ ᅨ ᄉ ᅵ ᆫ ᄃ ᅡ
오른쪽으로	ᄋ ᅩ ᄅ ᅳ ᆫ ᄍ ᅩ ᄀ ᅳ ᄅ ᅩ
누우세요	ᄂ ᅮ ᄋ ᅮ ᄉ ᅦ ᄋ ᅭ
외부	ᄋ ᅬ ᄇ ᅮ
전화는	ᄌ ᅥ ᆫ ᄒ ᅪ ᄂ ᅳ ᆫ
구	ᄀ ᅮ
번을	ᄇ ᅥ ᄂ ᅳ ᆯ
누르세요	ᄂ ᅮ ᄅ ᅳ ᄉ ᅦ ᄋ ᅭ
화를	ᄒ ᅪ ᄅ ᅳ ᆯ
누를	ᄂ ᅮ ᄅ ᅳ ᆯ
없었다	ᄋ ᅥ ᆸ ᄊ ᅥ ᆮ ᄄ ᅡ
있으면	ᄋ ᅵ ᄊ ᅳ ᄆ ᅧ ᆫ
전시회에	ᄌ ᅥ ᆫ ᄉ ᅵ ᄒ ᅬ ᄋ ᅦ
오세요	ᄋ ᅩ ᄉ ᅦ ᄋ ᅭ
돌아오라고	ᄃ ᅩ ᄅ ᅡ ᄋ ᅩ ᄅ ᅡ ᄀ ᅩ
외쳤다	ᄋ ᅬ ᄎ ᅥ ᆮ ᄄ ᅡ
누군가	ᄂ ᅮ ᄀ ᅮ ᆫ ᄀ ᅡ
달라고	ᄃ ᅡ ᆯ ᄅ ᅡ ᄀ ᅩ
외치는	ᄋ ᅬ ᄎ ᅵ ᄂ ᅳ ᆫ
층까지	ᄎ ᅳ ᆼ ᄁ ᅡ ᄌ ᅵ
걸어	ᄀ ᅥ ᄅ ᅥ
올라가세요	ᄋ ᅩ ᆯ ᄅ ᅡ ᄀ ᅡ ᄉ ᅦ ᄋ ᅭ
기온이	ᄀ ᅵ ᄋ ᅩ ᄂ ᅵ
올라갔다	ᄋ ᅩ ᆯ ᄅ ᅡ ᄀ ᅡ ᆮ ᄄ ᅡ
서울에	ᄉ ᅥ ᄋ ᅮ ᄅ ᅦ
올라오셨어요	ᄋ ᅩ ᆯ ᄅ ᅡ ᄋ ᅩ ᄉ ᅧ ᄊ ᅥ ᄋ ᅭ
옥상으로	ᄋ ᅩ ᆨ ᄊ ᅡ ᆼ ᄋ ᅳ ᄅ ᅩ
올라오세요	ᄋ ᅩ ᆯ ᄅ ᅡ ᄋ ᅩ ᄉ ᅦ ᄋ ᅭ
바지	ᄇ ᅡ ᄌ ᅵ
지퍼를	ᄌ ᅵ ᄑ ᅥ ᄅ ᅳ ᆯ
올리세요	ᄋ ᅩ ᆯ ᄅ ᅵ ᄉ ᅦ ᄋ ᅭ
점수를	ᄌ ᅥ ᆷ ᄉ ᅮ ᄅ ᅳ ᆯ
올릴	ᄋ ᅩ ᆯ ᄅ ᅵ ᆯ
방법이	ᄇ ᅡ ᆼ ᄇ ᅥ ᄇ ᅵ
없을까	ᄋ ᅥ ᆸ ᄊ ᅳ ᆯ ᄁ ᅡ
게시판에	ᄀ ᅦ ᄉ ᅵ ᄑ ᅡ ᄂ ᅦ
글	ᄀ ᅳ ᆯ
올려	ᄋ ᅩ ᆯ ᄅ ᅧ
방으로	ᄇ ᅡ ᆼ ᄋ ᅳ ᄅ ᅩ
옮겨	ᄋ ᅩ ᆷ ᄀ ᅧ
아버지께서	ᄋ ᅡ ᄇ ᅥ ᄌ ᅵ ᄁ ᅦ ᄉ ᅥ
저더러	ᄌ ᅥ ᄃ ᅥ ᄅ ᅥ
캐비닛을	ᄏ ᅢ ᄇ ᅵ ᄂ ᅵ ᄉ ᅳ ᆯ
옮기라고	ᄋ ᅩ ᆷ ᄀ ᅵ ᄅ ᅡ ᄀ ᅩ
하셨어요	ᄒ ᅡ ᄉ ᅧ ᄊ ᅥ ᄋ ᅭ
오르는	ᄋ ᅩ ᄅ ᅳ ᄂ ᅳ ᆫ
결코	ᄀ ᅧ ᆯ ᄏ ᅩ
쉽지	ᄉ ᅱ ᆸ ᄍ ᅵ
성적이	ᄉ ᅥ ᆼ ᄌ ᅥ ᄀ ᅵ
올랐어요	ᄋ ᅩ ᆯ ᄅ ᅡ ᄊ ᅥ ᄋ ᅭ
빚을	ᄇ ᅵ ᄌ ᅳ ᆯ
갚으려고	ᄀ ᅡ ᄑ ᅳ ᄅ ᅧ ᄀ ᅩ
친구한테	ᄎ ᅵ ᆫ ᄀ ᅮ ᄒ ᅡ ᆫ ᄐ ᅦ
오토바이를	ᄋ ᅩ ᄐ ᅩ ᄇ ᅡ ᄋ ᅵ ᄅ ᅳ ᆯ
팔았다	ᄑ ᅡ ᄅ ᅡ ᆮ ᄄ ᅡ
저희는	ᄌ ᅥ ᄒ ᅵ ᄂ ᅳ ᆫ
물건을	ᄆ ᅮ ᆯ ᄀ ᅥ ᄂ ᅳ ᆯ
다발로	ᄃ ᅡ ᄇ ᅡ ᆯ ᄅ ᅩ
팔아요	ᄑ ᅡ ᄅ ᅡ ᄋ ᅭ
코스모스는	ᄏ ᅩ ᄉ ᅳ ᄆ ᅩ ᄉ ᅳ ᄂ ᅳ ᆫ
가을에	ᄀ ᅡ ᄋ ᅳ ᄅ ᅦ
펴요	ᄑ ᅧ ᄋ ᅭ
벚꽃이	ᄇ ᅥ ᆮ ᄁ ᅩ ᄎ ᅵ
활짝	ᄒ ᅪ ᆯ ᄍ ᅡ ᆨ
폈다	ᄑ ᅧ ᆮ ᄄ ᅡ
격렬한	ᄀ ᅧ ᆼ ᄂ ᅧ ᆯ ᄒ ᅡ ᆫ
피하셔야	ᄑ ᅵ ᄒ ᅡ ᄉ ᅧ ᄋ ᅣ
피해요	ᄑ ᅵ ᄒ ᅢ ᄋ ᅭ
난로에	ᄂ ᅡ ᆯ ᄅ ᅩ ᄋ ᅦ
피웠다	ᄑ ᅵ ᄋ ᅯ ᆮ ᄄ ᅡ
피워도	ᄑ ᅵ ᄋ ᅯ ᄃ ᅩ
되나	ᄃ ᅬ ᄂ ᅡ
주어진	ᄌ ᅮ ᄋ ᅥ ᄌ ᅵ ᆫ
쉽게	ᄉ ᅱ ᆸ ᄁ ᅦ
포기하지	ᄑ ᅩ ᄀ ᅵ ᄒ ᅡ ᄌ ᅵ
않습니다	ᄋ ᅡ ᆫ ᄊ ᅳ ᆷ ᄂ ᅵ ᄃ ᅡ
포기하기에는	ᄑ ᅩ ᄀ ᅵ ᄒ ᅡ ᄀ ᅵ ᄋ ᅦ ᄂ ᅳ ᆫ
일러	ᄋ ᅵ ᆯ ᄅ ᅥ
요금에	ᄋ ᅭ ᄀ ᅳ ᄆ ᅦ
식사가	ᄉ ᅵ ᆨ ᄊ ᅡ ᄀ ᅡ
포함되어	ᄑ ᅩ ᄒ ᅡ ᆷ ᄃ ᅬ ᄋ ᅥ
있습니까	ᄋ ᅵ ᆮ ᄊ ᅳ ᆷ ᄂ ᅵ ᄁ ᅡ
통근	ᄐ ᅩ ᆼ ᄀ ᅳ ᆫ
수당은	ᄉ ᅮ ᄃ ᅡ ᆼ ᄋ ᅳ ᆫ
봉급에	ᄇ ᅩ ᆼ ᄀ ᅳ ᄇ ᅦ
세금을	ᄉ ᅦ ᄀ ᅳ ᄆ ᅳ ᆯ
포함하는	ᄑ ᅩ ᄒ ᅡ ᆷ ᄒ ᅡ ᄂ ᅳ ᆫ
가족은	ᄀ ᅡ ᄌ ᅩ ᄀ ᅳ ᆫ
포함해서	ᄑ ᅩ ᄒ ᅡ ᆷ ᄒ ᅢ ᄉ ᅥ
명입니다	ᄆ ᅧ ᆼ ᄋ ᅵ ᆷ ᄂ ᅵ ᄃ ᅡ
초대장에서	ᄎ ᅩ ᄃ ᅢ ᄌ ᅡ ᆼ ᄋ ᅦ ᄉ ᅥ
빼라	ᄈ ᅢ ᄅ ᅡ
빼기	ᄈ ᅢ ᄀ ᅵ
팔은	ᄑ ᅡ ᄅ ᅳ ᆫ
살을	ᄉ ᅡ ᄅ ᅳ ᆯ
빼는	ᄈ ᅢ ᄂ ᅳ ᆫ
뭘까요	ᄆ ᅯ ᆯ ᄁ ᅡ ᄋ ᅭ
혼잡한	ᄒ ᅩ ᆫ ᄌ ᅡ ᄑ ᅡ ᆫ
빠져나갔니	ᄈ ᅡ ᄌ ᅥ ᄂ ᅡ ᄀ ᅡ ᆫ ᄂ ᅵ
아무도	ᄋ ᅡ ᄆ ᅮ ᄃ ᅩ
여기를	ᄋ ᅧ ᄀ ᅵ ᄅ ᅳ ᆯ
빠져나갈	ᄈ ᅡ ᄌ ᅥ ᄂ ᅡ ᄀ ᅡ ᆯ
바다에	ᄇ ᅡ ᄃ ᅡ ᄋ ᅦ
빠져	ᄈ ᅡ ᄌ ᅥ
죽을	ᄌ ᅮ ᄀ ᅳ ᆯ
뻔한	ᄈ ᅥ ᆫ ᄒ ᅡ ᆫ
사랑에	ᄉ ᅡ ᄅ ᅡ ᆼ ᄋ ᅦ
빠진	ᄈ ᅡ ᄌ ᅵ ᆫ
움큼씩	ᄋ ᅮ ᆷ ᄏ ᅳ ᆷ ᄊ ᅵ ᆨ
합격자	ᄒ ᅡ ᆸ ᄁ ᅧ ᆨ ᄍ ᅡ
명단에서	ᄆ ᅧ ᆼ ᄃ ᅡ ᄂ ᅦ ᄉ ᅥ
학교를	ᄒ ᅡ ᆨ ᄁ ᅭ ᄅ ᅳ ᆯ
자주	ᄌ ᅡ ᄌ ᅮ
빠져요	ᄈ ᅡ ᄌ ᅥ ᄋ ᅭ
치과에서	ᄎ ᅵ ᄀ ᅪ ᄋ ᅦ ᄉ ᅥ
뽑아서	ᄈ ᅩ ᄇ ᅡ ᄉ ᅥ
씹을	ᄊ ᅵ ᄇ ᅳ ᆯ
명만	ᄆ ᅧ ᆼ ᄆ ᅡ ᆫ
뽑을	ᄈ ᅩ ᄇ ᅳ ᆯ
음식에	ᄋ ᅳ ᆷ ᄉ ᅵ ᄀ ᅦ
후추	ᄒ ᅮ ᄎ ᅮ
뿌려라	ᄈ ᅮ ᄅ ᅧ ᄅ ᅡ
향수만	ᄒ ᅣ ᆼ ᄉ ᅮ ᄆ ᅡ ᆫ
뿌리면	ᄈ ᅮ ᄅ ᅵ ᄆ ᅧ ᆫ
좌석	ᄌ ᅪ ᄉ ᅥ ᆨ
벨트를	ᄇ ᅦ ᆯ ᄐ ᅳ ᄅ ᅳ ᆯ
풀어	ᄑ ᅮ ᄅ ᅥ
풀겠어	ᄑ ᅮ ᆯ ᄀ ᅦ ᄊ ᅥ
왼쪽	ᄋ ᅬ ᆫ ᄍ ᅩ ᆨ
끈이	ᄁ ᅳ ᄂ ᅵ
풀렸어요	ᄑ ᅮ ᆯ ᄅ ᅧ ᄊ ᅥ ᄋ ᅭ
의외로	ᄋ ᅴ ᄋ ᅬ ᄅ ᅩ
풀렸어	ᄑ ᅮ ᆯ ᄅ ᅧ ᄊ ᅥ
할아버지	ᄒ ᅡ ᄅ ᅡ ᄇ ᅥ ᄌ ᅵ
이불	ᄋ ᅵ ᄇ ᅮ ᆯ
펴	ᄑ ᅧ
드려라	ᄃ ᅳ ᄅ ᅧ ᄅ ᅡ
펴세요	ᄑ ᅧ ᄉ ᅦ ᄋ ᅭ
애의	ᄋ ᅢ ᄋ ᅴ
펼쳐져	ᄑ ᅧ ᆯ ᄎ ᅥ ᄌ ᅥ
부산국제영화제가	ᄇ ᅮ ᄉ ᅡ ᆫ ᄀ ᅮ ᆨ ᄍ ᅦ ᄋ ᅧ ᆼ ᄒ ᅪ ᄌ ᅦ ᄀ ᅡ
시월	ᄉ ᅵ ᄋ ᅯ ᆯ
일부터	ᄋ ᅵ ᆯ ᄇ ᅮ ᄐ ᅥ
팔	ᄑ ᅡ ᆯ
일까지	ᄋ ᅵ ᆯ ᄁ ᅡ ᄌ ᅵ
펼쳐질	ᄑ ᅧ ᆯ ᄎ ᅥ ᄌ ᅵ ᆯ
예정입니다	ᄋ ᅨ ᄌ ᅥ ᆼ ᄋ ᅵ ᆷ ᄂ ᅵ ᄃ ᅡ
지하철에서는	ᄌ ᅵ ᄒ ᅡ ᄎ ᅥ ᄅ ᅦ ᄉ ᅥ ᄂ ᅳ ᆫ
신문을	ᄉ ᅵ ᆫ ᄆ ᅮ ᄂ ᅳ ᆯ
펼치고	ᄑ ᅧ ᆯ ᄎ ᅵ ᄀ ᅩ
봐서는	ᄇ ᅪ ᄉ ᅥ ᄂ ᅳ ᆫ
막상막하의	ᄆ ᅡ ᆨ ᄊ ᅡ ᆼ ᄆ ᅡ ᄏ ᅡ ᄋ ᅴ
경기를	ᄀ ᅧ ᆼ ᄀ ᅵ ᄅ ᅳ ᆯ
펼쳤습니다	ᄑ ᅧ ᆯ ᄎ ᅥ ᆮ ᄊ ᅳ ᆷ ᄂ ᅵ ᄃ ᅡ
경상도	ᄀ ᅧ ᆼ ᄉ ᅡ ᆼ ᄃ ᅩ
남자들은	ᄂ ᅡ ᆷ ᄌ ᅡ ᄃ ᅳ ᄅ ᅳ ᆫ
애정을	ᄋ ᅢ ᄌ ᅥ ᆼ ᄋ ᅳ ᆯ
표현하지	ᄑ ᅭ ᄒ ᅧ ᆫ ᄒ ᅡ ᄌ ᅵ
한국어로	ᄒ ᅡ ᆫ ᄀ ᅮ ᄀ ᅥ ᄅ ᅩ
생각을	ᄉ ᅢ ᆼ ᄀ ᅡ ᄀ ᅳ ᆯ
표현하는	ᄑ ᅭ ᄒ ᅧ ᆫ ᄒ ᅡ ᄂ ᅳ ᆫ
먹을지	ᄆ ᅥ ᄀ ᅳ ᆯ ᄌ ᅵ
생각한다	ᄉ ᅢ ᆼ ᄀ ᅡ ᄏ ᅡ ᆫ ᄃ ᅡ
아무리	ᄋ ᅡ ᄆ ᅮ ᄅ ᅵ
생각해	ᄉ ᅢ ᆼ ᄀ ᅡ ᄏ ᅢ
봐도	ᄇ ᅪ ᄃ ᅩ
모르겠어요	ᄆ ᅩ ᄅ ᅳ ᄀ ᅦ ᄊ ᅥ ᄋ ᅭ
범인으로	ᄇ ᅥ ᄆ ᅵ ᄂ ᅳ ᄅ ᅩ
생각됩니다	ᄉ ᅢ ᆼ ᄀ ᅡ ᆨ ᄄ ᅬ ᆷ ᄂ ᅵ ᄃ ᅡ
아프다고	ᄋ ᅡ ᄑ ᅳ ᄃ ᅡ ᄀ ᅩ
생각되면	ᄉ ᅢ ᆼ ᄀ ᅡ ᆨ ᄄ ᅬ ᄆ ᅧ ᆫ
가라	ᄀ ᅡ ᄅ ᅡ
의견이	ᄋ ᅴ ᄀ ᅧ ᄂ ᅵ
생각나면	ᄉ ᅢ ᆼ ᄀ ᅡ ᆼ ᄂ ᅡ ᄆ ᅧ ᆫ
비만	ᄇ ᅵ ᄆ ᅡ ᆫ
보면	ᄇ ᅩ ᄆ ᅧ ᆫ
친구가	ᄎ ᅵ ᆫ ᄀ ᅮ ᄀ ᅡ
생각나	ᄉ ᅢ ᆼ ᄀ ᅡ ᆼ ᄂ ᅡ
건너편에	ᄀ ᅥ ᆫ ᄂ ᅥ ᄑ ᅧ ᄂ ᅦ
새로	ᄉ ᅢ ᄅ ᅩ
생긴	ᄉ ᅢ ᆼ ᄀ ᅵ ᆫ
커피숍	ᄏ ᅥ ᄑ ᅵ ᄉ ᅭ ᆸ
봤니	ᄇ ᅪ ᆫ ᄂ ᅵ
바비	ᄇ ᅡ ᄇ ᅵ
인형처럼	ᄋ ᅵ ᆫ ᄒ ᅧ ᆼ ᄎ ᅥ ᄅ ᅥ ᆷ
생겼어요	ᄉ ᅢ ᆼ ᄀ ᅧ ᄊ ᅥ ᄋ ᅭ
생겨나고	ᄉ ᅢ ᆼ ᄀ ᅧ ᄂ ᅡ ᄀ ᅩ
곰팡이는	ᄀ ᅩ ᆷ ᄑ ᅡ ᆼ ᄋ ᅵ ᄂ ᅳ ᆫ
생겨난	ᄉ ᅢ ᆼ ᄀ ᅧ ᄂ ᅡ ᆫ
길	ᄀ ᅵ ᆯ
산다	ᄉ ᅡ ᆫ ᄃ ᅡ
기숙사에서	ᄀ ᅵ ᄉ ᅮ ᆨ ᄊ ᅡ ᄋ ᅦ ᄉ ᅥ
지겨워	ᄌ ᅵ ᄀ ᅧ ᄋ ᅯ
절	ᄌ ᅥ ᆯ
살려	ᄉ ᅡ ᆯ ᄅ ᅧ
주셨어요	ᄌ ᅮ ᄉ ᅧ ᄊ ᅥ ᄋ ᅭ
대통령이	ᄃ ᅢ ᄐ ᅩ ᆼ ᄂ ᅧ ᆼ ᄋ ᅵ
가장	ᄀ ᅡ ᄌ ᅡ ᆼ
먼저	ᄆ ᅥ ᆫ ᄌ ᅥ
해야	ᄒ ᅢ ᄋ ᅣ
경제를	ᄀ ᅧ ᆼ ᄌ ᅦ ᄅ ᅳ ᆯ
살리는	ᄉ ᅡ ᆯ ᄅ ᅵ ᄂ ᅳ ᆫ
서랍을	ᄉ ᅥ ᄅ ᅡ ᄇ ᅳ ᆯ
살펴봤어	ᄉ ᅡ ᆯ ᄑ ᅧ ᄇ ᅪ ᄊ ᅥ
비용	ᄇ ᅵ ᄋ ᅭ ᆼ
자세히	ᄌ ᅡ ᄉ ᅦ ᄒ ᅵ
살펴봐야	ᄉ ᅡ ᆯ ᄑ ᅧ ᄇ ᅪ ᄋ ᅣ
남자와	ᄂ ᅡ ᆷ ᄌ ᅡ ᄋ ᅪ
상상할	ᄉ ᅡ ᆼ ᄉ ᅡ ᆼ ᄒ ᅡ ᆯ
가격은	ᄀ ᅡ ᄀ ᅧ ᄀ ᅳ ᆫ
선생님이	ᄉ ᅥ ᆫ ᄉ ᅢ ᆼ ᄂ ᅵ ᄆ ᅵ
상상하시는	ᄉ ᅡ ᆼ ᄉ ᅡ ᆼ ᄒ ᅡ ᄉ ᅵ ᄂ ᅳ ᆫ
저렴합니다	ᄌ ᅥ ᄅ ᅧ ᆷ ᄒ ᅡ ᆷ ᄂ ᅵ ᄃ ᅡ
수십	ᄉ ᅮ ᄉ ᅵ ᆸ
개의	ᄀ ᅢ ᄋ ᅴ
언어가	ᄋ ᅥ ᄂ ᅥ ᄀ ᅡ
땅에서	ᄄ ᅡ ᆼ ᄋ ᅦ ᄉ ᅥ
사라지고	ᄉ ᅡ ᄅ ᅡ ᄌ ᅵ ᄀ ᅩ
달이	ᄃ ᅡ ᄅ ᅵ
구름	ᄀ ᅮ ᄅ ᅳ ᆷ
사라졌다	ᄉ ᅡ ᄅ ᅡ ᄌ ᅥ ᆮ ᄄ ᅡ
자유보다	ᄌ ᅡ ᄋ ᅲ ᄇ ᅩ ᄃ ᅡ
복종을	ᄇ ᅩ ᆨ ᄍ ᅩ ᆼ ᄋ ᅳ ᆯ
사랑해요	ᄉ ᅡ ᄅ ᅡ ᆼ ᄒ ᅢ ᄋ ᅭ
사랑하지	ᄉ ᅡ ᄅ ᅡ ᆼ ᄒ ᅡ ᄌ ᅵ
이것은	ᄋ ᅵ ᄀ ᅥ ᄉ ᅳ ᆫ
무언가를	ᄆ ᅮ ᄋ ᅥ ᆫ ᄀ ᅡ ᄅ ᅳ ᆯ
사용된다	ᄉ ᅡ ᄋ ᅭ ᆼ ᄃ ᅬ ᆫ ᄃ ᅡ
방은	ᄇ ᅡ ᆼ ᄋ ᅳ ᆫ
응접실로	ᄋ ᅳ ᆼ ᄌ ᅥ ᆸ ᄊ ᅵ ᆯ ᄅ ᅩ
사용될	ᄉ ᅡ ᄋ ᅭ ᆼ ᄃ ᅬ ᆯ
지렁이를	ᄌ ᅵ ᄅ ᅥ ᆼ ᄋ ᅵ ᄅ ᅳ ᆯ
미끼로	ᄆ ᅵ ᄁ ᅵ ᄅ ᅩ
사용해	ᄉ ᅡ ᄋ ᅭ ᆼ ᄒ ᅢ
쿠폰을	ᄏ ᅮ ᄑ ᅩ ᄂ ᅳ ᆯ
사용해서	ᄉ ᅡ ᄋ ᅭ ᆼ ᄒ ᅢ ᄉ ᅥ
조금	ᄌ ᅩ ᄀ ᅳ ᆷ
절약할	ᄌ ᅥ ᄅ ᅣ ᄏ ᅡ ᆯ
구석에	ᄀ ᅮ ᄉ ᅥ ᄀ ᅦ
서	ᄉ ᅥ
있지	ᄋ ᅵ ᆮ ᄍ ᅵ
서울역	ᄉ ᅥ ᄋ ᅮ ᆯ ᄅ ᅧ ᆨ
가는	ᄀ ᅡ ᄂ ᅳ ᆫ
여기	ᄋ ᅧ ᄀ ᅵ
서요	ᄉ ᅥ ᄋ ᅭ
서두르지	ᄉ ᅥ ᄃ ᅮ ᄅ ᅳ ᄌ ᅵ
떠날	ᄄ ᅥ ᄂ ᅡ ᆯ
채비를	ᄎ ᅢ ᄇ ᅵ ᄅ ᅳ ᆯ
서둘러라	ᄉ ᅥ ᄃ ᅮ ᆯ ᄅ ᅥ ᄅ ᅡ
우유랑	ᄋ ᅮ ᄋ ᅲ ᄅ ᅡ ᆼ
버터를	ᄇ ᅥ ᄐ ᅥ ᄅ ᅳ ᆯ
밀가루에	ᄆ ᅵ ᆯ ᄀ ᅡ ᄅ ᅮ ᄋ ᅦ
섞으세요	ᄉ ᅥ ᄁ ᅳ ᄉ ᅦ ᄋ ᅭ
카드	ᄏ ᅡ ᄃ ᅳ
섞어요	ᄉ ᅥ ᄁ ᅥ ᄋ ᅭ
의사에게	ᄋ ᅴ ᄉ ᅡ ᄋ ᅦ ᄀ ᅦ
증상을	ᄌ ᅳ ᆼ ᄉ ᅡ ᆼ ᄋ ᅳ ᆯ
설명했다	ᄉ ᅥ ᆯ ᄆ ᅧ ᆼ ᄒ ᅢ ᆮ ᄄ ᅡ
설명해	ᄉ ᅥ ᆯ ᄆ ᅧ ᆼ ᄒ ᅢ
사업에	ᄉ ᅡ ᄋ ᅥ ᄇ ᅦ
성공하려면	ᄉ ᅥ ᆼ ᄀ ᅩ ᆼ ᄒ ᅡ ᄅ ᅧ ᄆ ᅧ ᆫ
우선	ᄋ ᅮ ᄉ ᅥ ᆫ
돌봐야	ᄃ ᅩ ᆯ ᄇ ᅪ ᄋ ᅣ
상업적으로	ᄉ ᅡ ᆼ ᄋ ᅥ ᆸ ᄍ ᅥ ᄀ ᅳ ᄅ ᅩ
크게	ᄏ ᅳ ᄀ ᅦ
성공했다	ᄉ ᅥ ᆼ ᄀ ᅩ ᆼ ᄒ ᅢ ᆮ ᄄ ᅡ
다발을	ᄃ ᅡ ᄇ ᅡ ᄅ ᅳ ᆯ
선물했다	ᄉ ᅥ ᆫ ᄆ ᅮ ᆯ ᄒ ᅢ ᆮ ᄄ ᅡ
어머니	ᄋ ᅥ ᄆ ᅥ ᄂ ᅵ
생신에	ᄉ ᅢ ᆼ ᄉ ᅵ ᄂ ᅦ
선물할	ᄉ ᅥ ᆫ ᄆ ᅮ ᆯ ᄒ ᅡ ᆯ
직업을	ᄌ ᅵ ᄀ ᅥ ᄇ ᅳ ᆯ
선택하는	ᄉ ᅥ ᆫ ᄐ ᅢ ᄏ ᅡ ᄂ ᅳ ᆫ
중요한	ᄌ ᅮ ᆼ ᄋ ᅭ ᄒ ᅡ ᆫ
선택하시겠어요	ᄉ ᅥ ᆫ ᄐ ᅢ ᄏ ᅡ ᄉ ᅵ ᄀ ᅦ ᄊ ᅥ ᄋ ᅭ
일렬로	ᄋ ᅵ ᆯ ᄅ ᅧ ᆯ ᄅ ᅩ
세우는	ᄉ ᅦ ᄋ ᅮ ᄂ ᅳ ᆫ
언젠가	ᄋ ᅥ ᆫ ᄌ ᅦ ᆫ ᄀ ᅡ
세우고	ᄉ ᅦ ᄋ ᅮ ᄀ ᅩ
물어봐야겠는걸	ᄆ ᅮ ᄅ ᅥ ᄇ ᅪ ᄋ ᅣ ᄀ ᅦ ᆫ ᄂ ᅳ ᆫ ᄀ ᅥ ᆯ
스트레스에	ᄉ ᅳ ᄐ ᅳ ᄅ ᅦ ᄉ ᅳ ᄋ ᅦ
시달리고	ᄉ ᅵ ᄃ ᅡ ᆯ ᄅ ᅵ ᄀ ᅩ
조카들한테	ᄌ ᅩ ᄏ ᅡ ᄃ ᅳ ᆯ ᄒ ᅡ ᆫ ᄐ ᅦ
시달려서	ᄉ ᅵ ᄃ ᅡ ᆯ ᄅ ᅧ ᄉ ᅥ
몹시	ᄆ ᅩ ᆸ ᄊ ᅵ
피곤해	ᄑ ᅵ ᄀ ᅩ ᆫ ᄒ ᅢ
의사	ᄋ ᅴ ᄉ ᅡ
운동을	ᄋ ᅮ ᆫ ᄃ ᅩ ᆼ ᄋ ᅳ ᆯ
시작하라고	ᄉ ᅵ ᄌ ᅡ ᄏ ᅡ ᄅ ᅡ ᄀ ᅩ
하셨다	ᄒ ᅡ ᄉ ᅧ ᆮ ᄄ ᅡ
시작하려고	ᄉ ᅵ ᄌ ᅡ ᄏ ᅡ ᄅ ᅧ ᄀ ᅩ
곧	ᄀ ᅩ ᆮ
시작돼요	ᄉ ᅵ ᄌ ᅡ ᆨ ᄄ ᅫ ᄋ ᅭ
장마가	ᄌ ᅡ ᆼ ᄆ ᅡ ᄀ ᅡ
시작됩니까	ᄉ ᅵ ᄌ ᅡ ᆨ ᄄ ᅬ ᆷ ᄂ ᅵ ᄁ ᅡ
시키는	ᄉ ᅵ ᄏ ᅵ ᄂ ᅳ ᆫ
텐데	ᄐ ᅦ ᆫ ᄃ ᅦ
점심은	ᄌ ᅥ ᆷ ᄉ ᅵ ᄆ ᅳ ᆫ
시켜	ᄉ ᅵ ᄏ ᅧ
먹읍시다	ᄆ ᅥ ᄀ ᅳ ᆸ ᄊ ᅵ ᄃ ᅡ
식사하셨어요	ᄉ ᅵ ᆨ ᄊ ᅡ ᄒ ᅡ ᄉ ᅧ ᄊ ᅥ ᄋ ᅭ
점심	ᄌ ᅥ ᆷ ᄉ ᅵ ᆷ
식사하러	ᄉ ᅵ ᆨ ᄊ ᅡ ᄒ ᅡ ᄅ ᅥ
나가죠	ᄂ ᅡ ᄀ ᅡ ᄌ ᅭ
실례합니다	ᄉ ᅵ ᆯ ᄅ ᅨ ᄒ ᅡ ᆷ ᄂ ᅵ ᄃ ᅡ
실례합니다만	ᄉ ᅵ ᆯ ᄅ ᅨ ᄒ ᅡ ᆷ ᄂ ᅵ ᄃ ᅡ ᄆ ᅡ ᆫ
봐야	ᄇ ᅪ ᄋ ᅣ
받았지만	ᄇ ᅡ ᄃ ᅡ ᆮ ᄍ ᅵ ᄆ ᅡ ᆫ
흥행에는	ᄒ ᅳ ᆼ ᄒ ᅢ ᆼ ᄋ ᅦ ᄂ ᅳ ᆫ
실패했어	ᄉ ᅵ ᆯ ᄑ ᅢ ᄒ ᅢ ᄊ ᅥ
실패할	ᄉ ᅵ ᆯ ᄑ ᅢ ᄒ ᅡ ᆯ
몰랐어	ᄆ ᅩ ᆯ ᄅ ᅡ ᄊ ᅥ
실수할	ᄉ ᅵ ᆯ ᄉ ᅮ ᄒ ᅡ ᆯ
이메일을	ᄋ ᅵ ᄆ ᅦ ᄋ ᅵ ᄅ ᅳ ᆯ
보내다가	ᄇ ᅩ ᄂ ᅢ ᄃ ᅡ ᄀ ᅡ
실수하신	ᄉ ᅵ ᆯ ᄉ ᅮ ᄒ ᅡ ᄉ ᅵ ᆫ
옥수수를	ᄋ ᅩ ᆨ ᄊ ᅮ ᄉ ᅮ ᄅ ᅳ ᆯ
심겠다고	ᄉ ᅵ ᆷ ᄁ ᅦ ᆮ ᄄ ᅡ ᄀ ᅩ
심은	ᄉ ᅵ ᄆ ᅳ ᆫ
거둔다	ᄀ ᅥ ᄃ ᅮ ᆫ ᄃ ᅡ
스타킹	ᄉ ᅳ ᄐ ᅡ ᄏ ᅵ ᆼ
양말을	ᄋ ᅣ ᆼ ᄆ ᅡ ᄅ ᅳ ᆯ
신지	ᄉ ᅵ ᆫ ᄌ ᅵ
그래	ᄀ ᅳ ᄅ ᅢ
신는	ᄉ ᅵ ᆫ ᄂ ᅳ ᆫ
쇼핑하는	ᄉ ᅭ ᄑ ᅵ ᆼ ᄒ ᅡ ᄂ ᅳ ᆫ
싫어해요	ᄉ ᅵ ᄅ ᅥ ᄒ ᅢ ᄋ ᅭ
싫어하기	ᄉ ᅵ ᄅ ᅥ ᄒ ᅡ ᄀ ᅵ
나도	ᄂ ᅡ ᄃ ᅩ
트럭에	ᄐ ᅳ ᄅ ᅥ ᄀ ᅦ
상자를	ᄉ ᅡ ᆼ ᄌ ᅡ ᄅ ᅳ ᆯ
싣는	ᄉ ᅵ ᆫ ᄂ ᅳ ᆫ
중이라	ᄌ ᅮ ᆼ ᄋ ᅵ ᄅ ᅡ
실었어	ᄉ ᅵ ᄅ ᅥ ᄊ ᅥ
어머니를	ᄋ ᅥ ᄆ ᅥ ᄂ ᅵ ᄅ ᅳ ᆯ
소개합니다	ᄉ ᅩ ᄀ ᅢ ᄒ ᅡ ᆷ ᄂ ᅵ ᄃ ᅡ
소개하겠습니다	ᄉ ᅩ ᄀ ᅢ ᄒ ᅡ ᄀ ᅦ ᆮ ᄊ ᅳ ᆷ ᄂ ᅵ ᄃ ᅡ
동아리에도	ᄃ ᅩ ᆼ ᄋ ᅡ ᄅ ᅵ ᄋ ᅦ ᄃ ᅩ
속해	ᄉ ᅩ ᄏ ᅢ
상당한	ᄉ ᅡ ᆼ ᄃ ᅡ ᆼ ᄒ ᅡ ᆫ
미인에	ᄆ ᅵ ᄋ ᅵ ᄂ ᅦ
속한다	ᄉ ᅩ ᄏ ᅡ ᆫ ᄃ ᅡ
소리치지	ᄉ ᅩ ᄅ ᅵ ᄎ ᅵ ᄌ ᅵ
포장지에	ᄑ ᅩ ᄌ ᅡ ᆼ ᄌ ᅵ ᄋ ᅦ
싸	ᄊ ᅡ
남은	ᄂ ᅡ ᄆ ᅳ ᆫ
음식	ᄋ ᅳ ᆷ ᄉ ᅵ ᆨ
모니터	ᄆ ᅩ ᄂ ᅵ ᄐ ᅥ
먼지가	ᄆ ᅥ ᆫ ᄌ ᅵ ᄀ ᅡ
잔뜩	ᄌ ᅡ ᆫ ᄄ ᅳ ᆨ
쌓였어요	ᄊ ᅡ ᄋ ᅧ ᄊ ᅥ ᄋ ᅭ
쌓여	ᄊ ᅡ ᄋ ᅧ
최대한	ᄎ ᅬ ᄃ ᅢ ᄒ ᅡ ᆫ
통나무를	ᄐ ᅩ ᆼ ᄂ ᅡ ᄆ ᅮ ᄅ ᅳ ᆯ
쌓아라	ᄊ ᅡ ᄋ ᅡ ᄅ ᅡ
작가가	ᄌ ᅡ ᆨ ᄁ ᅡ ᄀ ᅡ
되려면	ᄃ ᅬ ᄅ ᅧ ᄆ ᅧ ᆫ
폭넓은	ᄑ ᅩ ᆼ ᄂ ᅥ ᆯ ᄇ ᅳ ᆫ
경험을	ᄀ ᅧ ᆼ ᄒ ᅥ ᄆ ᅳ ᆯ
쌓는	ᄊ ᅡ ᆫ ᄂ ᅳ ᆫ
제발	ᄌ ᅦ ᄇ ᅡ ᆯ
싸우라고	ᄊ ᅡ ᄋ ᅮ ᄅ ᅡ ᄀ ᅩ
싸웠어	ᄊ ᅡ ᄋ ᅯ ᄊ ᅥ
파를	ᄑ ᅡ ᄅ ᅳ ᆯ
썰어서	ᄊ ᅥ ᄅ ᅥ ᄉ ᅥ
접시	ᄌ ᅥ ᆸ ᄊ ᅵ
치즈	ᄎ ᅵ ᄌ ᅳ
썰어	ᄊ ᅥ ᄅ ᅥ
줄래	ᄌ ᅮ ᆯ ᄅ ᅢ
장에	ᄌ ᅡ ᆼ ᄋ ᅦ
이름	ᄋ ᅵ ᄅ ᅳ ᆷ
쓰는	ᄊ ᅳ ᄂ ᅳ ᆫ
이메일보다	ᄋ ᅵ ᄆ ᅦ ᄋ ᅵ ᆯ ᄇ ᅩ ᄃ ᅡ
외출을	ᄋ ᅬ ᄎ ᅮ ᄅ ᅳ ᆯ
모자를	ᄆ ᅩ ᄌ ᅡ ᄅ ᅳ ᆯ
씁니다	ᄊ ᅳ ᆷ ᄂ ᅵ ᄃ ᅡ
군인은	ᄀ ᅮ ᄂ ᅵ ᄂ ᅳ ᆫ
와도	ᄋ ᅪ ᄃ ᅩ
얼마	ᄋ ᅥ ᆯ ᄆ ᅡ
쓰실	ᄊ ᅳ ᄉ ᅵ ᆯ
건가	ᄀ ᅥ ᆫ ᄀ ᅡ
쓴	ᄊ ᅳ ᆫ
돈은	ᄃ ᅩ ᄂ ᅳ ᆫ
가난한	ᄀ ᅡ ᄂ ᅡ ᆫ ᄒ ᅡ ᆫ
쓰일	ᄊ ᅳ ᄋ ᅵ ᆯ
껌	ᄁ ᅥ ᆷ
조용히	ᄌ ᅩ ᄋ ᅭ ᆼ ᄒ ᅵ
씹어	ᄊ ᅵ ᄇ ᅥ
씹은	ᄊ ᅵ ᄇ ᅳ ᆫ
삼켜라	ᄉ ᅡ ᆷ ᄏ ᅧ ᄅ ᅡ
씻어라	ᄊ ᅵ ᄉ ᅥ ᄅ ᅡ
차가운	ᄎ ᅡ ᄀ ᅡ ᄋ ᅮ ᆫ
물로	ᄆ ᅮ ᆯ ᄅ ᅩ
씻으면	ᄊ ᅵ ᄉ ᅳ ᄆ ᅧ ᆫ
상쾌해질	ᄉ ᅡ ᆼ ᄏ ᅫ ᄒ ᅢ ᄌ ᅵ ᆯ
억수같이	ᄋ ᅥ ᆨ ᄊ ᅮ ᄀ ᅡ ᄎ ᅵ
쏟아지고	ᄊ ᅩ ᄃ ᅡ ᄌ ᅵ ᄀ ᅩ
원한다는	ᄋ ᅯ ᆫ ᄒ ᅡ ᆫ ᄃ ᅡ ᄂ ᅳ ᆫ
듣자	ᄃ ᅳ ᆮ ᄍ ᅡ
눈물이	ᄂ ᅮ ᆫ ᄆ ᅮ ᄅ ᅵ
쏟아졌다	ᄊ ᅩ ᄃ ᅡ ᄌ ᅥ ᆮ ᄄ ᅡ
뒤에	ᄃ ᅱ ᄋ ᅦ
숨어	ᄉ ᅮ ᄆ ᅥ
산속으로	ᄉ ᅡ ᆫ ᄉ ᅩ ᄀ ᅳ ᄅ ᅩ
쉬어야	ᄉ ᅱ ᄋ ᅥ ᄋ ᅣ
한다고	ᄒ ᅡ ᆫ ᄃ ᅡ ᄀ ᅩ
쉬는	ᄉ ᅱ ᄂ ᅳ ᆫ
날이야	ᄂ ᅡ ᄅ ᅵ ᄋ ᅣ
비행기에	ᄇ ᅵ ᄒ ᅢ ᆼ ᄀ ᅵ ᄋ ᅦ
타려고	ᄐ ᅡ ᄅ ᅧ ᄀ ᅩ
줄을	ᄌ ᅮ ᄅ ᅳ ᆯ
섰다	ᄉ ᅥ ᆮ ᄄ ᅡ
운전할	ᄋ ᅮ ᆫ ᄌ ᅥ ᆫ ᄒ ᅡ ᆯ
아는데	ᄋ ᅡ ᄂ ᅳ ᆫ ᄃ ᅦ
자전거를	ᄌ ᅡ ᄌ ᅥ ᆫ ᄀ ᅥ ᄅ ᅳ ᆯ
탈	ᄐ ᅡ ᆯ
뭔가	ᄆ ᅯ ᆫ ᄀ ᅡ
고기가	ᄀ ᅩ ᄀ ᅵ ᄀ ᅡ
타서	ᄐ ᅡ ᄉ ᅥ
없었죠	ᄋ ᅥ ᆸ ᄊ ᅥ ᆮ ᄍ ᅭ
한국에서는	ᄒ ᅡ ᆫ ᄀ ᅮ ᄀ ᅦ ᄉ ᅥ ᄂ ᅳ ᆫ
태어나면	ᄐ ᅢ ᄋ ᅥ ᄂ ᅡ ᄆ ᅧ ᆫ
곧바로	ᄀ ᅩ ᆮ ᄈ ᅡ ᄅ ᅩ
살이에요	ᄉ ᅡ ᄅ ᅵ ᄋ ᅦ ᄋ ᅭ
미국에서	ᄆ ᅵ ᄀ ᅮ ᄀ ᅦ ᄉ ᅥ
태어났지만	ᄐ ᅢ ᄋ ᅥ ᄂ ᅡ ᆮ ᄍ ᅵ ᄆ ᅡ ᆫ
한국에서	ᄒ ᅡ ᆫ ᄀ ᅮ ᄀ ᅦ ᄉ ᅥ
버스는	ᄇ ᅥ ᄉ ᅳ ᄂ ᅳ ᆫ
승객들을	ᄉ ᅳ ᆼ ᄀ ᅢ ᆨ ᄄ ᅳ ᄅ ᅳ ᆯ
태우고	ᄐ ᅢ ᄋ ᅮ ᄀ ᅩ
태워	ᄐ ᅢ ᄋ ᅯ
줘요	ᄌ ᅯ ᄋ ᅭ
산에서	ᄉ ᅡ ᄂ ᅦ ᄉ ᅥ
태우는	ᄐ ᅢ ᄋ ᅮ ᄂ ᅳ ᆫ
위험해요	ᄋ ᅱ ᄒ ᅥ ᆷ ᄒ ᅢ ᄋ ᅭ
밥을	ᄇ ᅡ ᄇ ᅳ ᆯ
태우는구나	ᄐ ᅢ ᄋ ᅮ ᄂ ᅳ ᆫ ᄀ ᅮ ᄂ ᅡ
여기저기서	ᄋ ᅧ ᄀ ᅵ ᄌ ᅥ ᄀ ᅵ ᄉ ᅥ
폭탄이	ᄑ ᅩ ᆨ ᄐ ᅡ ᄂ ᅵ
터졌다	ᄐ ᅥ ᄌ ᅥ ᆮ ᄄ ᅡ
전쟁이	ᄌ ᅥ ᆫ ᄌ ᅢ ᆼ ᄋ ᅵ
터질	ᄐ ᅥ ᄌ ᅵ ᆯ
때를	ᄄ ᅢ ᄅ ᅳ ᆯ
대비해서	ᄃ ᅢ ᄇ ᅵ ᄒ ᅢ ᄉ ᅥ
사재기하고	ᄉ ᅡ ᄌ ᅢ ᄀ ᅵ ᄒ ᅡ ᄀ ᅩ
핸들을	ᄒ ᅢ ᆫ ᄃ ᅳ ᄅ ᅳ ᆯ
틀려고	ᄐ ᅳ ᆯ ᄅ ᅧ ᄀ ᅩ
했지만	ᄒ ᅢ ᆮ ᄍ ᅵ ᄆ ᅡ ᆫ
늦었다	ᄂ ᅳ ᄉ ᅥ ᆮ ᄄ ᅡ
선풍기	ᄉ ᅥ ᆫ ᄑ ᅮ ᆼ ᄀ ᅵ
틀어도	ᄐ ᅳ ᄅ ᅥ ᄃ ᅩ
괜찮으시겠어요	ᄀ ᅫ ᆫ ᄎ ᅡ ᄂ ᅳ ᄉ ᅵ ᄀ ᅦ ᄊ ᅥ ᄋ ᅭ
생각엔	ᄉ ᅢ ᆼ ᄀ ᅡ ᄀ ᅦ ᆫ
답이	ᄃ ᅡ ᄇ ᅵ
틀렸어	ᄐ ᅳ ᆯ ᄅ ᅧ ᄊ ᅥ
나무는	ᄂ ᅡ ᄆ ᅮ ᄂ ᅳ ᆫ
전기가	ᄌ ᅥ ᆫ ᄀ ᅵ ᄀ ᅡ
통해요	ᄐ ᅩ ᆼ ᄒ ᅢ ᄋ ᅭ
시행착오를	ᄉ ᅵ ᄒ ᅢ ᆼ ᄎ ᅡ ᄀ ᅩ ᄅ ᅳ ᆯ
통해	ᄐ ᅩ ᆼ ᄒ ᅢ
배우는	ᄇ ᅢ ᄋ ᅮ ᄂ ᅳ ᆫ
나쁘지	ᄂ ᅡ ᄈ ᅳ ᄌ ᅵ
부분은	ᄇ ᅮ ᄇ ᅮ ᄂ ᅳ ᆫ
뜻이	ᄄ ᅳ ᄉ ᅵ
통하는	ᄐ ᅩ ᆼ ᄒ ᅡ ᄂ ᅳ ᆫ
포도를	ᄑ ᅩ ᄃ ᅩ ᄅ ᅳ ᆯ
따고	ᄄ ᅡ ᄀ ᅩ
캔	ᄏ ᅢ ᆫ
따	ᄄ ᅡ
때렸다는	ᄄ ᅢ ᄅ ᅧ ᆮ ᄄ ᅡ ᄂ ᅳ ᆫ
이유로	ᄋ ᅵ ᄋ ᅲ ᄅ ᅩ
고소를	ᄀ ᅩ ᄉ ᅩ ᄅ ᅳ ᆯ
회초리로	ᄒ ᅬ ᄎ ᅩ ᄅ ᅵ ᄅ ᅩ
손바닥을	ᄉ ᅩ ᆫ ᄇ ᅡ ᄃ ᅡ ᄀ ᅳ ᆯ
때리셨어	ᄄ ᅢ ᄅ ᅵ ᄉ ᅧ ᄊ ᅥ
따라가세요	ᄄ ᅡ ᄅ ᅡ ᄀ ᅡ ᄉ ᅦ ᄋ ᅭ
토론에서는	ᄐ ᅩ ᄅ ᅩ ᄂ ᅦ ᄉ ᅥ ᄂ ᅳ ᆫ
따라갈	ᄄ ᅡ ᄅ ᅡ ᄀ ᅡ ᆯ
따라오십시오	ᄄ ᅡ ᄅ ᅡ ᄋ ᅩ ᄉ ᅵ ᆸ ᄊ ᅵ ᄋ ᅩ
수학이라면	ᄉ ᅮ ᄒ ᅡ ᄀ ᅵ ᄅ ᅡ ᄆ ᅧ ᆫ
따라올	ᄄ ᅡ ᄅ ᅡ ᄋ ᅩ ᆯ
총에서	ᄎ ᅩ ᆼ ᄋ ᅦ ᄉ ᅥ
떼라	ᄄ ᅦ ᄅ ᅡ
아름다운	ᄋ ᅡ ᄅ ᅳ ᆷ ᄃ ᅡ ᄋ ᅮ ᆫ
여인에게서	ᄋ ᅧ ᄋ ᅵ ᄂ ᅦ ᄀ ᅦ ᄉ ᅥ
뗄	ᄄ ᅦ ᆯ
떨고	ᄄ ᅥ ᆯ ᄀ ᅩ
다리	ᄃ ᅡ ᄅ ᅵ
떨지	ᄄ ᅥ ᆯ ᄌ ᅵ
놀라서	ᄂ ᅩ ᆯ ᄅ ᅡ ᄉ ᅥ
목소리가	ᄆ ᅩ ᆨ ᄊ ᅩ ᄅ ᅵ ᄀ ᅡ
떨리기	ᄄ ᅥ ᆯ ᄅ ᅵ ᄀ ᅵ
보기	ᄇ ᅩ ᄀ ᅵ
전이면	ᄌ ᅥ ᄂ ᅵ ᄆ ᅧ ᆫ
떨려	ᄄ ᅥ ᆯ ᄅ ᅧ
떠난	ᄄ ᅥ ᄂ ᅡ ᆫ
추억을	ᄎ ᅮ ᄋ ᅥ ᄀ ᅳ ᆯ
한국을	ᄒ ᅡ ᆫ ᄀ ᅮ ᄀ ᅳ ᆯ
떠나셨으면	ᄄ ᅥ ᄂ ᅡ ᄉ ᅧ ᄊ ᅳ ᄆ ᅧ ᆫ
좋겠네요	ᄌ ᅩ ᄏ ᅦ ᆫ ᄂ ᅦ ᄋ ᅭ
해외여행을	ᄒ ᅢ ᄋ ᅬ ᄋ ᅧ ᄒ ᅢ ᆼ ᄋ ᅳ ᆯ
떠나려면	ᄄ ᅥ ᄂ ᅡ ᄅ ᅧ ᄆ ᅧ ᆫ
준비할	ᄌ ᅮ ᆫ ᄇ ᅵ ᄒ ᅡ ᆯ
행복했던	ᄒ ᅢ ᆼ ᄇ ᅩ ᄏ ᅢ ᆮ ᄄ ᅥ ᆫ
시절을	ᄉ ᅵ ᄌ ᅥ ᄅ ᅳ ᆯ
떠올리면	ᄄ ᅥ ᄋ ᅩ ᆯ ᄅ ᅵ ᄆ ᅧ ᆫ
미소가	ᄆ ᅵ ᄉ ᅩ ᄀ ᅡ
지어진다	ᄌ ᅵ ᄋ ᅥ ᄌ ᅵ ᆫ ᄃ ᅡ
때마다	ᄄ ᅢ ᄆ ᅡ ᄃ ᅡ
떠올리게	ᄄ ᅥ ᄋ ᅩ ᆯ ᄅ ᅵ ᄀ ᅦ
해는	ᄒ ᅢ ᄂ ᅳ ᆫ
동쪽에서	ᄃ ᅩ ᆼ ᄍ ᅩ ᄀ ᅦ ᄉ ᅥ
떠오른다	ᄄ ᅥ ᄋ ᅩ ᄅ ᅳ ᆫ ᄃ ᅡ
떠올랐다	ᄄ ᅥ ᄋ ᅩ ᆯ ᄅ ᅡ ᆮ ᄄ ᅡ
말에서	ᄆ ᅡ ᄅ ᅦ ᄉ ᅥ
떨어져서	ᄄ ᅥ ᄅ ᅥ ᄌ ᅥ ᄉ ᅥ
왼팔이	ᄋ ᅬ ᆫ ᄑ ᅡ ᄅ ᅵ
부러졌어요	ᄇ ᅮ ᄅ ᅥ ᄌ ᅥ ᄊ ᅥ ᄋ ᅭ
딸아이가	ᄄ ᅡ ᄅ ᅡ ᄋ ᅵ ᄀ ᅡ
입학시험에	ᄋ ᅵ ᄑ ᅡ ᆨ ᄊ ᅵ ᄒ ᅥ ᄆ ᅦ
떨어졌어요	ᄄ ᅥ ᄅ ᅥ ᄌ ᅥ ᄊ ᅥ ᄋ ᅭ
연료가	ᄋ ᅧ ᆯ ᄅ ᅭ ᄀ ᅡ
떨어져	ᄄ ᅥ ᄅ ᅥ ᄌ ᅥ
무언가가	ᄆ ᅮ ᄋ ᅥ ᆫ ᄀ ᅡ ᄀ ᅡ
표면에	ᄑ ᅭ ᄆ ᅧ ᄂ ᅦ
떠	ᄄ ᅥ
태양은	ᄐ ᅢ ᄋ ᅣ ᆼ ᄋ ᅳ ᆫ
떠서	ᄄ ᅥ ᄉ ᅥ
서쪽으로	ᄉ ᅥ ᄍ ᅩ ᄀ ᅳ ᄅ ᅩ
진다	ᄌ ᅵ ᆫ ᄃ ᅡ
뜨고	ᄄ ᅳ ᄀ ᅩ
떴어요	ᄄ ᅥ ᄊ ᅥ ᄋ ᅭ
아줌마는	ᄋ ᅡ ᄌ ᅮ ᆷ ᄆ ᅡ ᄂ ᅳ ᆫ
뜻한다	ᄄ ᅳ ᄐ ᅡ ᆫ ᄃ ᅡ
문장은	ᄆ ᅮ ᆫ ᄌ ᅡ ᆼ ᄋ ᅳ ᆫ
무엇을	ᄆ ᅮ ᄋ ᅥ ᄉ ᅳ ᆯ
뜻합니까	ᄄ ᅳ ᄐ ᅡ ᆷ ᄂ ᅵ ᄁ ᅡ
뛰어	ᄄ ᅱ ᄋ ᅥ
출구를	ᄎ ᅮ ᆯ ᄀ ᅮ ᄅ ᅳ ᆯ
뛰기	ᄄ ᅱ ᄀ ᅵ
육상	ᄋ ᅲ ᆨ ᄊ ᅡ ᆼ
선수였기	ᄉ ᅥ ᆫ ᄉ ᅮ ᄋ ᅧ ᆮ ᄁ ᅵ
높이	ᄂ ᅩ ᄑ ᅵ
뛸	ᄄ ᅱ ᆯ
우정을	ᄋ ᅮ ᄌ ᅥ ᆼ ᄋ ᅳ ᆯ
진화심리학의	ᄌ ᅵ ᆫ ᄒ ᅪ ᄉ ᅵ ᆷ ᄂ ᅵ ᄒ ᅡ ᄀ ᅴ
관점에서	ᄀ ᅪ ᆫ ᄌ ᅥ ᄆ ᅦ ᄉ ᅥ
분석하려는	ᄇ ᅮ ᆫ ᄉ ᅥ ᄏ ᅡ ᄅ ᅧ ᄂ ᅳ ᆫ
시도가	ᄉ ᅵ ᄃ ᅩ ᄀ ᅡ
있었습니다	ᄋ ᅵ ᄊ ᅥ ᆮ ᄊ ᅳ ᆷ ᄂ ᅵ ᄃ ᅡ
가까운	ᄀ ᅡ ᄁ ᅡ ᄋ ᅮ ᆫ
버스	ᄇ ᅥ ᄉ ᅳ
정류장이	ᄌ ᅥ ᆼ ᄂ ᅲ ᄌ ᅡ ᆼ ᄋ ᅵ
소설	ᄉ ᅩ ᄉ ᅥ ᆯ
백경의	ᄇ ᅢ ᆨ ᄁ ᅧ ᆼ ᄋ ᅴ
주인공으로	ᄌ ᅮ ᄋ ᅵ ᆫ ᄀ ᅩ ᆼ ᄋ ᅳ ᄅ ᅩ
나왔던	ᄂ ᅡ ᄋ ᅪ ᆮ ᄄ ᅥ ᆫ
향유고래의	ᄒ ᅣ ᆼ ᄋ ᅲ ᄀ ᅩ ᄅ ᅢ ᄋ ᅴ
몸무게는	ᄆ ᅩ ᆷ ᄆ ᅮ ᄀ ᅦ ᄂ ᅳ ᆫ
톤에	ᄐ ᅩ ᄂ ᅦ
달합니다	ᄃ ᅡ ᆯ ᄒ ᅡ ᆷ ᄂ ᅵ ᄃ ᅡ
지구	ᄌ ᅵ ᄀ ᅮ
온난화로	ᄋ ᅩ ᆫ ᄂ ᅡ ᆫ ᄒ ᅪ ᄅ ᅩ
인해	ᄋ ᅵ ᆫ ᄒ ᅢ
나타나는	ᄂ ᅡ ᄐ ᅡ ᄂ ᅡ ᄂ ᅳ ᆫ
현상들을	ᄒ ᅧ ᆫ ᄉ ᅡ ᆼ ᄃ ᅳ ᄅ ᅳ ᆯ
정리해	ᄌ ᅥ ᆼ ᄂ ᅵ ᄒ ᅢ
자외선에	ᄌ ᅡ ᄋ ᅬ ᄉ ᅥ ᄂ ᅦ
노출된	ᄂ ᅩ ᄎ ᅮ ᆯ ᄃ ᅬ ᆫ
모발은	ᄆ ᅩ ᄇ ᅡ ᄅ ᅳ ᆫ
단백질이	ᄃ ᅡ ᆫ ᄇ ᅢ ᆨ ᄍ ᅵ ᄅ ᅵ
파괴되고	ᄑ ᅡ ᄀ ᅬ ᄃ ᅬ ᄀ ᅩ
윤기와	ᄋ ᅲ ᆫ ᄀ ᅵ ᄋ ᅪ
탄력을	ᄐ ᅡ ᆯ ᄅ ᅧ ᄀ ᅳ ᆯ
잃어요	ᄋ ᅵ ᄅ ᅥ ᄋ ᅭ
바다의	ᄇ ᅡ ᄃ ᅡ ᄋ ᅴ
포식자로	ᄑ ᅩ ᄉ ᅵ ᆨ ᄍ ᅡ ᄅ ᅩ
불리는	ᄇ ᅮ ᆯ ᄅ ᅵ ᄂ ᅳ ᆫ
백상아리	ᄇ ᅢ ᆨ ᄊ ᅡ ᆼ ᄋ ᅡ ᄅ ᅵ
발견되었어요	ᄇ ᅡ ᆯ ᄀ ᅧ ᆫ ᄃ ᅬ ᄋ ᅥ ᄊ ᅥ ᄋ ᅭ
투표는	ᄐ ᅮ ᄑ ᅭ ᄂ ᅳ ᆫ
국민의	ᄀ ᅮ ᆼ ᄆ ᅵ ᄂ ᅴ
권리입니다	ᄀ ᅯ ᆯ ᄅ ᅵ ᄋ ᅵ ᆷ ᄂ ᅵ ᄃ ᅡ
소방차의	ᄉ ᅩ ᄇ ᅡ ᆼ ᄎ ᅡ ᄋ ᅴ
출동을	ᄎ ᅮ ᆯ ᄃ ᅩ ᆼ ᄋ ᅳ ᆯ
방해할	ᄇ ᅡ ᆼ ᄒ ᅢ ᄒ ᅡ ᆯ
경우	ᄀ ᅧ ᆼ ᄋ ᅮ
최대	ᄎ ᅬ ᄃ ᅢ
이백만	ᄋ ᅵ ᄇ ᅢ ᆼ ᄆ ᅡ ᆫ
원의	ᄋ ᅯ ᄂ ᅴ
과태료가	ᄀ ᅪ ᄐ ᅢ ᄅ ᅭ ᄀ ᅡ
부과된	ᄇ ᅮ ᄀ ᅪ ᄃ ᅬ ᆫ
대	ᄃ ᅢ
언제부터	ᄋ ᅥ ᆫ ᄌ ᅦ ᄇ ᅮ ᄐ ᅥ
소방차는	ᄉ ᅩ ᄇ ᅡ ᆼ ᄎ ᅡ ᄂ ᅳ ᆫ
빨간색이	ᄈ ᅡ ᆯ ᄀ ᅡ ᆫ ᄉ ᅢ ᄀ ᅵ
되었을까	ᄃ ᅬ ᄋ ᅥ ᄊ ᅳ ᆯ ᄁ ᅡ
지나가는	ᄌ ᅵ ᄂ ᅡ ᄀ ᅡ ᄂ ᅳ ᆫ
소방차에	ᄉ ᅩ ᄇ ᅡ ᆼ ᄎ ᅡ ᄋ ᅦ
열어주세요	ᄋ ᅧ ᄅ ᅥ ᄌ ᅮ ᄉ ᅦ ᄋ ᅭ
오신	ᄋ ᅩ ᄉ ᅵ ᆫ
순서대로	ᄉ ᅮ ᆫ ᄉ ᅥ ᄃ ᅢ ᄅ ᅩ
처리해	ᄎ ᅥ ᄅ ᅵ ᄒ ᅢ
신용카드를	ᄉ ᅵ ᄂ ᅭ ᆼ ᄏ ᅡ ᄃ ᅳ ᄅ ᅳ ᆯ
지참하시고	ᄌ ᅵ ᄎ ᅡ ᆷ ᄒ ᅡ ᄉ ᅵ ᄀ ᅩ
고객센터에서	ᄀ ᅩ ᄀ ᅢ ᆨ ᄊ ᅦ ᆫ ᄐ ᅥ ᄋ ᅦ ᄉ ᅥ
영수증	ᄋ ᅧ ᆼ ᄉ ᅮ ᄌ ᅳ ᆼ
재발급을	ᄌ ᅢ ᄇ ᅡ ᆯ ᄀ ᅳ ᄇ ᅳ ᆯ
받으면	ᄇ ᅡ ᄃ ᅳ ᄆ ᅧ ᆫ
해변가에	ᄒ ᅢ ᄇ ᅧ ᆫ ᄀ ᅡ ᄋ ᅦ
상어가	ᄉ ᅡ ᆼ ᄋ ᅥ ᄀ ᅡ
출몰해	ᄎ ᅮ ᆯ ᄆ ᅩ ᆯ ᄒ ᅢ
피서객들의	ᄑ ᅵ ᄉ ᅥ ᄀ ᅢ ᆨ ᄄ ᅳ ᄅ ᅴ
주의가	ᄌ ᅮ ᄋ ᅴ ᄀ ᅡ
필요합니다	ᄑ ᅵ ᄅ ᅭ ᄒ ᅡ ᆷ ᄂ ᅵ ᄃ ᅡ
방울토마토는	ᄇ ᅡ ᆼ ᄋ ᅮ ᆯ ᄐ ᅩ ᄆ ᅡ ᄐ ᅩ ᄂ ᅳ ᆫ
꼭지가	ᄁ ᅩ ᆨ ᄍ ᅵ ᄀ ᅡ
싱싱한	ᄉ ᅵ ᆼ ᄉ ᅵ ᆼ ᄒ ᅡ ᆫ
상품이야	ᄉ ᅡ ᆼ ᄑ ᅮ ᄆ ᅵ ᄋ ᅣ
아침은	ᄋ ᅡ ᄎ ᅵ ᄆ ᅳ ᆫ
쌀밥	ᄊ ᅡ ᆯ ᄇ ᅡ ᆸ
귀리나	ᄀ ᅱ ᄅ ᅵ ᄂ ᅡ
오트밀	ᄋ ᅩ ᄐ ᅳ ᄆ ᅵ ᆯ
황제처럼	ᄒ ᅪ ᆼ ᄌ ᅦ ᄎ ᅥ ᄅ ᅥ ᆷ
저녁은	ᄌ ᅥ ᄂ ᅧ ᄀ ᅳ ᆫ
든든하게	ᄃ ᅳ ᆫ ᄃ ᅳ ᆫ ᄒ ᅡ ᄀ ᅦ
특선	ᄐ ᅳ ᆨ ᄊ ᅥ ᆫ
메뉴는	ᄆ ᅦ ᄂ ᅲ ᄂ ᅳ ᆫ
갈비탕	ᄀ ᅡ ᆯ ᄇ ᅵ ᄐ ᅡ ᆼ
이래	ᄋ ᅵ ᄅ ᅢ
일회용	ᄋ ᅵ ᆯ ᄒ ᅬ ᄋ ᅭ ᆼ
비닐봉지도	ᄇ ᅵ ᄂ ᅵ ᆯ ᄇ ᅩ ᆼ ᄌ ᅵ ᄃ ᅩ
이제는	ᄋ ᅵ ᄌ ᅦ ᄂ ᅳ ᆫ
주고	ᄌ ᅮ ᄀ ᅩ
사야	ᄉ ᅡ ᄋ ᅣ
회원님	ᄒ ᅬ ᄋ ᅯ ᆫ ᄂ ᅵ ᆷ
예매가	ᄋ ᅨ ᄆ ᅢ ᄀ ᅡ
완료되었습니다	ᄋ ᅪ ᆯ ᄅ ᅭ ᄃ ᅬ ᄋ ᅥ ᆮ ᄊ ᅳ ᆷ ᄂ ᅵ ᄃ ᅡ
기프티카드로	ᄀ ᅵ ᄑ ᅳ ᄐ ᅵ ᄏ ᅡ ᄃ ᅳ ᄅ ᅩ
소중한	ᄉ ᅩ ᄌ ᅮ ᆼ ᄒ ᅡ ᆫ
전하세요	ᄌ ᅥ ᆫ ᄒ ᅡ ᄉ ᅦ ᄋ ᅭ
콜드	ᄏ ᅩ ᆯ ᄃ ᅳ
부루는	ᄇ ᅮ ᄅ ᅮ ᄂ ᅳ ᆫ
원두를	ᄋ ᅯ ᆫ ᄃ ᅮ ᄅ ᅳ ᆯ
오랜	ᄋ ᅩ ᄅ ᅢ ᆫ
들여	ᄃ ᅳ ᄅ ᅧ
우려내는	ᄋ ᅮ ᄅ ᅧ ᄂ ᅢ ᄂ ᅳ ᆫ
방식을	ᄇ ᅡ ᆼ ᄉ ᅵ ᄀ ᅳ ᆯ
무분별한	ᄆ ᅮ ᄇ ᅮ ᆫ ᄇ ᅧ ᆯ ᄒ ᅡ ᆫ
종이컵	ᄌ ᅩ ᆼ ᄋ ᅵ ᄏ ᅥ ᆸ
자제하고	ᄌ ᅡ ᄌ ᅦ ᄒ ᅡ ᄀ ᅩ
텀블러	ᄐ ᅥ ᆷ ᄇ ᅳ ᆯ ᄅ ᅥ
생활화합시다	ᄉ ᅢ ᆼ ᄒ ᅪ ᆯ ᄒ ᅪ ᄒ ᅡ ᆸ ᄊ ᅵ ᄃ ᅡ
미세먼지	ᄆ ᅵ ᄉ ᅦ ᄆ ᅥ ᆫ ᄌ ᅵ
제거에	ᄌ ᅦ ᄀ ᅥ ᄋ ᅦ
효과적인	ᄒ ᅭ ᄀ ᅪ ᄌ ᅥ ᄀ ᅵ ᆫ
공기청정기를	ᄀ ᅩ ᆼ ᄀ ᅵ ᄎ ᅥ ᆼ ᄌ ᅥ ᆼ ᄀ ᅵ ᄅ ᅳ ᆯ
추천해	ᄎ ᅮ ᄎ ᅥ ᆫ ᄒ ᅢ
여덟	ᄋ ᅧ ᄃ ᅥ ᆯ
시간의	ᄉ ᅵ ᄀ ᅡ ᄂ ᅴ
수면이	ᄉ ᅮ ᄆ ᅧ ᄂ ᅵ
건강에	ᄀ ᅥ ᆫ ᄀ ᅡ ᆼ ᄋ ᅦ
좋다는	ᄌ ᅩ ᄐ ᅡ ᄂ ᅳ ᆫ
연구	ᄋ ᅧ ᆫ ᄀ ᅮ
결과가	ᄀ ᅧ ᆯ ᄀ ᅪ ᄀ ᅡ
나왔어	ᄂ ᅡ ᄋ ᅪ ᄊ ᅥ
점심을	ᄌ ᅥ ᆷ ᄉ ᅵ ᄆ ᅳ ᆯ
살지	ᄉ ᅡ ᆯ ᄌ ᅵ
사다리	ᄉ ᅡ ᄃ ᅡ ᄅ ᅵ
타기로	ᄐ ᅡ ᄀ ᅵ ᄅ ᅩ
에너지	ᄋ ᅦ ᄂ ᅥ ᄌ ᅵ
절약과	ᄌ ᅥ ᄅ ᅣ ᆨ ᄁ ᅪ
건강을	ᄀ ᅥ ᆫ ᄀ ᅡ ᆼ ᄋ ᅳ ᆯ
저층은	ᄌ ᅥ ᄎ ᅳ ᆼ ᄋ ᅳ ᆫ
이용합시다	ᄋ ᅵ ᄋ ᅭ ᆼ ᄒ ᅡ ᆸ ᄊ ᅵ ᄃ ᅡ
정부가	ᄌ ᅥ ᆼ ᄇ ᅮ ᄀ ᅡ
권장하는	ᄀ ᅯ ᆫ ᄌ ᅡ ᆼ ᄒ ᅡ ᄂ ᅳ ᆫ
여름철	ᄋ ᅧ ᄅ ᅳ ᆷ ᄎ ᅥ ᆯ
실내	ᄉ ᅵ ᆯ ᄅ ᅢ
적정	ᄌ ᅥ ᆨ ᄍ ᅥ ᆼ
온도는	ᄋ ᅩ ᆫ ᄃ ᅩ ᄂ ᅳ ᆫ
이십육에서	ᄋ ᅵ ᄉ ᅵ ᄇ ᅲ ᄀ ᅦ ᄉ ᅥ
이십팔	ᄋ ᅵ ᄉ ᅵ ᆸ ᄑ ᅡ ᆯ
도입니다	ᄃ ᅩ ᄋ ᅵ ᆷ ᄂ ᅵ ᄃ ᅡ
반소매	ᄇ ᅡ ᆫ ᄉ ᅩ ᄆ ᅢ
와이셔츠에	ᄋ ᅪ ᄋ ᅵ ᄉ ᅧ ᄎ ᅳ ᄋ ᅦ
체감온도를	ᄎ ᅦ ᄀ ᅡ ᄆ ᅩ ᆫ ᄃ ᅩ ᄅ ᅳ ᆯ
이도	ᄋ ᅵ ᄃ ᅩ
낮출	ᄂ ᅡ ᆮ ᄎ ᅮ ᆯ
드신	ᄃ ᅳ ᄉ ᅵ ᆫ
식판의	ᄉ ᅵ ᆨ ᄑ ᅡ ᄂ ᅴ
찌꺼기는	ᄍ ᅵ ᄁ ᅥ ᄀ ᅵ ᄂ ᅳ ᆫ
쓰레기통에	ᄊ ᅳ ᄅ ᅦ ᄀ ᅵ ᄐ ᅩ ᆼ ᄋ ᅦ
버려주세요	ᄇ ᅥ ᄅ ᅧ ᄌ ᅮ ᄉ ᅦ ᄋ ᅭ
회식에	ᄒ ᅬ ᄉ ᅵ ᄀ ᅦ
참석이	ᄎ ᅡ ᆷ ᄉ ᅥ ᄀ ᅵ
어려우신	ᄋ ᅥ ᄅ ᅧ ᄋ ᅮ ᄉ ᅵ ᆫ
분들은	ᄇ ᅮ ᆫ ᄃ ᅳ ᄅ ᅳ ᆫ
미리	ᄆ ᅵ ᄅ ᅵ
칸에서	ᄏ ᅡ ᄂ ᅦ ᄉ ᅥ
수상한	ᄉ ᅮ ᄉ ᅡ ᆼ ᄒ ᅡ ᆫ
영화인	ᄋ ᅧ ᆼ ᄒ ᅪ ᄋ ᅵ ᆫ
만큼	ᄆ ᅡ ᆫ ᄏ ᅳ ᆷ
작품성은	ᄌ ᅡ ᆨ ᄑ ᅮ ᆷ ᄉ ᅥ ᆼ ᄋ ᅳ ᆫ
보장하지	ᄇ ᅩ ᄌ ᅡ ᆼ ᄒ ᅡ ᄌ ᅵ
음식은	ᄋ ᅳ ᆷ ᄉ ᅵ ᄀ ᅳ ᆫ
맛도	ᄆ ᅡ ᆮ ᄄ ᅩ
중요하지만	ᄌ ᅮ ᆼ ᄋ ᅭ ᄒ ᅡ ᄌ ᅵ ᄆ ᅡ ᆫ
스타일링도	ᄉ ᅳ ᄐ ᅡ ᄋ ᅵ ᆯ ᄅ ᅵ ᆼ ᄃ ᅩ
중요하다고	ᄌ ᅮ ᆼ ᄋ ᅭ ᄒ ᅡ ᄃ ᅡ ᄀ ᅩ
원만한	ᄋ ᅯ ᆫ ᄆ ᅡ ᆫ ᄒ ᅡ ᆫ
인간관계를	ᄋ ᅵ ᆫ ᄀ ᅡ ᆫ ᄀ ᅪ ᆫ ᄀ ᅨ ᄅ ᅳ ᆯ
위해서는	ᄋ ᅱ ᄒ ᅢ ᄉ ᅥ ᄂ ᅳ ᆫ
하얀	ᄒ ᅡ ᄋ ᅣ ᆫ
거짓말도	ᄀ ᅥ ᄌ ᅵ ᆫ ᄆ ᅡ ᆯ ᄃ ᅩ
필요하다고	ᄑ ᅵ ᄅ ᅭ ᄒ ᅡ ᄃ ᅡ ᄀ ᅩ
하려면	ᄒ ᅡ ᄅ ᅧ ᄆ ᅧ ᆫ
기초대사량을	ᄀ ᅵ ᄎ ᅩ ᄃ ᅢ ᄉ ᅡ ᄅ ᅣ ᆼ ᄋ ᅳ ᆯ
높이는	ᄂ ᅩ ᄑ ᅵ ᄂ ᅳ ᆫ
중요해	ᄌ ᅮ ᆼ ᄋ ᅭ ᄒ ᅢ
점심때	ᄌ ᅥ ᆷ ᄉ ᅵ ᆷ ᄄ ᅢ
상추를	ᄉ ᅡ ᆼ ᄎ ᅮ ᄅ ᅳ ᆯ
먹어서	ᄆ ᅥ ᄀ ᅥ ᄉ ᅥ
졸린	ᄌ ᅩ ᆯ ᄅ ᅵ ᆫ
만성	ᄆ ᅡ ᆫ ᄉ ᅥ ᆼ
피로가	ᄑ ᅵ ᄅ ᅩ ᄀ ᅡ
문제야	ᄆ ᅮ ᆫ ᄌ ᅦ ᄋ ᅣ
마시면	ᄆ ᅡ ᄉ ᅵ ᄆ ᅧ ᆫ
이뇨작용이	ᄋ ᅵ ᄂ ᅭ ᄌ ᅡ ᄀ ᅭ ᆼ ᄋ ᅵ
심해져서	ᄉ ᅵ ᆷ ᄒ ᅢ ᄌ ᅥ ᄉ ᅥ
마셔줘야	ᄆ ᅡ ᄉ ᅧ ᄌ ᅯ ᄋ ᅣ
동안의	ᄃ ᅩ ᆼ ᄋ ᅡ ᄂ ᅴ
비결은	ᄇ ᅵ ᄀ ᅧ ᄅ ᅳ ᆫ
육식보다는	ᄋ ᅲ ᆨ ᄊ ᅵ ᆨ ᄈ ᅩ ᄃ ᅡ ᄂ ᅳ ᆫ
채식을	ᄎ ᅢ ᄉ ᅵ ᄀ ᅳ ᆯ
선호한다는	ᄉ ᅥ ᆫ ᄒ ᅩ ᄒ ᅡ ᆫ ᄃ ᅡ ᄂ ᅳ ᆫ
건강	ᄀ ᅥ ᆫ ᄀ ᅡ ᆼ
검진	ᄀ ᅥ ᆷ ᄌ ᅵ ᆫ
예약이	ᄋ ᅨ ᄋ ᅣ ᄀ ᅵ
금식이야	ᄀ ᅳ ᆷ ᄉ ᅵ ᄀ ᅵ ᄋ ᅣ
결혼기념일	ᄀ ᅧ ᆯ ᄒ ᅩ ᆫ ᄀ ᅵ ᄂ ᅧ ᄆ ᅵ ᆯ
좋을까	ᄌ ᅩ ᄋ ᅳ ᆯ ᄁ ᅡ
피자는	ᄑ ᅵ ᄌ ᅡ ᄂ ᅳ ᆫ
손으로	ᄉ ᅩ ᄂ ᅳ ᄅ ᅩ
들고	ᄃ ᅳ ᆯ ᄀ ᅩ
먹어야	ᄆ ᅥ ᄀ ᅥ ᄋ ᅣ
비상구의	ᄇ ᅵ ᄉ ᅡ ᆼ ᄀ ᅮ ᄋ ᅴ
잠그거나	ᄌ ᅡ ᆷ ᄀ ᅳ ᄀ ᅥ ᄂ ᅡ
쌓아두는	ᄊ ᅡ ᄋ ᅡ ᄃ ᅮ ᄂ ᅳ ᆫ
불법이야	ᄇ ᅮ ᆯ ᄇ ᅥ ᄇ ᅵ ᄋ ᅣ
좋다고	ᄌ ᅩ ᄐ ᅡ ᄀ ᅩ
착각하는	ᄎ ᅡ ᆨ ᄁ ᅡ ᄏ ᅡ ᄂ ᅳ ᆫ
음식들이	ᄋ ᅳ ᆷ ᄉ ᅵ ᆨ ᄄ ᅳ ᄅ ᅵ
많다고	ᄆ ᅡ ᆫ ᄐ ᅡ ᄀ ᅩ
온라인에서	ᄋ ᅩ ᆯ ᄅ ᅡ ᄋ ᅵ ᄂ ᅦ ᄉ ᅥ
졸업	ᄌ ᅩ ᄅ ᅥ ᆸ
증명서와	ᄌ ᅳ ᆼ ᄆ ᅧ ᆼ ᄉ ᅥ ᄋ ᅪ
성적	ᄉ ᅥ ᆼ ᄌ ᅥ ᆨ
증명서	ᄌ ᅳ ᆼ ᄆ ᅧ ᆼ ᄉ ᅥ
발급하는	ᄇ ᅡ ᆯ ᄀ ᅳ ᄑ ᅡ ᄂ ᅳ ᆫ
방법을	ᄇ ᅡ ᆼ ᄇ ᅥ ᄇ ᅳ ᆯ
알려주세요	ᄋ ᅡ ᆯ ᄅ ᅧ ᄌ ᅮ ᄉ ᅦ ᄋ ᅭ
추가	ᄎ ᅮ ᄀ ᅡ
주문하시겠습니까	ᄌ ᅮ ᄆ ᅮ ᆫ ᄒ ᅡ ᄉ ᅵ ᄀ ᅦ ᆮ ᄊ ᅳ ᆷ ᄂ ᅵ ᄁ ᅡ
레몬의	ᄅ ᅦ ᄆ ᅩ ᄂ ᅴ
상큼함이	ᄉ ᅡ ᆼ ᄏ ᅳ ᆷ ᄒ ᅡ ᄆ ᅵ
입	ᄋ ᅵ ᆸ
퍼져요	ᄑ ᅥ ᄌ ᅥ ᄋ ᅭ
제주도에	ᄌ ᅦ ᄌ ᅮ ᄃ ᅩ ᄋ ᅦ
맹독을	ᄆ ᅢ ᆼ ᄃ ᅩ ᄀ ᅳ ᆯ
지닌	ᄌ ᅵ ᄂ ᅵ ᆫ
파란	ᄑ ᅡ ᄅ ᅡ ᆫ
고리문어가	ᄀ ᅩ ᄅ ᅵ ᄆ ᅮ ᄂ ᅥ ᄀ ᅡ
오랫동안	ᄋ ᅩ ᄅ ᅢ ᆮ ᄄ ᅩ ᆼ ᄋ ᅡ ᆫ
짝사랑해왔던	ᄍ ᅡ ᆨ ᄊ ᅡ ᄅ ᅡ ᆼ ᄒ ᅢ ᄋ ᅪ ᆮ ᄄ ᅥ ᆫ
니가	ᄂ ᅵ ᄀ ᅡ
곁에	ᄀ ᅧ ᄐ ᅦ
있다는	ᄋ ᅵ ᆮ ᄄ ᅡ ᄂ ᅳ ᆫ
꿈만	ᄁ ᅮ ᆷ ᄆ ᅡ ᆫ
경치	ᄀ ᅧ ᆼ ᄎ ᅵ
좋고	ᄌ ᅩ ᄏ ᅩ
음식도	ᄋ ᅳ ᆷ ᄉ ᅵ ᆨ ᄄ ᅩ
맛있고	ᄆ ᅡ ᄉ ᅵ ᆮ ᄁ ᅩ
여행은	ᄋ ᅧ ᄒ ᅢ ᆼ ᄋ ᅳ ᆫ
대만족이야	ᄃ ᅢ ᄆ ᅡ ᆫ ᄌ ᅩ ᄀ ᅵ ᄋ ᅣ
보잘것없는	ᄇ ᅩ ᄌ ᅡ ᆯ ᄀ ᅥ ᄉ ᅥ ᆷ ᄂ ᅳ ᆫ
선물이지만	ᄉ ᅥ ᆫ ᄆ ᅮ ᄅ ᅵ ᄌ ᅵ ᄆ ᅡ ᆫ
주니까	ᄌ ᅮ ᄂ ᅵ ᄁ ᅡ
기뻐	ᄀ ᅵ ᄈ ᅥ
난	ᄂ ᅡ ᆫ
바라보고	ᄇ ᅡ ᄅ ᅡ ᄇ ᅩ ᄀ ᅩ
것만으로도	ᄀ ᅥ ᆫ ᄆ ᅡ ᄂ ᅳ ᄅ ᅩ ᄃ ᅩ
행복해	ᄒ ᅢ ᆼ ᄇ ᅩ ᄏ ᅢ
드디어	ᄃ ᅳ ᄃ ᅵ ᄋ ᅥ
내일이	ᄂ ᅢ ᄋ ᅵ ᄅ ᅵ
기다리던	ᄀ ᅵ ᄃ ᅡ ᄅ ᅵ ᄃ ᅥ ᆫ
월급날이라서	ᄋ ᅯ ᆯ ᄀ ᅳ ᆷ ᄂ ᅡ ᄅ ᅵ ᄅ ᅡ ᄉ ᅥ
그런지	ᄀ ᅳ ᄅ ᅥ ᆫ ᄌ ᅵ
기분	ᄀ ᅵ ᄇ ᅮ ᆫ
최고야	ᄎ ᅬ ᄀ ᅩ ᄋ ᅣ
줘서	ᄌ ᅯ ᄉ ᅥ
고마워	ᄀ ᅩ ᄆ ᅡ ᄋ ᅯ
이런	ᄋ ᅵ ᄅ ᅥ ᆫ
선물까지	ᄉ ᅥ ᆫ ᄆ ᅮ ᆯ ᄁ ᅡ ᄌ ᅵ
주시고	ᄌ ᅮ ᄉ ᅵ ᄀ ᅩ
풀려서	ᄑ ᅮ ᆯ ᄅ ᅧ ᄉ ᅥ
살맛	ᄉ ᅡ ᆯ ᄆ ᅡ ᆮ
난다	ᄂ ᅡ ᆫ ᄃ ᅡ
에피소드	ᄋ ᅦ ᄑ ᅵ ᄉ ᅩ ᄃ ᅳ
진짜	ᄌ ᅵ ᆫ ᄍ ᅡ
재밌더라	ᄌ ᅢ ᄆ ᅵ ᆮ ᄄ ᅥ ᄅ ᅡ
해외여행은	ᄒ ᅢ ᄋ ᅬ ᄋ ᅧ ᄒ ᅢ ᆼ ᄋ ᅳ ᆫ
처음이라	ᄎ ᅥ ᄋ ᅳ ᄆ ᅵ ᄅ ᅡ
엄청나게	ᄋ ᅥ ᆷ ᄎ ᅥ ᆼ ᄂ ᅡ ᄀ ᅦ
들떠	ᄃ ᅳ ᆯ ᄄ ᅥ
만날	ᄆ ᅡ ᆫ ᄂ ᅡ ᆯ
생각하니	ᄉ ᅢ ᆼ ᄀ ᅡ ᄏ ᅡ ᄂ ᅵ
설렌다	ᄉ ᅥ ᆯ ᄅ ᅦ ᆫ ᄃ ᅡ
친구야	ᄎ ᅵ ᆫ ᄀ ᅮ ᄋ ᅣ
축하해줘	ᄎ ᅮ ᄏ ᅡ ᄒ ᅢ ᄌ ᅯ
여자친구	ᄋ ᅧ ᄌ ᅡ ᄎ ᅵ ᆫ ᄀ ᅮ
생겼어	ᄉ ᅢ ᆼ ᄀ ᅧ ᄊ ᅥ
먹자마자	ᄆ ᅥ ᆨ ᄍ ᅡ ᄆ ᅡ ᄌ ᅡ
안에서	ᄋ ᅡ ᄂ ᅦ ᄉ ᅥ
살살	ᄉ ᅡ ᆯ ᄉ ᅡ ᆯ
녹는데	ᄂ ᅩ ᆼ ᄂ ᅳ ᆫ ᄃ ᅦ
지금까지	ᄌ ᅵ ᄀ ᅳ ᆷ ᄁ ᅡ ᄌ ᅵ
뮤지컬	ᄆ ᅲ ᄌ ᅵ ᄏ ᅥ ᆯ
무대가	ᄆ ᅮ ᄃ ᅢ ᄀ ᅡ
멋졌어	ᄆ ᅥ ᆮ ᄍ ᅥ ᄊ ᅥ
강아지는	ᄀ ᅡ ᆼ ᄋ ᅡ ᄌ ᅵ ᄂ ᅳ ᆫ
짓이	ᄌ ᅵ ᄉ ᅵ
귀엽고	ᄀ ᅱ ᄋ ᅧ ᆸ ᄁ ᅩ
사랑스러워	ᄉ ᅡ ᄅ ᅡ ᆼ ᄉ ᅳ ᄅ ᅥ ᄋ ᅯ
정상이라	ᄌ ᅥ ᆼ ᄉ ᅡ ᆼ ᄋ ᅵ ᄅ ᅡ
공기	ᄀ ᅩ ᆼ ᄀ ᅵ
상쾌하다	ᄉ ᅡ ᆼ ᄏ ᅫ ᄒ ᅡ ᄃ ᅡ
직구	ᄌ ᅵ ᆨ ᄁ ᅮ
성공해서	ᄉ ᅥ ᆼ ᄀ ᅩ ᆼ ᄒ ᅢ ᄉ ᅥ
콧노래가	ᄏ ᅩ ᆫ ᄂ ᅩ ᄅ ᅢ ᄀ ᅡ
절로	ᄌ ᅥ ᆯ ᄅ ᅩ
선물이	ᄉ ᅥ ᆫ ᄆ ᅮ ᄅ ᅵ
마음에	ᄆ ᅡ ᄋ ᅳ ᄆ ᅦ
소개팅	ᄉ ᅩ ᄀ ᅢ ᄐ ᅵ ᆼ
생각만	ᄉ ᅢ ᆼ ᄀ ᅡ ᆼ ᄆ ᅡ ᆫ
하면	ᄒ ᅡ ᄆ ᅧ ᆫ
자꾸만	ᄌ ᅡ ᄁ ᅮ ᄆ ᅡ ᆫ
웃음이	ᄋ ᅮ ᄉ ᅳ ᄆ ᅵ
놈이구나	ᄂ ᅩ ᄆ ᅵ ᄀ ᅮ ᄂ ᅡ
레스토랑	ᄅ ᅦ ᄉ ᅳ ᄐ ᅩ ᄅ ᅡ ᆼ
분위기도	ᄇ ᅮ ᄂ ᅱ ᄀ ᅵ ᄃ ᅩ
근사한데	ᄀ ᅳ ᆫ ᄉ ᅡ ᄒ ᅡ ᆫ ᄃ ᅦ
가격	ᄀ ᅡ ᄀ ᅧ ᆨ
대비	ᄃ ᅢ ᄇ ᅵ
성능이	ᄉ ᅥ ᆼ ᄂ ᅳ ᆼ ᄋ ᅵ
꽤	ᄁ ᅫ
고양이	ᄀ ᅩ ᄋ ᅣ ᆼ ᄋ ᅵ
애교	ᄋ ᅢ ᄀ ᅭ
부리는	ᄇ ᅮ ᄅ ᅵ ᄂ ᅳ ᆫ
귀엽지	ᄀ ᅱ ᄋ ᅧ ᆸ ᄍ ᅵ
국립중앙박물관의	ᄀ ᅮ ᆼ ᄂ ᅵ ᆸ ᄍ ᅮ ᆼ ᄋ ᅡ ᆼ ᄇ ᅡ ᆼ ᄆ ᅮ ᆯ ᄀ ᅪ ᄂ ᅴ
개관	ᄀ ᅢ ᄀ ᅪ ᆫ
시간은	ᄉ ᅵ ᄀ ᅡ ᄂ ᅳ ᆫ
오전	ᄋ ᅩ ᄌ ᅥ ᆫ
시입니다	ᄉ ᅵ ᄋ ᅵ ᆷ ᄂ ᅵ ᄃ ᅡ
세종문화회관에서	ᄉ ᅦ ᄌ ᅩ ᆼ ᄆ ᅮ ᆫ ᄒ ᅪ ᄒ ᅬ ᄀ ᅪ ᄂ ᅦ ᄉ ᅥ
사진전이	ᄉ ᅡ ᄌ ᅵ ᆫ ᄌ ᅥ ᄂ ᅵ
있다는데	ᄋ ᅵ ᆮ ᄄ ᅡ ᄂ ᅳ ᆫ ᄃ ᅦ
가볼래	ᄀ ᅡ ᄇ ᅩ ᆯ ᄅ ᅢ
오월은	ᄋ ᅩ ᄋ ᅯ ᄅ ᅳ ᆫ
가정의	ᄀ ᅡ ᄌ ᅥ ᆼ ᄋ ᅴ
달이라	ᄃ ᅡ ᄅ ᅵ ᄅ ᅡ
특별	ᄐ ᅳ ᆨ ᄈ ᅧ ᆯ
공연이	ᄀ ᅩ ᆼ ᄋ ᅧ ᄂ ᅵ
계획되어	ᄀ ᅨ ᄒ ᅬ ᆨ ᄄ ᅬ ᄋ ᅥ
있대	ᄋ ᅵ ᆮ ᄄ ᅢ
오후에	ᄋ ᅩ ᄒ ᅮ ᄋ ᅦ
온다고	ᄋ ᅩ ᆫ ᄃ ᅡ ᄀ ᅩ
하니까	ᄒ ᅡ ᄂ ᅵ ᄁ ᅡ
챙겨	ᄎ ᅢ ᆼ ᄀ ᅧ
불규칙한	ᄇ ᅮ ᆯ ᄀ ᅲ ᄎ ᅵ ᄏ ᅡ ᆫ
식사	ᄉ ᅵ ᆨ ᄊ ᅡ
습관과	ᄉ ᅳ ᆸ ᄁ ᅪ ᆫ ᄀ ᅪ
과식은	ᄀ ᅪ ᄉ ᅵ ᄀ ᅳ ᆫ
소화	ᄉ ᅩ ᄒ ᅪ
불량의	ᄇ ᅮ ᆯ ᄅ ᅣ ᆼ ᄋ ᅴ
원인이	ᄋ ᅯ ᄂ ᅵ ᄂ ᅵ
중앙선거관리위원회에	ᄌ ᅮ ᆼ ᄋ ᅡ ᆼ ᄉ ᅥ ᆫ ᄀ ᅥ ᄀ ᅪ ᆯ ᄅ ᅵ ᄋ ᅱ ᄋ ᅯ ᆫ ᄒ ᅬ ᄋ ᅦ
문의해	ᄆ ᅮ ᄂ ᅴ ᄒ ᅢ
보셔야	ᄇ ᅩ ᄉ ᅧ ᄋ ᅣ
북미	ᄇ ᅮ ᆼ ᄆ ᅵ
정상회담의	ᄌ ᅥ ᆼ ᄉ ᅡ ᆼ ᄒ ᅬ ᄃ ᅡ ᄆ ᅴ
일정과	ᄋ ᅵ ᆯ ᄌ ᅥ ᆼ ᄀ ᅪ
장소가	ᄌ ᅡ ᆼ ᄉ ᅩ ᄀ ᅡ
주	ᄌ ᅮ
내로	ᄂ ᅢ ᄅ ᅩ
공개될	ᄀ ᅩ ᆼ ᄀ ᅢ ᄃ ᅬ ᆯ
아프가니스탄에서	ᄋ ᅡ ᄑ ᅳ ᄀ ᅡ ᄂ ᅵ ᄉ ᅳ ᄐ ᅡ ᄂ ᅦ ᄉ ᅥ
지진으로	ᄌ ᅵ ᄌ ᅵ ᄂ ᅳ ᄅ ᅩ
현재까지	ᄒ ᅧ ᆫ ᄌ ᅢ ᄁ ᅡ ᄌ ᅵ
명의	ᄆ ᅧ ᆼ ᄋ ᅴ
부상자가	ᄇ ᅮ ᄉ ᅡ ᆼ ᄌ ᅡ ᄀ ᅡ
발생했다고	ᄇ ᅡ ᆯ ᄉ ᅢ ᆼ ᄒ ᅢ ᆮ ᄄ ᅡ ᄀ ᅩ
전해졌습니다	ᄌ ᅥ ᆫ ᄒ ᅢ ᄌ ᅥ ᆮ ᄊ ᅳ ᆷ ᄂ ᅵ ᄃ ᅡ
파블로	ᄑ ᅡ ᄇ ᅳ ᆯ ᄅ ᅩ
피카소의	ᄑ ᅵ ᄏ ᅡ ᄉ ᅩ ᄋ ᅴ
그림이	ᄀ ᅳ ᄅ ᅵ ᄆ ᅵ
천오백억	ᄎ ᅥ ᄂ ᅩ ᄇ ᅢ ᄀ ᅥ ᆨ
원에	ᄋ ᅯ ᄂ ᅦ
낙찰되었대요	ᄂ ᅡ ᆨ ᄎ ᅡ ᆯ ᄃ ᅬ ᄋ ᅥ ᆮ ᄄ ᅢ ᄋ ᅭ
초	ᄎ ᅩ
어린이용	ᄋ ᅥ ᄅ ᅵ ᄂ ᅵ ᄋ ᅭ ᆼ
스마트워치가	ᄉ ᅳ ᄆ ᅡ ᄐ ᅳ ᄋ ᅯ ᄎ ᅵ ᄀ ᅡ
출시될	ᄎ ᅮ ᆯ ᄉ ᅵ ᄃ ᅬ ᆯ
말초	ᄆ ᅡ ᆯ ᄎ ᅩ
신경계는	ᄉ ᅵ ᆫ ᄀ ᅧ ᆼ ᄀ ᅨ ᄂ ᅳ ᆫ
몸	ᄆ ᅩ ᆷ
신경계와	ᄉ ᅵ ᆫ ᄀ ᅧ ᆼ ᄀ ᅨ ᄋ ᅪ
자율신경계로	ᄌ ᅡ ᄋ ᅲ ᆯ ᄉ ᅵ ᆫ ᄀ ᅧ ᆼ ᄀ ᅨ ᄅ ᅩ
나뉩니다	ᄂ ᅡ ᄂ ᅱ ᆷ ᄂ ᅵ ᄃ ᅡ
두산	ᄃ ᅮ ᄉ ᅡ ᆫ
베어스	ᄇ ᅦ ᄋ ᅥ ᄉ ᅳ
선수단이	ᄉ ᅥ ᆫ ᄉ ᅮ ᄃ ᅡ ᄂ ᅵ
호주로	ᄒ ᅩ ᄌ ᅮ ᄅ ᅩ
전지	ᄌ ᅥ ᆫ ᄌ ᅵ
훈련을	ᄒ ᅮ ᆯ ᄅ ᅧ ᄂ ᅳ ᆯ
거래	ᄀ ᅥ ᄅ ᅢ
대리와	ᄃ ᅢ ᄅ ᅵ ᄋ ᅪ
김	ᄀ ᅵ ᆷ
대리는	ᄃ ᅢ ᄅ ᅵ ᄂ ᅳ ᆫ
백화점에서	ᄇ ᅢ ᄏ ᅪ ᄌ ᅥ ᄆ ᅦ ᄉ ᅥ
시장조사를	ᄉ ᅵ ᄌ ᅡ ᆼ ᄌ ᅩ ᄉ ᅡ ᄅ ᅳ ᆯ
해주세요	ᄒ ᅢ ᄌ ᅮ ᄉ ᅦ ᄋ ᅭ
화장품도	ᄒ ᅪ ᄌ ᅡ ᆼ ᄑ ᅮ ᆷ ᄃ ᅩ
유통기한과	ᄋ ᅲ ᄐ ᅩ ᆼ ᄀ ᅵ ᄒ ᅡ ᆫ ᄀ ᅪ
제조	ᄌ ᅦ ᄌ ᅩ
일자를	ᄋ ᅵ ᆯ ᄌ ᅡ ᄅ ᅳ ᆯ
써야	ᄊ ᅥ ᄋ ᅣ
색상은	ᄉ ᅢ ᆨ ᄊ ᅡ ᆼ ᄋ ᅳ ᆫ
베이지로	ᄇ ᅦ ᄋ ᅵ ᄌ ᅵ ᄅ ᅩ
크기는	ᄏ ᅳ ᄀ ᅵ ᄂ ᅳ ᆫ
작은	ᄌ ᅡ ᄀ ᅳ ᆫ
치수로	ᄎ ᅵ ᄉ ᅮ ᄅ ᅩ
이태원에	ᄋ ᅵ ᄐ ᅢ ᄋ ᅯ ᄂ ᅦ
쌀국수집	ᄊ ᅡ ᆯ ᄀ ᅮ ᆨ ᄊ ᅮ ᄌ ᅵ ᆸ
가서	ᄀ ᅡ ᄉ ᅥ
먹자	ᄆ ᅥ ᆨ ᄍ ᅡ
그럼	ᄀ ᅳ ᄅ ᅥ ᆷ
아홉	ᄋ ᅡ ᄒ ᅩ ᆸ
카페에서	ᄏ ᅡ ᄑ ᅦ ᄋ ᅦ ᄉ ᅥ
뵙죠	ᄇ ᅬ ᆸ ᄍ ᅭ
개명은	ᄀ ᅢ ᄆ ᅧ ᆼ ᄋ ᅳ ᆫ
법률상	ᄇ ᅥ ᆷ ᄂ ᅲ ᆯ ᄉ ᅡ ᆼ
황제펭귄은	ᄒ ᅪ ᆼ ᄌ ᅦ ᄑ ᅦ ᆼ ᄀ ᅱ ᄂ ᅳ ᆫ
지구상에	ᄌ ᅵ ᄀ ᅮ ᄉ ᅡ ᆼ ᄋ ᅦ
펭귄	ᄑ ᅦ ᆼ ᄀ ᅱ ᆫ
몸집이	ᄆ ᅩ ᆷ ᄌ ᅵ ᄇ ᅵ
커	ᄏ ᅥ
양키	ᄋ ᅣ ᆼ ᄏ ᅵ
스타디움은	ᄉ ᅳ ᄐ ᅡ ᄃ ᅵ ᄋ ᅮ ᄆ ᅳ ᆫ
메이저리그를	ᄆ ᅦ ᄋ ᅵ ᄌ ᅥ ᄅ ᅵ ᄀ ᅳ ᄅ ᅳ ᆯ
상징하는	ᄉ ᅡ ᆼ ᄌ ᅵ ᆼ ᄒ ᅡ ᄂ ᅳ ᆫ
야구장이죠	ᄋ ᅣ ᄀ ᅮ ᄌ ᅡ ᆼ ᄋ ᅵ ᄌ ᅭ
지문으로	ᄌ ᅵ ᄆ ᅮ ᄂ ᅳ ᄅ ᅩ
범인을	ᄇ ᅥ ᄆ ᅵ ᄂ ᅳ ᆯ
방법에	ᄇ ᅡ ᆼ ᄇ ᅥ ᄇ ᅦ
알고	ᄋ ᅡ ᆯ ᄀ ᅩ
발표회	ᄇ ᅡ ᆯ ᄑ ᅭ ᄒ ᅬ
무대에서	ᄆ ᅮ ᄃ ᅢ ᄋ ᅦ ᄉ ᅥ
수진이가	ᄉ ᅮ ᄌ ᅵ ᄂ ᅵ ᄀ ᅡ
잘하던	ᄌ ᅡ ᆯ ᄒ ᅡ ᄃ ᅥ ᆫ
친구여서	ᄎ ᅵ ᆫ ᄀ ᅮ ᄋ ᅧ ᄉ ᅥ
든든하다	ᄃ ᅳ ᆫ ᄃ ᅳ ᆫ ᄒ ᅡ ᄃ ᅡ
역시	ᄋ ᅧ ᆨ ᄊ ᅵ
평양	ᄑ ᅧ ᆼ ᄋ ᅣ ᆼ
냉면이	ᄂ ᅢ ᆼ ᄆ ᅧ ᄂ ᅵ
전국에서	ᄌ ᅥ ᆫ ᄀ ᅮ ᄀ ᅦ ᄉ ᅥ
답답했던	ᄃ ᅡ ᆸ ᄄ ᅡ ᄑ ᅢ ᆮ ᄄ ᅥ ᆫ
속이	ᄉ ᅩ ᄀ ᅵ
뻥	ᄈ ᅥ ᆼ
뚫리는	ᄄ ᅮ ᆯ ᄅ ᅵ ᄂ ᅳ ᆫ
비현실적일	ᄇ ᅵ ᄒ ᅧ ᆫ ᄉ ᅵ ᆯ ᄌ ᅥ ᄀ ᅵ ᆯ
정도로	ᄌ ᅥ ᆼ ᄃ ᅩ ᄅ ᅩ
근사한	ᄀ ᅳ ᆫ ᄉ ᅡ ᄒ ᅡ ᆫ
통신사	ᄐ ᅩ ᆼ ᄉ ᅵ ᆫ ᄉ ᅡ
할인에	ᄒ ᅡ ᄅ ᅵ ᄂ ᅦ
오케이	ᄋ ᅩ ᄏ ᅦ ᄋ ᅵ
캐쉬백까지	ᄏ ᅢ ᄉ ᅱ ᄇ ᅢ ᆨ ᄁ ᅡ ᄌ ᅵ
완전	ᄋ ᅪ ᆫ ᄌ ᅥ ᆫ
굳었지요	ᄀ ᅮ ᄃ ᅥ ᆮ ᄍ ᅵ ᄋ ᅭ
웃기려고	ᄋ ᅮ ᆮ ᄁ ᅵ ᄅ ᅧ ᄀ ᅩ
작심했나	ᄌ ᅡ ᆨ ᄊ ᅵ ᆷ ᄒ ᅢ ᆫ ᄂ ᅡ
배꼽	ᄇ ᅢ ᄁ ᅩ ᆸ
빠지겠다	ᄈ ᅡ ᄌ ᅵ ᄀ ᅦ ᆮ ᄄ ᅡ
백	ᄇ ᅢ ᆨ
미터	ᄆ ᅵ ᄐ ᅥ
달리기	ᄃ ᅡ ᆯ ᄅ ᅵ ᄀ ᅵ
신기록	ᄉ ᅵ ᆫ ᄀ ᅵ ᄅ ᅩ ᆨ
세웠어요	ᄉ ᅦ ᄋ ᅯ ᄊ ᅥ ᄋ ᅭ
모델	ᄆ ᅩ ᄃ ᅦ ᆯ
보는	ᄇ ᅩ ᄂ ᅳ ᆫ
것만으로	ᄀ ᅥ ᆫ ᄆ ᅡ ᄂ ᅳ ᄅ ᅩ
훈훈해지네	ᄒ ᅮ ᆫ ᄒ ᅮ ᆫ ᄒ ᅢ ᄌ ᅵ ᄂ ᅦ
자기는	ᄌ ᅡ ᄀ ᅵ ᄂ ᅳ ᆫ
닮아서	ᄃ ᅡ ᆯ ᄆ ᅡ ᄉ ᅥ
예뻐	ᄋ ᅨ ᄈ ᅥ
예쁜	ᄋ ᅨ ᄈ ᅳ ᆫ
딸이	ᄄ ᅡ ᄅ ᅵ
뽀뽀해줘서	ᄈ ᅩ ᄈ ᅩ ᄒ ᅢ ᄌ ᅯ ᄉ ᅥ
날아갈	ᄂ ᅡ ᄅ ᅡ ᄀ ᅡ ᆯ
결혼식이라서	ᄀ ᅧ ᆯ ᄒ ᅩ ᆫ ᄉ ᅵ ᄀ ᅵ ᄅ ᅡ ᄉ ᅥ
설레서	ᄉ ᅥ ᆯ ᄅ ᅦ ᄉ ᅥ
준비한	ᄌ ᅮ ᆫ ᄇ ᅵ ᄒ ᅡ ᆫ
꿈이	ᄁ ᅮ ᄆ ᅵ
이루어졌어	ᄋ ᅵ ᄅ ᅮ ᄋ ᅥ ᄌ ᅥ ᄊ ᅥ
영화야	ᄋ ᅧ ᆼ ᄒ ᅪ ᄋ ᅣ
재밌겠지	ᄌ ᅢ ᄆ ᅵ ᆮ ᄁ ᅦ ᆮ ᄍ ᅵ
말로	ᄆ ᅡ ᆯ ᄅ ᅩ
표현할	ᄑ ᅭ ᄒ ᅧ ᆫ ᄒ ᅡ ᆯ
없을	ᄋ ᅥ ᆸ ᄊ ᅳ ᆯ
흐뭇하다	ᄒ ᅳ ᄆ ᅮ ᄐ ᅡ ᄃ ᅡ
울컥할	ᄋ ᅮ ᆯ ᄏ ᅥ ᄏ ᅡ ᆯ
따뜻해지는	ᄄ ᅡ ᄄ ᅳ ᄐ ᅢ ᄌ ᅵ ᄂ ᅳ ᆫ
장면이야	ᄌ ᅡ ᆼ ᄆ ᅧ ᄂ ᅵ ᄋ ᅣ
준비했다니	ᄌ ᅮ ᆫ ᄇ ᅵ ᄒ ᅢ ᆮ ᄄ ᅡ ᄂ ᅵ
감동이야	ᄀ ᅡ ᆷ ᄃ ᅩ ᆼ ᄋ ᅵ ᄋ ᅣ
햇살도	ᄒ ᅢ ᄊ ᅡ ᆯ ᄃ ᅩ
바람도	ᄇ ᅡ ᄅ ᅡ ᆷ ᄃ ᅩ
선선하고	ᄉ ᅥ ᆫ ᄉ ᅥ ᆫ ᄒ ᅡ ᄀ ᅩ
날씨	ᄂ ᅡ ᆯ ᄊ ᅵ
좋죠	ᄌ ᅩ ᄎ ᅭ
해냈다니	ᄒ ᅢ ᄂ ᅢ ᆮ ᄄ ᅡ ᄂ ᅵ
대견스러워	ᄃ ᅢ ᄀ ᅧ ᆫ ᄉ ᅳ ᄅ ᅥ ᄋ ᅯ
흥겨워서	ᄒ ᅳ ᆼ ᄀ ᅧ ᄋ ᅯ ᄉ ᅥ
노래가	ᄂ ᅩ ᄅ ᅢ ᄀ ᅡ
나는구먼	ᄂ ᅡ ᄂ ᅳ ᆫ ᄀ ᅮ ᄆ ᅥ ᆫ
신나서	ᄉ ᅵ ᆫ ᄂ ᅡ ᄉ ᅥ
춤이	ᄎ ᅮ ᄆ ᅵ
나네	ᄂ ᅡ ᄂ ᅦ
경사	ᄀ ᅧ ᆼ ᄉ ᅡ
났네	ᄂ ᅡ ᆫ ᄂ ᅦ
났어	ᄂ ᅡ ᄊ ᅥ
준비하시고	ᄌ ᅮ ᆫ ᄇ ᅵ ᄒ ᅡ ᄉ ᅵ ᄀ ᅩ
매번	ᄆ ᅢ ᄇ ᅥ ᆫ
너와	ᄂ ᅥ ᄋ ᅪ
함께	ᄒ ᅡ ᆷ ᄁ ᅦ
즐거워	ᄌ ᅳ ᆯ ᄀ ᅥ ᄋ ᅯ
애교에	ᄋ ᅢ ᄀ ᅭ ᄋ ᅦ
녹는다	ᄂ ᅩ ᆼ ᄂ ᅳ ᆫ ᄃ ᅡ
녹아	ᄂ ᅩ ᄀ ᅡ
순간	ᄉ ᅮ ᆫ ᄀ ᅡ ᆫ
운	ᄋ ᅮ ᆫ
사람입니다	ᄉ ᅡ ᄅ ᅡ ᄆ ᅵ ᆷ ᄂ ᅵ ᄃ ᅡ
천국이	ᄎ ᅥ ᆫ ᄀ ᅮ ᄀ ᅵ
따로	ᄄ ᅡ ᄅ ᅩ
행복하면	ᄒ ᅢ ᆼ ᄇ ᅩ ᄏ ᅡ ᄆ ᅧ ᆫ
그곳이	ᄀ ᅳ ᄀ ᅩ ᄉ ᅵ
손님이	ᄉ ᅩ ᆫ ᄂ ᅵ ᄆ ᅵ
몸은	ᄆ ᅩ ᄆ ᅳ ᆫ
고돼도	ᄀ ᅩ ᄃ ᅫ ᄃ ᅩ
같은	ᄀ ᅡ ᄐ ᅳ ᆫ
친구라니	ᄎ ᅵ ᆫ ᄀ ᅮ ᄅ ᅡ ᄂ ᅵ
행운아야	ᄒ ᅢ ᆼ ᄋ ᅮ ᄂ ᅡ ᄋ ᅣ
사장님	ᄉ ᅡ ᄌ ᅡ ᆼ ᄂ ᅵ ᆷ
오늘부로	ᄋ ᅩ ᄂ ᅳ ᆯ ᄇ ᅮ ᄅ ᅩ
아빠	ᄋ ᅡ ᄈ ᅡ
됐습니다	ᄃ ᅫ ᆮ ᄊ ᅳ ᆷ ᄂ ᅵ ᄃ ᅡ
자기야	ᄌ ᅡ ᄀ ᅵ ᄋ ᅣ
언니	ᄋ ᅥ ᆫ ᄂ ᅵ
사법고시	ᄉ ᅡ ᄇ ᅥ ᆸ ᄁ ᅩ ᄉ ᅵ
합격했어	ᄒ ᅡ ᆸ ᄁ ᅧ ᄏ ᅢ ᄊ ᅥ
순간이	ᄉ ᅮ ᆫ ᄀ ᅡ ᄂ ᅵ
영원했으면	ᄋ ᅧ ᆼ ᄋ ᅯ ᆫ ᄒ ᅢ ᄊ ᅳ ᄆ ᅧ ᆫ
좋겠다	ᄌ ᅩ ᄏ ᅦ ᆮ ᄄ ᅡ
청명하니	ᄎ ᅥ ᆼ ᄆ ᅧ ᆼ ᄒ ᅡ ᄂ ᅵ
기분도	ᄀ ᅵ ᄇ ᅮ ᆫ ᄃ ᅩ
웹	ᄋ ᅰ ᆸ
소설이	ᄉ ᅩ ᄉ ᅥ ᄅ ᅵ
순위권에	ᄉ ᅮ ᄂ ᅱ ᄀ ᅯ ᄂ ᅦ
들었다고요	ᄃ ᅳ ᄅ ᅥ ᆮ ᄄ ᅡ ᄀ ᅩ ᄋ ᅭ
오래간만에	ᄋ ᅩ ᄅ ᅢ ᄀ ᅡ ᆫ ᄆ ᅡ ᄂ ᅦ
기쁜	ᄀ ᅵ ᄈ ᅳ ᆫ
좋네요	ᄌ ᅩ ᆫ ᄂ ᅦ ᄋ ᅭ
끝까지	ᄁ ᅳ ᆮ ᄁ ᅡ ᄌ ᅵ
다한	ᄃ ᅡ ᄒ ᅡ ᆫ
선수들	ᄉ ᅥ ᆫ ᄉ ᅮ ᄃ ᅳ ᆯ
자랑스럽습니다	ᄌ ᅡ ᄅ ᅡ ᆼ ᄉ ᅳ ᄅ ᅥ ᆸ ᄊ ᅳ ᆷ ᄂ ᅵ ᄃ ᅡ
영화에서나	ᄋ ᅧ ᆼ ᄒ ᅪ ᄋ ᅦ ᄉ ᅥ ᄂ ᅡ
법한	ᄇ ᅥ ᄑ ᅡ ᆫ
풍경을	ᄑ ᅮ ᆼ ᄀ ᅧ ᆼ ᄋ ᅳ ᆯ
실제로	ᄉ ᅵ ᆯ ᄌ ᅦ ᄅ ᅩ
보다니	ᄇ ᅩ ᄃ ᅡ ᄂ ᅵ
황홀하다	ᄒ ᅪ ᆼ ᄒ ᅩ ᆯ ᄒ ᅡ ᄃ ᅡ
자식들	ᄌ ᅡ ᄉ ᅵ ᆨ ᄄ ᅳ ᆯ
덕을	ᄃ ᅥ ᄀ ᅳ ᆯ
톡톡히	ᄐ ᅩ ᆨ ᄐ ᅩ ᄏ ᅵ
보네	ᄇ ᅩ ᄂ ᅦ
칭찬해	ᄎ ᅵ ᆼ ᄎ ᅡ ᆫ ᄒ ᅢ
주시니	ᄌ ᅮ ᄉ ᅵ ᄂ ᅵ
둘	ᄃ ᅮ ᆯ
바를	ᄇ ᅡ ᄅ ᅳ ᆯ
모르겠네요	ᄆ ᅩ ᄅ ᅳ ᄀ ᅦ ᆫ ᄂ ᅦ ᄋ ᅭ
지도로	ᄌ ᅵ ᄃ ᅩ ᄅ ᅩ
해낼	ᄒ ᅢ ᄂ ᅢ ᆯ
있었어요	ᄋ ᅵ ᄊ ᅥ ᄊ ᅥ ᄋ ᅭ
여기에다	ᄋ ᅧ ᄀ ᅵ ᄋ ᅦ ᄃ ᅡ
김치를	ᄀ ᅵ ᆷ ᄎ ᅵ ᄅ ᅳ ᆯ
얹어	ᄋ ᅥ ᆫ ᄌ ᅥ
먹으면	ᄆ ᅥ ᄀ ᅳ ᄆ ᅧ ᆫ
그만이야	ᄀ ᅳ ᄆ ᅡ ᄂ ᅵ ᄋ ᅣ
몰라도	ᄆ ᅩ ᆯ ᄅ ᅡ ᄃ ᅩ
겉절이는	ᄀ ᅥ ᆮ ᄍ ᅥ ᄅ ᅵ ᄂ ᅳ ᆫ
끝내준다니까	ᄁ ᅳ ᆫ ᄂ ᅢ ᄌ ᅮ ᆫ ᄃ ᅡ ᄂ ᅵ ᄁ ᅡ
쥐구멍에도	ᄌ ᅱ ᄀ ᅮ ᄆ ᅥ ᆼ ᄋ ᅦ ᄃ ᅩ
볕들	ᄇ ᅧ ᆮ ᄄ ᅳ ᆯ
있다더니	ᄋ ᅵ ᆮ ᄄ ᅡ ᄃ ᅥ ᄂ ᅵ
인생에도	ᄋ ᅵ ᆫ ᄉ ᅢ ᆼ ᄋ ᅦ ᄃ ᅩ
영광이	ᄋ ᅧ ᆼ ᄀ ᅪ ᆼ ᄋ ᅵ
비치는구나	ᄇ ᅵ ᄎ ᅵ ᄂ ᅳ ᆫ ᄀ ᅮ ᄂ ᅡ
바로	ᄇ ᅡ ᄅ ᅩ
날을	ᄂ ᅡ ᄅ ᅳ ᆯ
위해서	ᄋ ᅱ ᄒ ᅢ ᄉ ᅥ
살아온	ᄉ ᅡ ᄅ ᅡ ᄋ ᅩ ᆫ
아니겠어	ᄋ ᅡ ᄂ ᅵ ᄀ ᅦ ᄊ ᅥ
반	ᄇ ᅡ ᆫ
학생들의	ᄒ ᅡ ᆨ ᄊ ᅢ ᆼ ᄃ ᅳ ᄅ ᅴ
수학	ᄉ ᅮ ᄒ ᅡ ᆨ
날로	ᄂ ᅡ ᆯ ᄅ ᅩ
일취월장하네	ᄋ ᅵ ᆯ ᄎ ᅱ ᄋ ᅯ ᆯ ᄌ ᅡ ᆼ ᄒ ᅡ ᄂ ᅦ
이러니	ᄋ ᅵ ᄅ ᅥ ᄂ ᅵ
배기겠니	ᄇ ᅢ ᄀ ᅵ ᄀ ᅦ ᆫ ᄂ ᅵ
태어난	ᄐ ᅢ ᄋ ᅥ ᄂ ᅡ ᆫ
기쁨은	ᄀ ᅵ ᄈ ᅳ ᄆ ᅳ ᆫ
평생	ᄑ ᅧ ᆼ ᄉ ᅢ ᆼ
못할	ᄆ ᅩ ᄐ ᅡ ᆯ
풍경이	ᄑ ᅮ ᆼ ᄀ ᅧ ᆼ ᄋ ᅵ
아름다워서	ᄋ ᅡ ᄅ ᅳ ᆷ ᄃ ᅡ ᄋ ᅯ ᄉ ᅥ
가슴이	ᄀ ᅡ ᄉ ᅳ ᄆ ᅵ
뭉클할	ᄆ ᅮ ᆼ ᄏ ᅳ ᆯ ᄒ ᅡ ᆯ
정도야	ᄌ ᅥ ᆼ ᄃ ᅩ ᄋ ᅣ
도전에	ᄃ ᅩ ᄌ ᅥ ᄂ ᅦ
성공했다니	ᄉ ᅥ ᆼ ᄀ ᅩ ᆼ ᄒ ᅢ ᆮ ᄄ ᅡ ᄂ ᅵ
벅차올라서	ᄇ ᅥ ᆨ ᄎ ᅡ ᄋ ᅩ ᆯ ᄅ ᅡ ᄉ ᅥ
울고	ᄋ ᅮ ᆯ ᄀ ᅩ
싶다	ᄉ ᅵ ᆸ ᄄ ᅡ
이따	ᄋ ᅵ ᄄ ᅡ
친구들이랑	ᄎ ᅵ ᆫ ᄀ ᅮ ᄃ ᅳ ᄅ ᅵ ᄅ ᅡ ᆼ
놀러	ᄂ ᅩ ᆯ ᄅ ᅥ
생각하니까	ᄉ ᅢ ᆼ ᄀ ᅡ ᄏ ᅡ ᄂ ᅵ ᄁ ᅡ
흥분된다	ᄒ ᅳ ᆼ ᄇ ᅮ ᆫ ᄃ ᅬ ᆫ ᄃ ᅡ
맛있는	ᄆ ᅡ ᄉ ᅵ ᆫ ᄂ ᅳ ᆫ
재밌게	ᄌ ᅢ ᄆ ᅵ ᆮ ᄁ ᅦ
놀아야지	ᄂ ᅩ ᄅ ᅡ ᄋ ᅣ ᄌ ᅵ
기대된다	ᄀ ᅵ ᄃ ᅢ ᄃ ᅬ ᆫ ᄃ ᅡ
행운이	ᄒ ᅢ ᆼ ᄋ ᅮ ᄂ ᅵ
찾아왔다니	ᄎ ᅡ ᄌ ᅡ ᄋ ᅪ ᆮ ᄄ ᅡ ᄂ ᅵ
실감이	ᄉ ᅵ ᆯ ᄀ ᅡ ᄆ ᅵ
마치	ᄆ ᅡ ᄎ ᅵ
걷는	ᄀ ᅥ ᆫ ᄂ ᅳ ᆫ
기분이야	ᄀ ᅵ ᄇ ᅮ ᄂ ᅵ ᄋ ᅣ
학자금	ᄒ ᅡ ᆨ ᄍ ᅡ ᄀ ᅳ ᆷ
대출을	ᄃ ᅢ ᄎ ᅮ ᄅ ᅳ ᆯ
갚고	ᄀ ᅡ ᆸ ᄁ ᅩ
나니까	ᄂ ᅡ ᄂ ᅵ ᄁ ᅡ
홀가분해졌어	ᄒ ᅩ ᆯ ᄀ ᅡ ᄇ ᅮ ᆫ ᄒ ᅢ ᄌ ᅥ ᄊ ᅥ
소프라노의	ᄉ ᅩ ᄑ ᅳ ᄅ ᅡ ᄂ ᅩ ᄋ ᅴ
먹었던	ᄆ ᅥ ᄀ ᅥ ᆮ ᄄ ᅥ ᆫ
솜사탕처럼	ᄉ ᅩ ᆷ ᄉ ᅡ ᄐ ᅡ ᆼ ᄎ ᅥ ᄅ ᅥ ᆷ
감미롭다	ᄀ ᅡ ᆷ ᄆ ᅵ ᄅ ᅩ ᆸ ᄄ ᅡ
남자친구가	ᄂ ᅡ ᆷ ᄌ ᅡ ᄎ ᅵ ᆫ ᄀ ᅮ ᄀ ᅡ
감동했어	ᄀ ᅡ ᆷ ᄃ ᅩ ᆼ ᄒ ᅢ ᄊ ᅥ
호탕한	ᄒ ᅩ ᄐ ᅡ ᆼ ᄒ ᅡ ᆫ
웃음소리를	ᄋ ᅮ ᄉ ᅳ ᆷ ᄉ ᅩ ᄅ ᅵ ᄅ ᅳ ᆯ
나까지	ᄂ ᅡ ᄁ ᅡ ᄌ ᅵ
유쾌해져	ᄋ ᅲ ᄏ ᅫ ᄒ ᅢ ᄌ ᅥ
호텔	ᄒ ᅩ ᄐ ᅦ ᆯ
시설이	ᄉ ᅵ ᄉ ᅥ ᄅ ᅵ
예약	ᄋ ᅨ ᄋ ᅣ ᆨ
사이트에서	ᄉ ᅡ ᄋ ᅵ ᄐ ᅳ ᄋ ᅦ ᄉ ᅥ
깨끗하고	ᄁ ᅢ ᄁ ᅳ ᄐ ᅡ ᄀ ᅩ
쾌적해서	ᄏ ᅫ ᄌ ᅥ ᄏ ᅢ ᄉ ᅥ
만족스러워	ᄆ ᅡ ᆫ ᄌ ᅩ ᆨ ᄊ ᅳ ᄅ ᅥ ᄋ ᅯ
배고팠는데	ᄇ ᅢ ᄀ ᅩ ᄑ ᅡ ᆫ ᄂ ᅳ ᆫ ᄃ ᅦ
이제야	ᄋ ᅵ ᄌ ᅦ ᄋ ᅣ
일일	ᄋ ᅵ ᄅ ᅵ ᆯ
팩	ᄑ ᅢ ᆨ
실천하고	ᄉ ᅵ ᆯ ᄎ ᅥ ᆫ ᄒ ᅡ ᄀ ᅩ
있거든	ᄋ ᅵ ᆮ ᄁ ᅥ ᄃ ᅳ ᆫ
얼굴에서	ᄋ ᅥ ᆯ ᄀ ᅮ ᄅ ᅦ ᄉ ᅥ
빛이	ᄇ ᅵ ᄎ ᅵ
쏟아지던	ᄊ ᅩ ᄃ ᅡ ᄌ ᅵ ᄃ ᅥ ᆫ
그치고	ᄀ ᅳ ᄎ ᅵ ᄀ ᅩ
나니	ᄂ ᅡ ᄂ ᅵ
화창해졌어	ᄒ ᅪ ᄎ ᅡ ᆼ ᄒ ᅢ ᄌ ᅥ ᄊ ᅥ
푹	ᄑ ᅮ ᆨ
쉬어서	ᄉ ᅱ ᄋ ᅥ ᄉ ᅥ
월요일	ᄋ ᅯ ᄅ ᅭ ᄋ ᅵ ᆯ
아침을	ᄋ ᅡ ᄎ ᅵ ᄆ ᅳ ᆯ
활기차게	ᄒ ᅪ ᆯ ᄀ ᅵ ᄎ ᅡ ᄀ ᅦ
시작할	ᄉ ᅵ ᄌ ᅡ ᄏ ᅡ ᆯ
성과가	ᄉ ᅥ ᆼ ᄀ ᅪ ᄀ ᅡ
나오기	ᄂ ᅡ ᄋ ᅩ ᄀ ᅵ
시작했어	ᄉ ᅵ ᄌ ᅡ ᄏ ᅢ ᄊ ᅥ
기다린	ᄀ ᅵ ᄃ ᅡ ᄅ ᅵ ᆫ
보람이	ᄇ ᅩ ᄅ ᅡ ᄆ ᅵ
미숙아였던	ᄆ ᅵ ᄉ ᅮ ᄀ ᅡ ᄋ ᅧ ᆮ ᄄ ᅥ ᆫ
씩씩하고	ᄊ ᅵ ᆨ ᄊ ᅵ ᄏ ᅡ ᄀ ᅩ
건강하게	ᄀ ᅥ ᆫ ᄀ ᅡ ᆼ ᄒ ᅡ ᄀ ᅦ
자라줘서	ᄌ ᅡ ᄅ ᅡ ᄌ ᅯ ᄉ ᅥ
대견해요	ᄃ ᅢ ᄀ ᅧ ᆫ ᄒ ᅢ ᄋ ᅭ
다행히	ᄃ ᅡ ᄒ ᅢ ᆼ ᄒ ᅵ
배	ᄇ ᅢ
크고	ᄏ ᅳ ᄀ ᅩ
있대요	ᄋ ᅵ ᆮ ᄄ ᅢ ᄋ ᅭ
연락이	ᄋ ᅧ ᆯ ᄅ ᅡ ᄀ ᅵ
끊겼던	ᄁ ᅳ ᆫ ᄏ ᅧ ᆮ ᄄ ᅥ ᆫ
친구의	ᄎ ᅵ ᆫ ᄀ ᅮ ᄋ ᅴ
알게	ᄋ ᅡ ᆯ ᄀ ᅦ
천진난만한	ᄎ ᅥ ᆫ ᄌ ᅵ ᆫ ᄂ ᅡ ᆫ ᄆ ᅡ ᆫ ᄒ ᅡ ᆫ
좋아지네요	ᄌ ᅩ ᄋ ᅡ ᄌ ᅵ ᄂ ᅦ ᄋ ᅭ
메리	ᄆ ᅦ ᄅ ᅵ
크리스마스	ᄏ ᅳ ᄅ ᅵ ᄉ ᅳ ᄆ ᅡ ᄉ ᅳ
즐거운	ᄌ ᅳ ᆯ ᄀ ᅥ ᄋ ᅮ ᆫ
성탄절	ᄉ ᅥ ᆼ ᄐ ᅡ ᆫ ᄌ ᅥ ᆯ
우리의	ᄋ ᅮ ᄅ ᅵ ᄋ ᅴ
만남을	ᄆ ᅡ ᆫ ᄂ ᅡ ᄆ ᅳ ᆯ
축복하듯	ᄎ ᅮ ᆨ ᄈ ᅩ ᄏ ᅡ ᄃ ᅳ ᆮ
하늘에서	ᄒ ᅡ ᄂ ᅳ ᄅ ᅦ ᄉ ᅥ
흩날리네요	ᄒ ᅳ ᆫ ᄂ ᅡ ᆯ ᄅ ᅵ ᄂ ᅦ ᄋ ᅭ
좋게	ᄌ ᅩ ᄏ ᅦ
비행기	ᄇ ᅵ ᄒ ᅢ ᆼ ᄀ ᅵ
좌석을	ᄌ ᅪ ᄉ ᅥ ᄀ ᅳ ᆯ
업그레이드	ᄋ ᅥ ᆸ ᄁ ᅳ ᄅ ᅦ ᄋ ᅵ ᄃ ᅳ
받았어요	ᄇ ᅡ ᄃ ᅡ ᄊ ᅥ ᄋ ᅭ
연탄	ᄋ ᅧ ᆫ ᄐ ᅡ ᆫ
배달	ᄇ ᅢ ᄃ ᅡ ᆯ
봉사	ᄇ ᅩ ᆼ ᄉ ᅡ
활동을	ᄒ ᅪ ᆯ ᄃ ᅩ ᆼ ᄋ ᅳ ᆯ
했데	ᄒ ᅢ ᆮ ᄄ ᅦ
힘들었지만	ᄒ ᅵ ᆷ ᄃ ᅳ ᄅ ᅥ ᆮ ᄍ ᅵ ᄆ ᅡ ᆫ
나눔의	ᄂ ᅡ ᄂ ᅮ ᄆ ᅴ
기쁨이란	ᄀ ᅵ ᄈ ᅳ ᄆ ᅵ ᄅ ᅡ ᆫ
신나게	ᄉ ᅵ ᆫ ᄂ ᅡ ᄀ ᅦ
즐길	ᄌ ᅳ ᆯ ᄀ ᅵ ᆯ
유럽	ᄋ ᅲ ᄅ ᅥ ᆸ
여행에	ᄋ ᅧ ᄒ ᅢ ᆼ ᄋ ᅦ
당첨됐다고요	ᄃ ᅡ ᆼ ᄎ ᅥ ᆷ ᄃ ᅫ ᆮ ᄄ ᅡ ᄀ ᅩ ᄋ ᅭ
나의	ᄂ ᅡ ᄋ ᅴ
고백을	ᄀ ᅩ ᄇ ᅢ ᄀ ᅳ ᆯ
받아줘서	ᄇ ᅡ ᄃ ᅡ ᄌ ᅯ ᄉ ᅥ
세상을	ᄉ ᅦ ᄉ ᅡ ᆼ ᄋ ᅳ ᆯ
가진	ᄀ ᅡ ᄌ ᅵ ᆫ
것만	ᄀ ᅥ ᆫ ᄆ ᅡ ᆫ
저에게	ᄌ ᅥ ᄋ ᅦ ᄀ ᅦ
올지는	ᄋ ᅩ ᆯ ᄌ ᅵ ᄂ ᅳ ᆫ
몰랐어요	ᄆ ᅩ ᆯ ᄅ ᅡ ᄊ ᅥ ᄋ ᅭ
이번에	ᄋ ᅵ ᄇ ᅥ ᄂ ᅦ
제대로	ᄌ ᅦ ᄃ ᅢ ᄅ ᅩ
횡재했어	ᄒ ᅬ ᆼ ᄌ ᅢ ᄒ ᅢ ᄊ ᅥ
가격도	ᄀ ᅡ ᄀ ᅧ ᆨ ᄄ ᅩ
가격이지만	ᄀ ᅡ ᄀ ᅧ ᄀ ᅵ ᄌ ᅵ ᄆ ᅡ ᆫ
원	ᄋ ᅯ ᆫ
플러스	ᄑ ᅳ ᆯ ᄅ ᅥ ᄉ ᅳ
원이지	ᄋ ᅯ ᄂ ᅵ ᄌ ᅵ
뭐야	ᄆ ᅯ ᄋ ᅣ
어떡해	ᄋ ᅥ ᄄ ᅥ ᄏ ᅢ
면접	ᄆ ᅧ ᆫ ᄌ ᅥ ᆸ
숨겨둔	ᄉ ᅮ ᆷ ᄀ ᅧ ᄃ ᅮ ᆫ
비상금도	ᄇ ᅵ ᄉ ᅡ ᆼ ᄀ ᅳ ᆷ ᄃ ᅩ
척해주고	ᄎ ᅥ ᄏ ᅢ ᄌ ᅮ ᄀ ᅩ
마누라	ᄆ ᅡ ᄂ ᅮ ᄅ ᅡ
최고	ᄎ ᅬ ᄀ ᅩ
들으니까	ᄃ ᅳ ᄅ ᅳ ᄂ ᅵ ᄁ ᅡ
아프다	ᄋ ᅡ ᄑ ᅳ ᄃ ᅡ
좋아했던	ᄌ ᅩ ᄋ ᅡ ᄒ ᅢ ᆮ ᄄ ᅥ ᆫ
배우였는데	ᄇ ᅢ ᄋ ᅮ ᄋ ᅧ ᆫ ᄂ ᅳ ᆫ ᄃ ᅦ
사고를	ᄉ ᅡ ᄀ ᅩ ᄅ ᅳ ᆯ
당했다니	ᄃ ᅡ ᆼ ᄒ ᅢ ᆮ ᄄ ᅡ ᄂ ᅵ
속상해	ᄉ ᅩ ᆨ ᄊ ᅡ ᆼ ᄒ ᅢ
입영	ᄋ ᅵ ᄇ ᅧ ᆼ
통지서를	ᄐ ᅩ ᆼ ᄌ ᅵ ᄉ ᅥ ᄅ ᅳ ᆯ
받았거든	ᄇ ᅡ ᄃ ᅡ ᆮ ᄁ ᅥ ᄃ ᅳ ᆫ
어머니가	ᄋ ᅥ ᄆ ᅥ ᄂ ᅵ ᄀ ᅡ
장례식에	ᄌ ᅡ ᆼ ᄂ ᅨ ᄉ ᅵ ᄀ ᅦ
다녀온	ᄃ ᅡ ᄂ ᅧ ᄋ ᅩ ᆫ
후로	ᄒ ᅮ ᄅ ᅩ
기운이	ᄀ ᅵ ᄋ ᅮ ᄂ ᅵ
없으셔서	ᄋ ᅥ ᆸ ᄊ ᅳ ᄉ ᅧ ᄉ ᅥ
걱정된다	ᄀ ᅥ ᆨ ᄍ ᅥ ᆼ ᄃ ᅬ ᆫ ᄃ ᅡ
선생님	ᄉ ᅥ ᆫ ᄉ ᅢ ᆼ ᄂ ᅵ ᆷ
애석한	ᄋ ᅢ ᄉ ᅥ ᄏ ᅡ ᆫ
금할	ᄀ ᅳ ᆷ ᄒ ᅡ ᆯ
길이	ᄀ ᅵ ᄅ ᅵ
너까지	ᄂ ᅥ ᄁ ᅡ ᄌ ᅵ
말할	ᄆ ᅡ ᆯ ᄒ ᅡ ᆯ
줄이야	ᄌ ᅮ ᄅ ᅵ ᄋ ᅣ
서럽다	ᄉ ᅥ ᄅ ᅥ ᆸ ᄄ ᅡ
위로가	ᄋ ᅱ ᄅ ᅩ ᄀ ᅡ
필요한데	ᄑ ᅵ ᄅ ᅭ ᄒ ᅡ ᆫ ᄃ ᅦ
없으니	ᄋ ᅥ ᆸ ᄊ ᅳ ᄂ ᅵ
울적해	ᄋ ᅮ ᆯ ᄌ ᅥ ᄏ ᅢ
본다고	ᄇ ᅩ ᆫ ᄃ ᅡ ᄀ ᅩ
눈물만	ᄂ ᅮ ᆫ ᄆ ᅮ ᆯ ᄆ ᅡ ᆫ
고시원에서도	ᄀ ᅩ ᄉ ᅵ ᄋ ᅯ ᄂ ᅦ ᄉ ᅥ ᄃ ᅩ
쫓겨나고	ᄍ ᅩ ᆮ ᄁ ᅧ ᄂ ᅡ ᄀ ᅩ
처지가	ᄎ ᅥ ᄌ ᅵ ᄀ ᅡ
서글퍼서	ᄉ ᅥ ᄀ ᅳ ᆯ ᄑ ᅥ ᄉ ᅥ
친구들	ᄎ ᅵ ᆫ ᄀ ᅮ ᄃ ᅳ ᆯ
집이나	ᄌ ᅵ ᄇ ᅵ ᄂ ᅡ
전전하는	ᄌ ᅥ ᆫ ᄌ ᅥ ᆫ ᄒ ᅡ ᄂ ᅳ ᆫ
신세가	ᄉ ᅵ ᆫ ᄉ ᅦ ᄀ ᅡ
처량하다	ᄎ ᅥ ᄅ ᅣ ᆼ ᄒ ᅡ ᄃ ᅡ
시골	ᄉ ᅵ ᄀ ᅩ ᆯ
보내주신	ᄇ ᅩ ᄂ ᅢ ᄌ ᅮ ᄉ ᅵ ᆫ
한약을	ᄒ ᅡ ᄂ ᅣ ᄀ ᅳ ᆯ
목이	ᄆ ᅩ ᄀ ᅵ
멘다	ᄆ ᅦ ᆫ ᄃ ᅡ
해준	ᄒ ᅢ ᄌ ᅮ ᆫ
얼만데	ᄋ ᅥ ᆯ ᄆ ᅡ ᆫ ᄃ ᅦ
섭섭하다	ᄉ ᅥ ᆸ ᄊ ᅥ ᄑ ᅡ ᄃ ᅡ
투병	ᄐ ᅮ ᄇ ᅧ ᆼ
중이시라는	ᄌ ᅮ ᆼ ᄋ ᅵ ᄉ ᅵ ᄅ ᅡ ᄂ ᅳ ᆫ
그분	ᄀ ᅳ ᄇ ᅮ ᆫ
부자는	ᄇ ᅮ ᄌ ᅡ ᄂ ᅳ ᆫ
망해도	ᄆ ᅡ ᆼ ᄒ ᅢ ᄃ ᅩ
삼대는	ᄉ ᅡ ᆷ ᄃ ᅢ ᄂ ᅳ ᆫ
간다던데	ᄀ ᅡ ᆫ ᄃ ᅡ ᄃ ᅥ ᆫ ᄃ ᅦ
사정이	ᄉ ᅡ ᄌ ᅥ ᆼ ᄋ ᅵ
딱하게	ᄄ ᅡ ᄏ ᅡ ᄀ ᅦ
됐어	ᄃ ᅫ ᄊ ᅥ
프로젝트가	ᄑ ᅳ ᄅ ᅩ ᄌ ᅦ ᆨ ᄐ ᅳ ᄀ ᅡ
무산됐다니	ᄆ ᅮ ᄉ ᅡ ᆫ ᄃ ᅫ ᆮ ᄄ ᅡ ᄂ ᅵ
다했는데	ᄃ ᅡ ᄒ ᅢ ᆫ ᄂ ᅳ ᆫ ᄃ ᅦ
안타깝다	ᄋ ᅡ ᆫ ᄐ ᅡ ᄁ ᅡ ᆸ ᄄ ᅡ
계약	ᄀ ᅨ ᄋ ᅣ ᆨ
종료인데	ᄌ ᅩ ᆼ ᄂ ᅭ ᄋ ᅵ ᆫ ᄃ ᅦ
모습이	ᄆ ᅩ ᄉ ᅳ ᄇ ᅵ
안쓰러워	ᄋ ᅡ ᆫ ᄊ ᅳ ᄅ ᅥ ᄋ ᅯ
죽겠어	ᄌ ᅮ ᆨ ᄁ ᅦ ᄊ ᅥ
주인이	ᄌ ᅮ ᄋ ᅵ ᄂ ᅵ
교통사고라며	ᄀ ᅭ ᄐ ᅩ ᆼ ᄉ ᅡ ᄀ ᅩ ᄅ ᅡ ᄆ ᅧ
불쌍해서	ᄇ ᅮ ᆯ ᄊ ᅡ ᆼ ᄒ ᅢ ᄉ ᅥ
또	ᄄ ᅩ
불합격	ᄇ ᅮ ᆯ ᄒ ᅡ ᆸ ᄁ ᅧ ᆨ
괴로워서	ᄀ ᅬ ᄅ ᅩ ᄋ ᅯ ᄉ ᅥ
숨이	ᄉ ᅮ ᄆ ᅵ
쉬어져	ᄉ ᅱ ᄋ ᅥ ᄌ ᅥ
술에	ᄉ ᅮ ᄅ ᅦ
취한	ᄎ ᅱ ᄒ ᅡ ᆫ
아버지의	ᄋ ᅡ ᄇ ᅥ ᄌ ᅵ ᄋ ᅴ
노랫가락이	ᄂ ᅩ ᄅ ᅢ ᆮ ᄁ ᅡ ᄅ ᅡ ᄀ ᅵ
오늘따라	ᄋ ᅩ ᄂ ᅳ ᆯ ᄄ ᅡ ᄅ ᅡ
구슬프게	ᄀ ᅮ ᄉ ᅳ ᆯ ᄑ ᅳ ᄀ ᅦ
들리네	ᄃ ᅳ ᆯ ᄅ ᅵ ᄂ ᅦ
결혼을	ᄀ ᅧ ᆯ ᄒ ᅩ ᄂ ᅳ ᆯ
하다니	ᄒ ᅡ ᄃ ᅡ ᄂ ᅵ
무너지는	ᄆ ᅮ ᄂ ᅥ ᄌ ᅵ ᄂ ᅳ ᆫ
탓인가	ᄐ ᅡ ᄉ ᅵ ᆫ ᄀ ᅡ
이상하게	ᄋ ᅵ ᄉ ᅡ ᆼ ᄒ ᅡ ᄀ ᅦ
축축	ᄎ ᅮ ᆨ ᄎ ᅮ ᆨ
처져요	ᄎ ᅥ ᄌ ᅥ ᄋ ᅭ
사고로	ᄉ ᅡ ᄀ ᅩ ᄅ ᅩ
분들을	ᄇ ᅮ ᆫ ᄃ ᅳ ᄅ ᅳ ᆯ
생각하면	ᄉ ᅢ ᆼ ᄀ ᅡ ᄏ ᅡ ᄆ ᅧ ᆫ
애석할	ᄋ ᅢ ᄉ ᅥ ᄏ ᅡ ᆯ
따름이야	ᄄ ᅡ ᄅ ᅳ ᄆ ᅵ ᄋ ᅣ
날	ᄂ ᅡ ᆯ
좋으련만	ᄌ ᅩ ᄋ ᅳ ᄅ ᅧ ᆫ ᄆ ᅡ ᆫ
아쉽다	ᄋ ᅡ ᄉ ᅱ ᆸ ᄄ ᅡ
병석에	ᄇ ᅧ ᆼ ᄉ ᅥ ᄀ ᅦ
이제	ᄋ ᅵ ᄌ ᅦ
화도	ᄒ ᅪ ᄃ ᅩ
다만	ᄃ ᅡ ᄆ ᅡ ᆫ
이렇게밖에	ᄋ ᅵ ᄅ ᅥ ᄏ ᅦ ᄇ ᅡ ᄁ ᅦ
못하는	ᄆ ᅩ ᄐ ᅡ ᄂ ᅳ ᆫ
자신에게	ᄌ ᅡ ᄉ ᅵ ᄂ ᅦ ᄀ ᅦ
실망스러울	ᄉ ᅵ ᆯ ᄆ ᅡ ᆼ ᄉ ᅳ ᄅ ᅥ ᄋ ᅮ ᆯ
뿐이야	ᄈ ᅮ ᄂ ᅵ ᄋ ᅣ
회색빛으로	ᄒ ᅬ ᄉ ᅢ ᆨ ᄈ ᅵ ᄎ ᅳ ᄅ ᅩ
가득한	ᄀ ᅡ ᄃ ᅳ ᄏ ᅡ ᆫ
마음처럼	ᄆ ᅡ ᄋ ᅳ ᆷ ᄎ ᅥ ᄅ ᅥ ᆷ
세상도	ᄉ ᅦ ᄉ ᅡ ᆼ ᄃ ᅩ
우중충해	ᄋ ᅮ ᄌ ᅮ ᆼ ᄎ ᅮ ᆼ ᄒ ᅢ
명절인데	ᄆ ᅧ ᆼ ᄌ ᅥ ᄅ ᅵ ᆫ ᄃ ᅦ
뵐	ᄇ ᅬ ᆯ
면목도	ᄆ ᅧ ᆫ ᄆ ᅩ ᆨ ᄄ ᅩ
없고	ᄋ ᅥ ᆸ ᄁ ᅩ
마음만	ᄆ ᅡ ᄋ ᅳ ᆷ ᄆ ᅡ ᆫ
무거워진다	ᄆ ᅮ ᄀ ᅥ ᄋ ᅯ ᄌ ᅵ ᆫ ᄃ ᅡ
기일이	ᄀ ᅵ ᄋ ᅵ ᄅ ᅵ
다가오니	ᄃ ᅡ ᄀ ᅡ ᄋ ᅩ ᄂ ᅵ
할머님	ᄒ ᅡ ᆯ ᄆ ᅥ ᄂ ᅵ ᆷ
나는구나	ᄂ ᅡ ᄂ ᅳ ᆫ ᄀ ᅮ ᄂ ᅡ
있으려니	ᄋ ᅵ ᄊ ᅳ ᄅ ᅧ ᄂ ᅵ
쓸쓸하다	ᄊ ᅳ ᆯ ᄊ ᅳ ᆯ ᄒ ᅡ ᄃ ᅡ
차라리	ᄎ ᅡ ᄅ ᅡ ᄅ ᅵ
아팠으면	ᄋ ᅡ ᄑ ᅡ ᄊ ᅳ ᄆ ᅧ ᆫ
잘하고	ᄌ ᅡ ᆯ ᄒ ᅡ ᄀ ᅩ
맘대로	ᄆ ᅡ ᆷ ᄃ ᅢ ᄅ ᅩ
되지	ᄃ ᅬ ᄌ ᅵ
않네	ᄋ ᅡ ᆫ ᄂ ᅦ
유리창	ᄋ ᅲ ᄅ ᅵ ᄎ ᅡ ᆼ
밖의	ᄇ ᅡ ᄁ ᅴ
저렇게	ᄌ ᅥ ᄅ ᅥ ᄏ ᅦ
행복할까	ᄒ ᅢ ᆼ ᄇ ᅩ ᄏ ᅡ ᆯ ᄁ ᅡ
가장의	ᄀ ᅡ ᄌ ᅡ ᆼ ᄋ ᅴ
무게에	ᄆ ᅮ ᄀ ᅦ ᄋ ᅦ
짓눌린	ᄌ ᅵ ᆫ ᄂ ᅮ ᆯ ᄅ ᅵ ᆫ
뒷모습이	ᄃ ᅱ ᆫ ᄆ ᅩ ᄉ ᅳ ᄇ ᅵ
애처로워	ᄋ ᅢ ᄎ ᅥ ᄅ ᅩ ᄋ ᅯ
민석이는	ᄆ ᅵ ᆫ ᄉ ᅥ ᄀ ᅵ ᄂ ᅳ ᆫ
이번에도	ᄋ ᅵ ᄇ ᅥ ᄂ ᅦ ᄃ ᅩ
서류	ᄉ ᅥ ᄅ ᅲ
심사에서	ᄉ ᅵ ᆷ ᄉ ᅡ ᄋ ᅦ ᄉ ᅥ
떨어졌대	ᄄ ᅥ ᄅ ᅥ ᄌ ᅥ ᆮ ᄄ ᅢ
축	ᄎ ᅮ ᆨ
처진	ᄎ ᅥ ᄌ ᅵ ᆫ
양	ᄋ ᅣ ᆼ
어깨를	ᄋ ᅥ ᄁ ᅢ ᄅ ᅳ ᆯ
그러고	ᄀ ᅳ ᄅ ᅥ ᄀ ᅩ
않은데	ᄋ ᅡ ᄂ ᅳ ᆫ ᄃ ᅦ
처지를	ᄎ ᅥ ᄌ ᅵ ᄅ ᅳ ᆯ
비관하게	ᄇ ᅵ ᄀ ᅪ ᆫ ᄒ ᅡ ᄀ ᅦ
팀원들	ᄐ ᅵ ᄆ ᅯ ᆫ ᄃ ᅳ ᆯ
기대했을	ᄀ ᅵ ᄃ ᅢ ᄒ ᅢ ᄊ ᅳ ᆯ
좋지	ᄌ ᅩ ᄎ ᅵ
무겁네요	ᄆ ᅮ ᄀ ᅥ ᆷ ᄂ ᅦ ᄋ ᅭ
와서	ᄋ ᅪ ᄉ ᅥ
했던	ᄒ ᅢ ᆮ ᄄ ᅥ ᆫ
건데	ᄀ ᅥ ᆫ ᄃ ᅦ
후회스러워	ᄒ ᅮ ᄒ ᅬ ᄉ ᅳ ᄅ ᅥ ᄋ ᅯ
낙담하지	ᄂ ᅡ ᆨ ᄄ ᅡ ᆷ ᄒ ᅡ ᄌ ᅵ
말라는	ᄆ ᅡ ᆯ ᄅ ᅡ ᄂ ᅳ ᆫ
들어도	ᄃ ᅳ ᄅ ᅥ ᄃ ᅩ
어쩔	ᄋ ᅥ ᄍ ᅥ ᆯ
진심	ᄌ ᅵ ᆫ ᄉ ᅵ ᆷ
죽고	ᄌ ᅮ ᆨ ᄁ ᅩ
아버지가	ᄋ ᅡ ᄇ ᅥ ᄌ ᅵ ᄀ ᅡ
보셨으면	ᄇ ᅩ ᄉ ᅧ ᄊ ᅳ ᄆ ᅧ ᆫ
좋아하셨을까	ᄌ ᅩ ᄋ ᅡ ᄒ ᅡ ᄉ ᅧ ᄊ ᅳ ᆯ ᄁ ᅡ
무너져	ᄆ ᅮ ᄂ ᅥ ᄌ ᅥ
내리는	ᄂ ᅢ ᄅ ᅵ ᄂ ᅳ ᆫ
언제쯤	ᄋ ᅥ ᆫ ᄌ ᅦ ᄍ ᅳ ᆷ
북녘의	ᄇ ᅮ ᆼ ᄂ ᅧ ᄏ ᅴ
고향	ᄀ ᅩ ᄒ ᅣ ᆼ
땅을	ᄄ ᅡ ᆼ ᄋ ᅳ ᆯ
보실	ᄇ ᅩ ᄉ ᅵ ᆯ
있을까	ᄋ ᅵ ᄊ ᅳ ᆯ ᄁ ᅡ
힘들게	ᄒ ᅵ ᆷ ᄃ ᅳ ᆯ ᄀ ᅦ
공모전인데	ᄀ ᅩ ᆼ ᄆ ᅩ ᄌ ᅥ ᄂ ᅵ ᆫ ᄃ ᅦ
발표를	ᄇ ᅡ ᆯ ᄑ ᅭ ᄅ ᅳ ᆯ
연기한다니	ᄋ ᅧ ᆫ ᄀ ᅵ ᄒ ᅡ ᆫ ᄃ ᅡ ᄂ ᅵ
맥	ᄆ ᅢ ᆨ
빠진다	ᄈ ᅡ ᄌ ᅵ ᆫ ᄃ ᅡ
지쳤어	ᄌ ᅵ ᄎ ᅥ ᄊ ᅥ
돌아왔으면	ᄃ ᅩ ᄅ ᅡ ᄋ ᅪ ᄊ ᅳ ᄆ ᅧ ᆫ
좋겠어	ᄌ ᅩ ᄏ ᅦ ᄊ ᅥ
이젠	ᄋ ᅵ ᄌ ᅦ ᆫ
힘들다	ᄒ ᅵ ᆷ ᄃ ᅳ ᆯ ᄃ ᅡ
한구석이	ᄒ ᅡ ᆫ ᄀ ᅮ ᄉ ᅥ ᄀ ᅵ
쓰라리고	ᄊ ᅳ ᄅ ᅡ ᄅ ᅵ ᄀ ᅩ
없이	ᄋ ᅥ ᆸ ᄊ ᅵ
끊지	ᄁ ᅳ ᆫ ᄎ ᅵ
인간관계	ᄋ ᅵ ᆫ ᄀ ᅡ ᆫ ᄀ ᅪ ᆫ ᄀ ᅨ
진이	ᄌ ᅵ ᄂ ᅵ
외로운	ᄋ ᅬ ᄅ ᅩ ᄋ ᅮ ᆫ
있지만	ᄋ ᅵ ᆮ ᄍ ᅵ ᄆ ᅡ ᆫ
둘인데도	ᄃ ᅮ ᄅ ᅵ ᆫ ᄃ ᅦ ᄃ ᅩ
모두에게	ᄆ ᅩ ᄃ ᅮ ᄋ ᅦ ᄀ ᅦ
불행이야	ᄇ ᅮ ᆯ ᄒ ᅢ ᆼ ᄋ ᅵ ᄋ ᅣ
그동안	ᄀ ᅳ ᄃ ᅩ ᆼ ᄋ ᅡ ᆫ
미안했다	ᄆ ᅵ ᄋ ᅡ ᆫ ᄒ ᅢ ᆮ ᄄ ᅡ
놓아줄게	ᄂ ᅩ ᄋ ᅡ ᄌ ᅮ ᆯ ᄀ ᅦ
넘게	ᄂ ᅥ ᆷ ᄁ ᅦ
동고동락했던	ᄃ ᅩ ᆼ ᄀ ᅩ ᄃ ᅩ ᆼ ᄂ ᅡ ᄏ ᅢ ᆮ ᄄ ᅥ ᆫ
고양이가	ᄀ ᅩ ᄋ ᅣ ᆼ ᄋ ᅵ ᄀ ᅡ
나가버렸어	ᄂ ᅡ ᄀ ᅡ ᄇ ᅥ ᄅ ᅧ ᄊ ᅥ
자란	ᄌ ᅡ ᄅ ᅡ ᆫ
강아지가	ᄀ ᅡ ᆼ ᄋ ᅡ ᄌ ᅵ ᄀ ᅡ
아파	ᄋ ᅡ ᄑ ᅡ
병문안을	ᄇ ᅧ ᆼ ᄆ ᅮ ᄂ ᅡ ᄂ ᅳ ᆯ
갔었는데	ᄀ ᅡ ᄊ ᅥ ᆫ ᄂ ᅳ ᆫ ᄃ ᅦ
우시는	ᄋ ᅮ ᄉ ᅵ ᄂ ᅳ ᆫ
봤어	ᄇ ᅪ ᄊ ᅥ
할머니	ᄒ ᅡ ᆯ ᄆ ᅥ ᄂ ᅵ
수술이	ᄉ ᅮ ᄉ ᅮ ᄅ ᅵ
됐나	ᄃ ᅫ ᆫ ᄂ ᅡ
고인이	ᄀ ᅩ ᄋ ᅵ ᄂ ᅵ
가시기를	ᄀ ᅡ ᄉ ᅵ ᄀ ᅵ ᄅ ᅳ ᆯ
기도하겠습니다	ᄀ ᅵ ᄃ ᅩ ᄒ ᅡ ᄀ ᅦ ᆮ ᄊ ᅳ ᆷ ᄂ ᅵ ᄃ ᅡ
추스르시고	ᄎ ᅮ ᄉ ᅳ ᄅ ᅳ ᄉ ᅵ ᄀ ᅩ
어서	ᄋ ᅥ ᄉ ᅥ
돌아오세요	ᄃ ᅩ ᄅ ᅡ ᄋ ᅩ ᄉ ᅦ ᄋ ᅭ
억울하게	ᄋ ᅥ ᄀ ᅮ ᆯ ᄒ ᅡ ᄀ ᅦ
희생당한	ᄒ ᅵ ᄉ ᅢ ᆼ ᄃ ᅡ ᆼ ᄒ ᅡ ᆫ
그분들을	ᄀ ᅳ ᄇ ᅮ ᆫ ᄃ ᅳ ᄅ ᅳ ᆯ
앞을	ᄋ ᅡ ᄑ ᅳ ᆯ
가린다	ᄀ ᅡ ᄅ ᅵ ᆫ ᄃ ᅡ
멈추지	ᄆ ᅥ ᆷ ᄎ ᅮ ᄌ ᅵ
눈물	ᄂ ᅮ ᆫ ᄆ ᅮ ᆯ
온	ᄋ ᅩ ᆫ
세상이	ᄉ ᅦ ᄉ ᅡ ᆼ ᄋ ᅵ
뿌옇게	ᄈ ᅮ ᄋ ᅧ ᄏ ᅦ
언제부터인가	ᄋ ᅥ ᆫ ᄌ ᅦ ᄇ ᅮ ᄐ ᅥ ᄋ ᅵ ᆫ ᄀ ᅡ
우울증이	ᄋ ᅮ ᄋ ᅮ ᆯ ᄌ ᅳ ᆼ ᄋ ᅵ
집어삼키는	ᄌ ᅵ ᄇ ᅥ ᄉ ᅡ ᆷ ᄏ ᅵ ᄂ ᅳ ᆫ
아직도	ᄋ ᅡ ᄌ ᅵ ᆨ ᄄ ᅩ
받는다고	ᄇ ᅡ ᆫ ᄂ ᅳ ᆫ ᄃ ᅡ ᄀ ᅩ
한심하게	ᄒ ᅡ ᆫ ᄉ ᅵ ᆷ ᄒ ᅡ ᄀ ᅦ
볼까	ᄇ ᅩ ᆯ ᄁ ᅡ
아픈	ᄋ ᅡ ᄑ ᅳ ᆫ
때문인	ᄄ ᅢ ᄆ ᅮ ᄂ ᅵ ᆫ
같아서	ᄀ ᅡ ᄐ ᅡ ᄉ ᅥ
미안해	ᄆ ᅵ ᄋ ᅡ ᆫ ᄒ ᅢ
풀	ᄑ ᅮ ᆯ
모습	ᄆ ᅩ ᄉ ᅳ ᆸ
보겠다	ᄇ ᅩ ᄀ ᅦ ᆮ ᄄ ᅡ
첫사랑이었던	ᄎ ᅥ ᆮ ᄊ ᅡ ᄅ ᅡ ᆼ ᄋ ᅵ ᄋ ᅥ ᆮ ᄄ ᅥ ᆫ
산산이	ᄉ ᅡ ᆫ ᄉ ᅡ ᄂ ᅵ
조각나는	ᄌ ᅩ ᄀ ᅡ ᆼ ᄂ ᅡ ᄂ ᅳ ᆫ
보내는	ᄇ ᅩ ᄂ ᅢ ᄂ ᅳ ᆫ
아니었는데	ᄋ ᅡ ᄂ ᅵ ᄋ ᅥ ᆫ ᄂ ᅳ ᆫ ᄃ ᅦ
미어지는구나	ᄆ ᅵ ᄋ ᅥ ᄌ ᅵ ᄂ ᅳ ᆫ ᄀ ᅮ ᄂ ᅡ
변호인으로서	ᄇ ᅧ ᆫ ᄒ ᅩ ᄋ ᅵ ᄂ ᅳ ᄅ ᅩ ᄉ ᅥ
참담한	ᄎ ᅡ ᆷ ᄃ ᅡ ᆷ ᄒ ᅡ ᆫ
심정을	ᄉ ᅵ ᆷ ᄌ ᅥ ᆼ ᄋ ᅳ ᆯ
이루	ᄋ ᅵ ᄅ ᅮ
화재로	ᄒ ᅪ ᄌ ᅢ ᄅ ᅩ
가족을	ᄀ ᅡ ᄌ ᅩ ᄀ ᅳ ᆯ
잃은	ᄋ ᅵ ᄅ ᅳ ᆫ
피해자들을	ᄑ ᅵ ᄒ ᅢ ᄌ ᅡ ᄃ ᅳ ᄅ ᅳ ᆯ
참으로	ᄎ ᅡ ᄆ ᅳ ᄅ ᅩ
비통한	ᄇ ᅵ ᄐ ᅩ ᆼ ᄒ ᅡ ᆫ
마음뿐입니다	ᄆ ᅡ ᄋ ᅳ ᆷ ᄈ ᅮ ᄂ ᅵ ᆷ ᄂ ᅵ ᄃ ᅡ
준비도	ᄌ ᅮ ᆫ ᄇ ᅵ ᄃ ᅩ
상실감이	ᄉ ᅡ ᆼ ᄉ ᅵ ᆯ ᄀ ᅡ ᄆ ᅵ
담임	ᄃ ᅡ ᄆ ᅵ ᆷ
선생님께서	ᄉ ᅥ ᆫ ᄉ ᅢ ᆼ ᄂ ᅵ ᆷ ᄁ ᅦ ᄉ ᅥ
편찮으시다고	ᄑ ᅧ ᆫ ᄎ ᅡ ᄂ ᅳ ᄉ ᅵ ᄃ ᅡ ᄀ ᅩ
들었습니다	ᄃ ᅳ ᄅ ᅥ ᆮ ᄊ ᅳ ᆷ ᄂ ᅵ ᄃ ᅡ
집안에	ᄌ ᅵ ᄇ ᅡ ᄂ ᅦ
우환이	ᄋ ᅮ ᄒ ᅪ ᄂ ᅵ
끊이지를	ᄁ ᅳ ᄂ ᅵ ᄌ ᅵ ᄅ ᅳ ᆯ
멍해졌어	ᄆ ᅥ ᆼ ᄒ ᅢ ᄌ ᅥ ᄊ ᅥ
동창회에서	ᄃ ᅩ ᆼ ᄎ ᅡ ᆼ ᄒ ᅬ ᄋ ᅦ ᄉ ᅥ
만난	ᄆ ᅡ ᆫ ᄂ ᅡ ᆫ
친구들을	ᄎ ᅵ ᆫ ᄀ ᅮ ᄃ ᅳ ᄅ ᅳ ᆯ
초라하고	ᄎ ᅩ ᄅ ᅡ ᄒ ᅡ ᄀ ᅩ
보잘것없었어	ᄇ ᅩ ᄌ ᅡ ᆯ ᄀ ᅥ ᄉ ᅥ ᆸ ᄊ ᅥ ᄊ ᅥ
한창	ᄒ ᅡ ᆫ ᄎ ᅡ ᆼ
회사를	ᄒ ᅬ ᄉ ᅡ ᄅ ᅳ ᆯ
떠나는	ᄄ ᅥ ᄂ ᅡ ᄂ ᅳ ᆫ
선배를	ᄉ ᅥ ᆫ ᄇ ᅢ ᄅ ᅳ ᆯ
보면서	ᄇ ᅩ ᄆ ᅧ ᆫ ᄉ ᅥ
안쓰러웠어	ᄋ ᅡ ᆫ ᄊ ᅳ ᄅ ᅥ ᄋ ᅯ ᄊ ᅥ
사랑하지만	ᄉ ᅡ ᄅ ᅡ ᆼ ᄒ ᅡ ᄌ ᅵ ᄆ ᅡ ᆫ
보내줘야	ᄇ ᅩ ᄂ ᅢ ᄌ ᅯ ᄋ ᅣ
그녀	ᄀ ᅳ ᄂ ᅧ
나려는	ᄂ ᅡ ᄅ ᅧ ᄂ ᅳ ᆫ
번이고	ᄇ ᅥ ᄂ ᅵ ᄀ ᅩ
참았어	ᄎ ᅡ ᄆ ᅡ ᄊ ᅥ
생활고로	ᄉ ᅢ ᆼ ᄒ ᅪ ᆯ ᄀ ᅩ ᄅ ᅩ
범죄자가	ᄇ ᅥ ᆷ ᄌ ᅬ ᄌ ᅡ ᄀ ᅡ
수밖에	ᄉ ᅮ ᄇ ᅡ ᄁ ᅦ
없었던	ᄋ ᅥ ᆸ ᄊ ᅥ ᆮ ᄄ ᅥ ᆫ
피의자를	ᄑ ᅵ ᄋ ᅴ ᄌ ᅡ ᄅ ᅳ ᆯ
측은해지더라	ᄎ ᅳ ᄀ ᅳ ᆫ ᄒ ᅢ ᄌ ᅵ ᄃ ᅥ ᄅ ᅡ
실험	ᄉ ᅵ ᆯ ᄒ ᅥ ᆷ
대상이	ᄃ ᅢ ᄉ ᅡ ᆼ ᄋ ᅵ
연구소에	ᄋ ᅧ ᆫ ᄀ ᅮ ᄉ ᅩ ᄋ ᅦ
갇혀	ᄀ ᅡ ᄐ ᅧ
동물들이	ᄃ ᅩ ᆼ ᄆ ᅮ ᆯ ᄃ ᅳ ᄅ ᅵ
불쌍해	ᄇ ᅮ ᆯ ᄊ ᅡ ᆼ ᄒ ᅢ
굶주림에	ᄀ ᅮ ᆷ ᄌ ᅮ ᄅ ᅵ ᄆ ᅦ
시달리는	ᄉ ᅵ ᄃ ᅡ ᆯ ᄅ ᅵ ᄂ ᅳ ᆫ
아프리카	ᄋ ᅡ ᄑ ᅳ ᄅ ᅵ ᄏ ᅡ
어린이들의	ᄋ ᅥ ᄅ ᅵ ᄂ ᅵ ᄃ ᅳ ᄅ ᅴ
처참했어	ᄎ ᅥ ᄎ ᅡ ᆷ ᄒ ᅢ ᄊ ᅥ
사고	ᄉ ᅡ ᄀ ᅩ
이후	ᄋ ᅵ ᄒ ᅮ
지금까지도	ᄌ ᅵ ᄀ ᅳ ᆷ ᄁ ᅡ ᄌ ᅵ ᄃ ᅩ
가족들	ᄀ ᅡ ᄌ ᅩ ᆨ ᄄ ᅳ ᆯ
슬픔에	ᄉ ᅳ ᆯ ᄑ ᅳ ᄆ ᅦ
잠겨	ᄌ ᅡ ᆷ ᄀ ᅧ
자식을	ᄌ ᅡ ᄉ ᅵ ᄀ ᅳ ᆯ
잃고	ᄋ ᅵ ᆯ ᄏ ᅩ
비탄에	ᄇ ᅵ ᄐ ᅡ ᄂ ᅦ
친구에게	ᄎ ᅵ ᆫ ᄀ ᅮ ᄋ ᅦ ᄀ ᅦ
위로를	ᄋ ᅱ ᄅ ᅩ ᄅ ᅳ ᆯ
해줘야	ᄒ ᅢ ᄌ ᅯ ᄋ ᅣ
할까	ᄒ ᅡ ᆯ ᄁ ᅡ
키우는	ᄏ ᅵ ᄋ ᅮ ᄂ ᅳ ᆫ
어찌나	ᄋ ᅥ ᄍ ᅵ ᄂ ᅡ
힘겨워	ᄒ ᅵ ᆷ ᄀ ᅧ ᄋ ᅯ
보이던지	ᄇ ᅩ ᄋ ᅵ ᄃ ᅥ ᆫ ᄌ ᅵ
하니	ᄒ ᅡ ᄂ ᅵ
암담하다	ᄋ ᅡ ᆷ ᄃ ᅡ ᆷ ᄒ ᅡ ᄃ ᅡ
버림받은	ᄇ ᅥ ᄅ ᅵ ᆷ ᄇ ᅡ ᄃ ᅳ ᆫ
줄도	ᄌ ᅮ ᆯ ᄃ ᅩ
모르고	ᄆ ᅩ ᄅ ᅳ ᄀ ᅩ
강아지의	ᄀ ᅡ ᆼ ᄋ ᅡ ᄌ ᅵ ᄋ ᅴ
가엾더라	ᄀ ᅡ ᄋ ᅧ ᆸ ᄄ ᅥ ᄅ ᅡ
늙어가시는	ᄂ ᅳ ᆯ ᄀ ᅥ ᄀ ᅡ ᄉ ᅵ ᄂ ᅳ ᆫ
서글퍼져	ᄉ ᅥ ᄀ ᅳ ᆯ ᄑ ᅥ ᄌ ᅥ
동생	ᄃ ᅩ ᆼ ᄉ ᅢ ᆼ
결혼식에서	ᄀ ᅧ ᆯ ᄒ ᅩ ᆫ ᄉ ᅵ ᄀ ᅦ ᄉ ᅥ
취급하던	ᄎ ᅱ ᄀ ᅳ ᄑ ᅡ ᄃ ᅥ ᆫ
서운했어	ᄉ ᅥ ᄋ ᅮ ᆫ ᄒ ᅢ ᄊ ᅥ
쌓아	ᄊ ᅡ ᄋ ᅡ
올린	ᄋ ᅩ ᆯ ᄅ ᅵ ᆫ
커리어보다	ᄏ ᅥ ᄅ ᅵ ᄋ ᅥ ᄇ ᅩ ᄃ ᅡ
여부가	ᄋ ᅧ ᄇ ᅮ ᄀ ᅡ
인생의	ᄋ ᅵ ᆫ ᄉ ᅢ ᆼ ᄋ ᅴ
성공	ᄉ ᅥ ᆼ ᄀ ᅩ ᆼ
잣대라니	ᄌ ᅡ ᆮ ᄄ ᅢ ᄅ ᅡ ᄂ ᅵ
허탈하다	ᄒ ᅥ ᄐ ᅡ ᆯ ᄒ ᅡ ᄃ ᅡ
믿고	ᄆ ᅵ ᆮ ᄁ ᅩ
야근도	ᄋ ᅣ ᄀ ᅳ ᆫ ᄃ ᅩ
마다하지	ᄆ ᅡ ᄃ ᅡ ᄒ ᅡ ᄌ ᅵ
않던	ᄋ ᅡ ᆫ ᄐ ᅥ ᆫ
팀원들에게	ᄐ ᅵ ᄆ ᅯ ᆫ ᄃ ᅳ ᄅ ᅦ ᄀ ᅦ
면목이	ᄆ ᅧ ᆫ ᄆ ᅩ ᄀ ᅵ
넘긴다면	ᄂ ᅥ ᆷ ᄀ ᅵ ᆫ ᄃ ᅡ ᄆ ᅧ ᆫ
자책하게	ᄌ ᅡ ᄎ ᅢ ᄏ ᅡ ᄀ ᅦ
좌절하고	ᄌ ᅪ ᄌ ᅥ ᆯ ᄒ ᅡ ᄀ ᅩ
않지만	ᄋ ᅡ ᆫ ᄎ ᅵ ᄆ ᅡ ᆫ
일어설	ᄋ ᅵ ᄅ ᅥ ᄉ ᅥ ᆯ
유기견	ᄋ ᅲ ᄀ ᅵ ᄀ ᅧ ᆫ
센터에서	ᄉ ᅦ ᆫ ᄐ ᅥ ᄋ ᅦ ᄉ ᅥ
강아지들의	ᄀ ᅡ ᆼ ᄋ ᅡ ᄌ ᅵ ᄃ ᅳ ᄅ ᅴ
애처로웠어	ᄋ ᅢ ᄎ ᅥ ᄅ ᅩ ᄋ ᅯ ᄊ ᅥ
매년	ᄆ ᅢ ᄂ ᅧ ᆫ
이맘때가	ᄋ ᅵ ᄆ ᅡ ᆷ ᄄ ᅢ ᄀ ᅡ
친구	ᄎ ᅵ ᆫ ᄀ ᅮ
생각에	ᄉ ᅢ ᆼ ᄀ ᅡ ᄀ ᅦ
코끝이	ᄏ ᅩ ᄁ ᅳ ᄉ ᅵ
시큰해져	ᄉ ᅵ ᄏ ᅳ ᆫ ᄒ ᅢ ᄌ ᅥ
손에서	ᄉ ᅩ ᄂ ᅦ ᄉ ᅥ
놓지	ᄂ ᅩ ᄎ ᅵ
부모님	ᄇ ᅮ ᄆ ᅩ ᄂ ᅵ ᆷ
먹먹해	ᄆ ᅥ ᆼ ᄆ ᅥ ᄏ ᅢ
그분의	ᄀ ᅳ ᄇ ᅮ ᄂ ᅴ
헌신에	ᄒ ᅥ ᆫ ᄉ ᅵ ᄂ ᅦ
감사하며	ᄀ ᅡ ᆷ ᄉ ᅡ ᄒ ᅡ ᄆ ᅧ
넋을	ᄂ ᅥ ᆨ ᄊ ᅳ ᆯ
위로하고자	ᄋ ᅱ ᄅ ᅩ ᄒ ᅡ ᄀ ᅩ ᄌ ᅡ
역사를	ᄋ ᅧ ᆨ ᄊ ᅡ ᄅ ᅳ ᆯ
잊은	ᄋ ᅵ ᄌ ᅳ ᆫ
민족에게	ᄆ ᅵ ᆫ ᄌ ᅩ ᄀ ᅦ ᄀ ᅦ
미래는	ᄆ ᅵ ᄅ ᅢ ᄂ ᅳ ᆫ
없다는	ᄋ ᅥ ᆸ ᄄ ᅡ ᄂ ᅳ ᆫ
말처럼	ᄆ ᅡ ᆯ ᄎ ᅥ ᄅ ᅥ ᆷ
지금의	ᄌ ᅵ ᄀ ᅳ ᄆ ᅴ
슬픔을	ᄉ ᅳ ᆯ ᄑ ᅳ ᄆ ᅳ ᆯ
기억합시다	ᄀ ᅵ ᄋ ᅥ ᄏ ᅡ ᆸ ᄊ ᅵ ᄃ ᅡ
눈시울이	ᄂ ᅮ ᆫ ᄉ ᅵ ᄋ ᅮ ᄅ ᅵ
붉어진	ᄇ ᅮ ᆯ ᄀ ᅥ ᄌ ᅵ ᆫ
동생은	ᄃ ᅩ ᆼ ᄉ ᅢ ᆼ ᄋ ᅳ ᆫ
어깨에	ᄋ ᅥ ᄁ ᅢ ᄋ ᅦ
기대어	ᄀ ᅵ ᄃ ᅢ ᄋ ᅥ
흐느껴	ᄒ ᅳ ᄂ ᅳ ᄁ ᅧ
울었다	ᄋ ᅮ ᄅ ᅥ ᆮ ᄄ ᅡ
숨죽여	ᄉ ᅮ ᆷ ᄌ ᅮ ᄀ ᅧ
남자의	ᄂ ᅡ ᆷ ᄌ ᅡ ᄋ ᅴ
어깨가	ᄋ ᅥ ᄁ ᅢ ᄀ ᅡ
들썩이는	ᄃ ᅳ ᆯ ᄊ ᅥ ᄀ ᅵ ᄂ ᅳ ᆫ
할머니의	ᄒ ᅡ ᆯ ᄆ ᅥ ᄂ ᅵ ᄋ ᅴ
영정	ᄋ ᅧ ᆼ ᄌ ᅥ ᆼ
대성통곡을	ᄃ ᅢ ᄉ ᅥ ᆼ ᄐ ᅩ ᆼ ᄀ ᅩ ᄀ ᅳ ᆯ
하셨어	ᄒ ᅡ ᄉ ᅧ ᄊ ᅥ
들을	ᄃ ᅳ ᄅ ᅳ ᆯ
때면	ᄄ ᅢ ᄆ ᅧ ᆫ
체한	ᄎ ᅦ ᄒ ᅡ ᆫ
것처럼	ᄀ ᅥ ᆮ ᄎ ᅥ ᄅ ᅥ ᆷ
명치끝이	ᄆ ᅧ ᆼ ᄎ ᅵ ᄁ ᅳ ᄉ ᅵ
아려와	ᄋ ᅡ ᄅ ᅧ ᄋ ᅪ
나이	ᄂ ᅡ ᄋ ᅵ
먹으면서	ᄆ ᅥ ᄀ ᅳ ᄆ ᅧ ᆫ ᄉ ᅥ
눈물샘이	ᄂ ᅮ ᆫ ᄆ ᅮ ᆯ ᄉ ᅢ ᄆ ᅵ
마른	ᄆ ᅡ ᄅ ᅳ ᆫ
알았는데	ᄋ ᅡ ᄅ ᅡ ᆫ ᄂ ᅳ ᆫ ᄃ ᅦ
아니었나	ᄋ ᅡ ᄂ ᅵ ᄋ ᅥ ᆫ ᄂ ᅡ
가수의	ᄀ ᅡ ᄉ ᅮ ᄋ ᅴ
절절하게	ᄌ ᅥ ᆯ ᄌ ᅥ ᆯ ᄒ ᅡ ᄀ ᅦ
파고들어	ᄑ ᅡ ᄀ ᅩ ᄃ ᅳ ᄅ ᅥ
가슴	ᄀ ᅡ ᄉ ᅳ ᆷ
시린	ᄉ ᅵ ᄅ ᅵ ᆫ
이별은	ᄋ ᅵ ᄇ ᅧ ᄅ ᅳ ᆫ
번으로	ᄇ ᅥ ᄂ ᅳ ᄅ ᅩ
족하다고	ᄌ ᅩ ᄏ ᅡ ᄃ ᅡ ᄀ ᅩ
생각했는데	ᄉ ᅢ ᆼ ᄀ ᅡ ᄏ ᅢ ᆫ ᄂ ᅳ ᆫ ᄃ ᅦ
아닌가	ᄋ ᅡ ᄂ ᅵ ᆫ ᄀ ᅡ
그리워	ᄀ ᅳ ᄅ ᅵ ᄋ ᅯ
아파요	ᄋ ᅡ ᄑ ᅡ ᄋ ᅭ
생각하지	ᄉ ᅢ ᆼ ᄀ ᅡ ᄏ ᅡ ᄌ ᅵ
않겠죠	ᄋ ᅡ ᆫ ᄏ ᅦ ᆮ ᄍ ᅭ
마지막이라는	ᄆ ᅡ ᄌ ᅵ ᄆ ᅡ ᄀ ᅵ ᄅ ᅡ ᄂ ᅳ ᆫ
슬픈	ᄉ ᅳ ᆯ ᄑ ᅳ ᆫ
억지	ᄋ ᅥ ᆨ ᄍ ᅵ
주장을	ᄌ ᅮ ᄌ ᅡ ᆼ ᄋ ᅳ ᆯ
있으니	ᄋ ᅵ ᄊ ᅳ ᄂ ᅵ
모양이지	ᄆ ᅩ ᄋ ᅣ ᆼ ᄋ ᅵ ᄌ ᅵ
코앞인데	ᄏ ᅩ ᄋ ᅡ ᄑ ᅵ ᆫ ᄃ ᅦ
공부는	ᄀ ᅩ ᆼ ᄇ ᅮ ᄂ ᅳ ᆫ
놀기만	ᄂ ᅩ ᆯ ᄀ ᅵ ᄆ ᅡ ᆫ
줄여달라는데	ᄌ ᅮ ᄅ ᅧ ᄃ ᅡ ᆯ ᄅ ᅡ ᄂ ᅳ ᆫ ᄃ ᅦ
그게	ᄀ ᅳ ᄀ ᅦ
어렵습니까	ᄋ ᅥ ᄅ ᅧ ᆸ ᄊ ᅳ ᆷ ᄂ ᅵ ᄁ ᅡ
결제	ᄀ ᅧ ᆯ ᄌ ᅦ
취소는	ᄎ ᅱ ᄉ ᅩ ᄂ ᅳ ᆫ
된다고	ᄃ ᅬ ᆫ ᄃ ᅡ ᄀ ᅩ
누누이	ᄂ ᅮ ᄂ ᅮ ᄋ ᅵ
말씀드렸을	ᄆ ᅡ ᆯ ᄊ ᅳ ᆷ ᄃ ᅳ ᄅ ᅧ ᄊ ᅳ ᆯ
텐데요	ᄐ ᅦ ᆫ ᄃ ᅦ ᄋ ᅭ
도대체	ᄃ ᅩ ᄃ ᅢ ᄎ ᅦ
말씀드려야	ᄆ ᅡ ᆯ ᄊ ᅳ ᆷ ᄃ ᅳ ᄅ ᅧ ᄋ ᅣ
끊으시겠습니까	ᄁ ᅳ ᄂ ᅳ ᄉ ᅵ ᄀ ᅦ ᆮ ᄊ ᅳ ᆷ ᄂ ᅵ ᄁ ᅡ
탈을	ᄐ ᅡ ᄅ ᅳ ᆯ
쓰고	ᄊ ᅳ ᄀ ᅩ
짓을	ᄌ ᅵ ᄉ ᅳ ᆯ
지하철에선	ᄌ ᅵ ᄒ ᅡ ᄎ ᅥ ᄅ ᅦ ᄉ ᅥ ᆫ
소리로	ᄉ ᅩ ᄅ ᅵ ᄅ ᅩ
통화하시면	ᄐ ᅩ ᆼ ᄒ ᅪ ᄒ ᅡ ᄉ ᅵ ᄆ ᅧ ᆫ
말씀드렸습니다	ᄆ ᅡ ᆯ ᄊ ᅳ ᆷ ᄃ ᅳ ᄅ ᅧ ᆮ ᄊ ᅳ ᆷ ᄂ ᅵ ᄃ ᅡ
속을	ᄉ ᅩ ᄀ ᅳ ᆯ
긁는	ᄀ ᅳ ᆼ ᄂ ᅳ ᆫ
있어야죠	ᄋ ᅵ ᄊ ᅥ ᄋ ᅣ ᄌ ᅭ
번만	ᄇ ᅥ ᆫ ᄆ ᅡ ᆫ
거짓말했다간	ᄀ ᅥ ᄌ ᅵ ᆫ ᄆ ᅡ ᆯ ᄒ ᅢ ᆮ ᄄ ᅡ ᄀ ᅡ ᆫ
그땐	ᄀ ᅳ ᄄ ᅢ ᆫ
혼날	ᄒ ᅩ ᆫ ᄂ ᅡ ᆯ
최소한	ᄎ ᅬ ᄉ ᅩ ᄒ ᅡ ᆫ
반성의	ᄇ ᅡ ᆫ ᄉ ᅥ ᆼ ᄋ ᅴ
기미는	ᄀ ᅵ ᄆ ᅵ ᄂ ᅳ ᆫ
보여야	ᄇ ᅩ ᄋ ᅧ ᄋ ᅣ
아닙니까	ᄋ ᅡ ᄂ ᅵ ᆷ ᄂ ᅵ ᄁ ᅡ
공금	ᄀ ᅩ ᆼ ᄀ ᅳ ᆷ
횡령에	ᄒ ᅬ ᆼ ᄂ ᅧ ᆼ ᄋ ᅦ
금품	ᄀ ᅳ ᆷ ᄑ ᅮ ᆷ
수수까지	ᄉ ᅮ ᄉ ᅮ ᄁ ᅡ ᄌ ᅵ
너무하네요	ᄂ ᅥ ᄆ ᅮ ᄒ ᅡ ᄂ ᅦ ᄋ ᅭ
보자	ᄇ ᅩ ᄌ ᅡ
싸우자는	ᄊ ᅡ ᄋ ᅮ ᄌ ᅡ ᄂ ᅳ ᆫ
좋으니까	ᄌ ᅩ ᄋ ᅳ ᄂ ᅵ ᄁ ᅡ
건드리지	ᄀ ᅥ ᆫ ᄃ ᅳ ᄅ ᅵ ᄌ ᅵ
일만	ᄋ ᅵ ᆯ ᄆ ᅡ ᆫ
분통이	ᄇ ᅮ ᆫ ᄐ ᅩ ᆼ ᄋ ᅵ
터진다고요	ᄐ ᅥ ᄌ ᅵ ᆫ ᄃ ᅡ ᄀ ᅩ ᄋ ᅭ
가만히	ᄀ ᅡ ᄆ ᅡ ᆫ ᄒ ᅵ
지긋지긋한	ᄌ ᅵ ᄀ ᅳ ᆮ ᄍ ᅵ ᄀ ᅳ ᄐ ᅡ ᆫ
잔소리	ᄌ ᅡ ᆫ ᄉ ᅩ ᄅ ᅵ
하세요	ᄒ ᅡ ᄉ ᅦ ᄋ ᅭ
저들의	ᄌ ᅥ ᄃ ᅳ ᄅ ᅴ
행태를	ᄒ ᅢ ᆼ ᄐ ᅢ ᄅ ᅳ ᆯ
피가	ᄑ ᅵ ᄀ ᅡ
거꾸로	ᄀ ᅥ ᄁ ᅮ ᄅ ᅩ
솟아요	ᄉ ᅩ ᄉ ᅡ ᄋ ᅭ
배웠다는	ᄇ ᅢ ᄋ ᅯ ᆮ ᄄ ᅡ ᄂ ᅳ ᆫ
저러고	ᄌ ᅥ ᄅ ᅥ ᄀ ᅩ
한심합니다	ᄒ ᅡ ᆫ ᄉ ᅵ ᆷ ᄒ ᅡ ᆷ ᄂ ᅵ ᄃ ᅡ
미치지	ᄆ ᅵ ᄎ ᅵ ᄌ ᅵ
않고서야	ᄋ ᅡ ᆫ ᄏ ᅩ ᄉ ᅥ ᄋ ᅣ
인간이	ᄋ ᅵ ᆫ ᄀ ᅡ ᄂ ᅵ
그럴	ᄀ ᅳ ᄅ ᅥ ᆯ
조언을	ᄌ ᅩ ᄋ ᅥ ᄂ ᅳ ᆯ
해줘도	ᄒ ᅢ ᄌ ᅯ ᄃ ᅩ
들은	ᄃ ᅳ ᄅ ᅳ ᆫ
척도	ᄎ ᅥ ᆨ ᄄ ᅩ
답답하다	ᄃ ᅡ ᆸ ᄄ ᅡ ᄑ ᅡ ᄃ ᅡ
생각으로	ᄉ ᅢ ᆼ ᄀ ᅡ ᄀ ᅳ ᄅ ᅩ
한심하다	ᄒ ᅡ ᆫ ᄉ ᅵ ᆷ ᄒ ᅡ ᄃ ᅡ
한심해	ᄒ ᅡ ᆫ ᄉ ᅵ ᆷ ᄒ ᅢ
가증스러운	ᄀ ᅡ ᄌ ᅳ ᆼ ᄉ ᅳ ᄅ ᅥ ᄋ ᅮ ᆫ
소름	ᄉ ᅩ ᄅ ᅳ ᆷ
끼치게	ᄁ ᅵ ᄎ ᅵ ᄀ ᅦ
싫어요	ᄉ ᅵ ᄅ ᅥ ᄋ ᅭ
한마디	ᄒ ᅡ ᆫ ᄆ ᅡ ᄃ ᅵ
꼴이	ᄁ ᅩ ᄅ ᅵ
우스워졌다고	ᄋ ᅮ ᄉ ᅳ ᄋ ᅯ ᄌ ᅥ ᆮ ᄄ ᅡ ᄀ ᅩ
알기나	ᄋ ᅡ ᆯ ᄀ ᅵ ᄂ ᅡ
공인이면	ᄀ ᅩ ᆼ ᄋ ᅵ ᄂ ᅵ ᄆ ᅧ ᆫ
공인답게	ᄀ ᅩ ᆼ ᄋ ᅵ ᆫ ᄃ ᅡ ᆸ ᄁ ᅦ
행동하셔야죠	ᄒ ᅢ ᆼ ᄃ ᅩ ᆼ ᄒ ᅡ ᄉ ᅧ ᄋ ᅣ ᄌ ᅭ
애를	ᄋ ᅢ ᄅ ᅳ ᆯ
때린다니	ᄄ ᅢ ᄅ ᅵ ᆫ ᄃ ᅡ ᄂ ᅵ
짐승만도	ᄌ ᅵ ᆷ ᄉ ᅳ ᆼ ᄆ ᅡ ᆫ ᄃ ᅩ
못한	ᄆ ᅩ ᄐ ᅡ ᆫ
사람들이네요	ᄉ ᅡ ᄅ ᅡ ᆷ ᄃ ᅳ ᄅ ᅵ ᄂ ᅦ ᄋ ᅭ
어쩜	ᄋ ᅥ ᄍ ᅥ ᆷ
뻔뻔한	ᄈ ᅥ ᆫ ᄈ ᅥ ᆫ ᄒ ᅡ ᆫ
태도로	ᄐ ᅢ ᄃ ᅩ ᄅ ᅩ
일관할	ᄋ ᅵ ᆯ ᄀ ᅪ ᆫ ᄒ ᅡ ᆯ
있죠	ᄋ ᅵ ᆮ ᄍ ᅭ
말해도	ᄆ ᅡ ᆯ ᄒ ᅢ ᄃ ᅩ
바뀌지	ᄇ ᅡ ᄁ ᅱ ᄌ ᅵ
않으니	ᄋ ᅡ ᄂ ᅳ ᄂ ᅵ
어떡해야	ᄋ ᅥ ᄄ ᅥ ᄏ ᅢ ᄋ ᅣ
합니까	ᄒ ᅡ ᆷ ᄂ ᅵ ᄁ ᅡ
사람에	ᄉ ᅡ ᄅ ᅡ ᄆ ᅦ
얘기라면	ᄋ ᅤ ᄀ ᅵ ᄅ ᅡ ᄆ ᅧ ᆫ
짜증	ᄍ ᅡ ᄌ ᅳ ᆼ
나게	ᄂ ᅡ ᄀ ᅦ
노트북이	ᄂ ᅩ ᄐ ᅳ ᄇ ᅮ ᄀ ᅵ
느리냐	ᄂ ᅳ ᄅ ᅵ ᄂ ᅣ
시비	ᄉ ᅵ ᄇ ᅵ
거는	ᄀ ᅥ ᄂ ᅳ ᆫ
놈들은	ᄂ ᅩ ᆷ ᄃ ᅳ ᄅ ᅳ ᆫ
아예	ᄋ ᅡ ᄋ ᅨ
상대하지	ᄉ ᅡ ᆼ ᄃ ᅢ ᄒ ᅡ ᄌ ᅵ
말아야	ᄆ ᅡ ᄅ ᅡ ᄋ ᅣ
동창회	ᄃ ᅩ ᆼ ᄎ ᅡ ᆼ ᄒ ᅬ
생각할수록	ᄉ ᅢ ᆼ ᄀ ᅡ ᄏ ᅡ ᆯ ᄊ ᅮ ᄅ ᅩ ᆨ
신경질이	ᄉ ᅵ ᆫ ᄀ ᅧ ᆼ ᄌ ᅵ ᄅ ᅵ
잘나서	ᄌ ᅡ ᆯ ᄅ ᅡ ᄉ ᅥ
멋대로야	ᄆ ᅥ ᆮ ᄄ ᅢ ᄅ ᅩ ᄋ ᅣ
한동안	ᄒ ᅡ ᆫ ᄃ ᅩ ᆼ ᄋ ᅡ ᆫ
자중하고	ᄌ ᅡ ᄌ ᅮ ᆼ ᄒ ᅡ ᄀ ᅩ
사나	ᄉ ᅡ ᄂ ᅡ
싶더니	ᄉ ᅵ ᆸ ᄄ ᅥ ᄂ ᅵ
또다시	ᄄ ᅩ ᄃ ᅡ ᄉ ᅵ
설치고	ᄉ ᅥ ᆯ ᄎ ᅵ ᄀ ᅩ
다니네	ᄃ ᅡ ᄂ ᅵ ᄂ ᅦ
영업장에서	ᄋ ᅧ ᆼ ᄋ ᅥ ᆸ ᄍ ᅡ ᆼ ᄋ ᅦ ᄉ ᅥ
하시는	ᄒ ᅡ ᄉ ᅵ ᄂ ᅳ ᆫ
처리	ᄎ ᅥ ᄅ ᅵ
이딴	ᄋ ᅵ ᄄ ᅡ ᆫ
거면	ᄀ ᅥ ᄆ ᅧ ᆫ
관두세요	ᄀ ᅪ ᆫ ᄃ ᅮ ᄉ ᅦ ᄋ ᅭ
방해하시면	ᄇ ᅡ ᆼ ᄒ ᅢ ᄒ ᅡ ᄉ ᅵ ᄆ ᅧ ᆫ
곤란합니다	ᄀ ᅩ ᆯ ᄅ ᅡ ᆫ ᄒ ᅡ ᆷ ᄂ ᅵ ᄃ ᅡ
이틀도	ᄋ ᅵ ᄐ ᅳ ᆯ ᄃ ᅩ
아니고	ᄋ ᅡ ᄂ ᅵ ᄀ ᅩ
상습범이네요	ᄉ ᅡ ᆼ ᄉ ᅳ ᆸ ᄈ ᅥ ᄆ ᅵ ᄂ ᅦ ᄋ ᅭ
폭언을	ᄑ ᅩ ᄀ ᅥ ᄂ ᅳ ᆯ
일삼는	ᄋ ᅵ ᆯ ᄉ ᅡ ᆷ ᄂ ᅳ ᆫ
당장	ᄃ ᅡ ᆼ ᄌ ᅡ ᆼ
잘라버려야	ᄌ ᅡ ᆯ ᄅ ᅡ ᄇ ᅥ ᄅ ᅧ ᄋ ᅣ
건물주의	ᄀ ᅥ ᆫ ᄆ ᅮ ᆯ ᄌ ᅮ ᄋ ᅴ
오만하고	ᄋ ᅩ ᄆ ᅡ ᆫ ᄒ ᅡ ᄀ ᅩ
태도에	ᄐ ᅢ ᄃ ᅩ ᄋ ᅦ
기가	ᄀ ᅵ ᄀ ᅡ
찹니다	ᄎ ᅡ ᆷ ᄂ ᅵ ᄃ ᅡ
사실이라면	ᄉ ᅡ ᄉ ᅵ ᄅ ᅵ ᄅ ᅡ ᄆ ᅧ ᆫ
가만	ᄀ ᅡ ᄆ ᅡ ᆫ
정치인들을	ᄌ ᅥ ᆼ ᄎ ᅵ ᄋ ᅵ ᆫ ᄃ ᅳ ᄅ ᅳ ᆯ
다들	ᄃ ᅡ ᄃ ᅳ ᆯ
잘났다고	ᄌ ᅡ ᆯ ᄅ ᅡ ᆮ ᄄ ᅡ ᄀ ᅩ
저러고들	ᄌ ᅥ ᄅ ᅥ ᄀ ᅩ ᄃ ᅳ ᆯ
없네	ᄋ ᅥ ᆷ ᄂ ᅦ
층간	ᄎ ᅳ ᆼ ᄀ ᅡ ᆫ
소음	ᄉ ᅩ ᄋ ᅳ ᆷ
열불이	ᄋ ᅧ ᆯ ᄇ ᅮ ᄅ ᅵ
도저히	ᄃ ᅩ ᄌ ᅥ ᄒ ᅵ
더는	ᄃ ᅥ ᄂ ᅳ ᆫ
참겠어요	ᄎ ᅡ ᆷ ᄁ ᅦ ᄊ ᅥ ᄋ ᅭ
지난	ᄌ ᅵ ᄂ ᅡ ᆫ
민박집에서	ᄆ ᅵ ᆫ ᄇ ᅡ ᆨ ᄍ ᅵ ᄇ ᅦ ᄉ ᅥ
지금도	ᄌ ᅵ ᄀ ᅳ ᆷ ᄃ ᅩ
음주운전은	ᄋ ᅳ ᆷ ᄌ ᅮ ᄋ ᅮ ᆫ ᄌ ᅥ ᄂ ᅳ ᆫ
본인뿐	ᄇ ᅩ ᄂ ᅵ ᆫ ᄈ ᅮ ᆫ
타인에게까지	ᄐ ᅡ ᄋ ᅵ ᄂ ᅦ ᄀ ᅦ ᄁ ᅡ ᄌ ᅵ
피해를	ᄑ ᅵ ᄒ ᅢ ᄅ ᅳ ᆯ
주는	ᄌ ᅮ ᄂ ᅳ ᆫ
강력범죄야	ᄀ ᅡ ᆼ ᄂ ᅧ ᆨ ᄈ ᅥ ᆷ ᄌ ᅬ ᄋ ᅣ
클럽에	ᄏ ᅳ ᆯ ᄅ ᅥ ᄇ ᅦ
갔다는	ᄀ ᅡ ᆮ ᄄ ᅡ ᄂ ᅳ ᆫ
배신감을	ᄇ ᅢ ᄉ ᅵ ᆫ ᄀ ᅡ ᄆ ᅳ ᆯ
느꼈어	ᄂ ᅳ ᄁ ᅧ ᄊ ᅥ
가게에	ᄀ ᅡ ᄀ ᅦ ᄋ ᅦ
갔는데	ᄀ ᅡ ᆫ ᄂ ᅳ ᆫ ᄃ ᅦ
육육	ᄋ ᅲ ᄀ ᅲ ᆨ
상했어	ᄉ ᅡ ᆼ ᄒ ᅢ ᄊ ᅥ
외모지상주의에	ᄋ ᅬ ᄆ ᅩ ᄌ ᅵ ᄉ ᅡ ᆼ ᄌ ᅮ ᄋ ᅴ ᄋ ᅦ
현대사회의	ᄒ ᅧ ᆫ ᄃ ᅢ ᄉ ᅡ ᄒ ᅬ ᄋ ᅴ
병폐를	ᄇ ᅧ ᆼ ᄑ ᅨ ᄅ ᅳ ᆯ
강력히	ᄀ ᅡ ᆼ ᄂ ᅧ ᄏ ᅵ
규탄한다	ᄀ ᅲ ᄐ ᅡ ᆫ ᄒ ᅡ ᆫ ᄃ ᅡ
쓰레기	ᄊ ᅳ ᄅ ᅦ ᄀ ᅵ
분리	ᄇ ᅮ ᆯ ᄅ ᅵ
수거를	ᄉ ᅮ ᄀ ᅥ ᄅ ᅳ ᆯ
하지	ᄒ ᅡ ᄌ ᅵ
이웃들	ᄋ ᅵ ᄋ ᅮ ᆮ ᄄ ᅳ ᆯ
아동학대	ᄋ ᅡ ᄃ ᅩ ᆼ ᄒ ᅡ ᆨ ᄄ ᅢ
뉴스를	ᄂ ᅲ ᄉ ᅳ ᄅ ᅳ ᆯ
분노가	ᄇ ᅮ ᆫ ᄂ ᅩ ᄀ ᅡ
끓어오른다니까	ᄁ ᅳ ᄅ ᅥ ᄋ ᅩ ᄅ ᅳ ᆫ ᄃ ᅡ ᄂ ᅵ ᄁ ᅡ
기념일을	ᄀ ᅵ ᄂ ᅧ ᄆ ᅵ ᄅ ᅳ ᆯ
잊어버린	ᄋ ᅵ ᄌ ᅥ ᄇ ᅥ ᄅ ᅵ ᆫ
남자친구의	ᄂ ᅡ ᆷ ᄌ ᅡ ᄎ ᅵ ᆫ ᄀ ᅮ ᄋ ᅴ
괘씸죄를	ᄀ ᅫ ᄊ ᅵ ᆷ ᄌ ᅬ ᄅ ᅳ ᆯ
뉴스에서	ᄂ ᅲ ᄉ ᅳ ᄋ ᅦ ᄉ ᅥ
센터에	ᄉ ᅦ ᆫ ᄐ ᅥ ᄋ ᅦ
개들을	ᄀ ᅢ ᄃ ᅳ ᄅ ᅳ ᆯ
봤는데	ᄇ ᅪ ᆫ ᄂ ᅳ ᆫ ᄃ ᅦ
불편하더라	ᄇ ᅮ ᆯ ᄑ ᅧ ᆫ ᄒ ᅡ ᄃ ᅥ ᄅ ᅡ
공원에	ᄀ ᅩ ᆼ ᄋ ᅯ ᄂ ᅦ
목줄도	ᄆ ᅩ ᆨ ᄍ ᅮ ᆯ ᄃ ᅩ
않은	ᄋ ᅡ ᄂ ᅳ ᆫ
개들이	ᄀ ᅢ ᄃ ᅳ ᄅ ᅵ
돌아다니는	ᄃ ᅩ ᄅ ᅡ ᄃ ᅡ ᄂ ᅵ ᄂ ᅳ ᆫ
불쾌해	ᄇ ᅮ ᆯ ᄏ ᅫ ᄒ ᅢ
교대	ᄀ ᅭ ᄃ ᅢ
시간마다	ᄉ ᅵ ᄀ ᅡ ᆫ ᄆ ᅡ ᄃ ᅡ
늦는	ᄂ ᅳ ᆫ ᄂ ᅳ ᆫ
동료에게	ᄃ ᅩ ᆼ ᄂ ᅭ ᄋ ᅦ ᄀ ᅦ
따끔하게	ᄄ ᅡ ᄁ ᅳ ᆷ ᄒ ᅡ ᄀ ᅦ
블로그에	ᄇ ᅳ ᆯ ᄅ ᅩ ᄀ ᅳ ᄋ ᅦ
나온	ᄂ ᅡ ᄋ ᅩ ᆫ
식당에	ᄉ ᅵ ᆨ ᄄ ᅡ ᆼ ᄋ ᅦ
갔다가	ᄀ ᅡ ᆮ ᄄ ᅡ ᄀ ᅡ
터무니없는	ᄐ ᅥ ᄆ ᅮ ᄂ ᅵ ᄋ ᅥ ᆷ ᄂ ᅳ ᆫ
비싼	ᄇ ᅵ ᄊ ᅡ ᆫ
가격을	ᄀ ᅡ ᄀ ᅧ ᄀ ᅳ ᆯ
어처구니가	ᄋ ᅥ ᄎ ᅥ ᄀ ᅮ ᄂ ᅵ ᄀ ᅡ
퇴근	ᄐ ᅬ ᄀ ᅳ ᆫ
후에도	ᄒ ᅮ ᄋ ᅦ ᄃ ᅩ
카톡으로	ᄏ ᅡ ᄐ ᅩ ᄀ ᅳ ᄅ ᅩ
업무지시를	ᄋ ᅥ ᆷ ᄆ ᅮ ᄌ ᅵ ᄉ ᅵ ᄅ ᅳ ᆯ
부장님	ᄇ ᅮ ᄌ ᅡ ᆼ ᄂ ᅵ ᆷ
폭발	ᄑ ᅩ ᆨ ᄈ ᅡ ᆯ
직전이야	ᄌ ᅵ ᆨ ᄍ ᅥ ᄂ ᅵ ᄋ ᅣ
소리를	ᄉ ᅩ ᄅ ᅵ ᄅ ᅳ ᆯ
소개팅에서	ᄉ ᅩ ᄀ ᅢ ᄐ ᅵ ᆼ ᄋ ᅦ ᄉ ᅥ
남자에게	ᄂ ᅡ ᆷ ᄌ ᅡ ᄋ ᅦ ᄀ ᅦ
거절	ᄀ ᅥ ᄌ ᅥ ᆯ
밝혔는데도	ᄇ ᅡ ᆯ ᄏ ᅧ ᆫ ᄂ ᅳ ᆫ ᄃ ᅦ ᄃ ᅩ
극장에서	ᄀ ᅳ ᆨ ᄍ ᅡ ᆼ ᄋ ᅦ ᄉ ᅥ
영화를	ᄋ ᅧ ᆼ ᄒ ᅪ ᄅ ᅳ ᆯ
보는데	ᄇ ᅩ ᄂ ᅳ ᆫ ᄃ ᅦ
뒷좌석에서	ᄃ ᅱ ᆮ ᄍ ᅪ ᄉ ᅥ ᄀ ᅦ ᄉ ᅥ
떠는	ᄄ ᅥ ᄂ ᅳ ᆫ
바람에	ᄇ ᅡ ᄅ ᅡ ᄆ ᅦ
집중을	ᄌ ᅵ ᆸ ᄍ ᅮ ᆼ ᄋ ᅳ ᆯ
사촌	ᄉ ᅡ ᄎ ᅩ ᆫ
결혼식에	ᄀ ᅧ ᆯ ᄒ ᅩ ᆫ ᄉ ᅵ ᄀ ᅦ
친척들의	ᄎ ᅵ ᆫ ᄎ ᅥ ᆨ ᄄ ᅳ ᄅ ᅴ
성화에	ᄉ ᅥ ᆼ ᄒ ᅪ ᄋ ᅦ
비참했어	ᄇ ᅵ ᄎ ᅡ ᆷ ᄒ ᅢ ᄊ ᅥ
불금이면	ᄇ ᅮ ᆯ ᄀ ᅳ ᄆ ᅵ ᄆ ᅧ ᆫ
뭐하냐고	ᄆ ᅯ ᄒ ᅡ ᄂ ᅣ ᄀ ᅩ
오늘도	ᄋ ᅩ ᄂ ᅳ ᆯ ᄃ ᅩ
야근이라	ᄋ ᅣ ᄀ ᅳ ᄂ ᅵ ᄅ ᅡ
있을지도	ᄋ ᅵ ᄊ ᅳ ᆯ ᄌ ᅵ ᄃ ᅩ
모르는데	ᄆ ᅩ ᄅ ᅳ ᄂ ᅳ ᆫ ᄃ ᅦ
술만	ᄉ ᅮ ᆯ ᄆ ᅡ ᆫ
끊기는	ᄁ ᅳ ᆫ ᄏ ᅵ ᄂ ᅳ ᆫ
남자친구에게	ᄂ ᅡ ᆷ ᄌ ᅡ ᄎ ᅵ ᆫ ᄀ ᅮ ᄋ ᅦ ᄀ ᅦ
최후	ᄎ ᅬ ᄒ ᅮ
통첩했어	ᄐ ᅩ ᆼ ᄎ ᅥ ᄑ ᅢ ᄊ ᅥ
드라마	ᄃ ᅳ ᄅ ᅡ ᄆ ᅡ
고구마	ᄀ ᅩ ᄀ ᅮ ᄆ ᅡ
전개에	ᄌ ᅥ ᆫ ᄀ ᅢ ᄋ ᅦ
답답해	ᄃ ᅡ ᆸ ᄄ ᅡ ᄑ ᅢ
죽는	ᄌ ᅮ ᆼ ᄂ ᅳ ᆫ
알았다니까	ᄋ ᅡ ᄅ ᅡ ᆮ ᄄ ᅡ ᄂ ᅵ ᄁ ᅡ
다닐	ᄃ ᅡ ᄂ ᅵ ᆯ
나보다	ᄂ ᅡ ᄇ ᅩ ᄃ ᅡ
공부도	ᄀ ᅩ ᆼ ᄇ ᅮ ᄃ ᅩ
못했던	ᄆ ᅩ ᄐ ᅢ ᆮ ᄄ ᅥ ᆫ
대기업에	ᄃ ᅢ ᄀ ᅵ ᄋ ᅥ ᄇ ᅦ
다닌다는	ᄃ ᅡ ᄂ ᅵ ᆫ ᄃ ᅡ ᄂ ᅳ ᆫ
솔직히	ᄉ ᅩ ᆯ ᄌ ᅵ ᄏ ᅵ
아팠어	ᄋ ᅡ ᄑ ᅡ ᄊ ᅥ
헤어진	ᄒ ᅦ ᄋ ᅥ ᄌ ᅵ ᆫ
연락해서	ᄋ ᅧ ᆯ ᄅ ᅡ ᄏ ᅢ ᄉ ᅥ
짜증나	ᄍ ᅡ ᄌ ᅳ ᆼ ᄂ ᅡ
아파트	ᄋ ᅡ ᄑ ᅡ ᄐ ᅳ
베란다에서	ᄇ ᅦ ᄅ ᅡ ᆫ ᄃ ᅡ ᄋ ᅦ ᄉ ᅥ
냄새가	ᄂ ᅢ ᆷ ᄉ ᅢ ᄀ ᅡ
올라오는	ᄋ ᅩ ᆯ ᄅ ᅡ ᄋ ᅩ ᄂ ᅳ ᆫ
신경이	ᄉ ᅵ ᆫ ᄀ ᅧ ᆼ ᄋ ᅵ
날카로워	ᄂ ᅡ ᆯ ᄏ ᅡ ᄅ ᅩ ᄋ ᅯ
연락도	ᄋ ᅧ ᆯ ᄅ ᅡ ᆨ ᄄ ᅩ
없던	ᄋ ᅥ ᆸ ᄄ ᅥ ᆫ
청첩장을	ᄎ ᅥ ᆼ ᄎ ᅥ ᆸ ᄍ ᅡ ᆼ ᄋ ᅳ ᆯ
보낸	ᄇ ᅩ ᄂ ᅢ ᆫ
얄밉던지	ᄋ ᅣ ᆯ ᄆ ᅵ ᆸ ᄄ ᅥ ᆫ ᄌ ᅵ
세상에서	ᄉ ᅦ ᄉ ᅡ ᆼ ᄋ ᅦ ᄉ ᅥ
갑질하는	ᄀ ᅡ ᆸ ᄍ ᅵ ᆯ ᄒ ᅡ ᄂ ᅳ ᆫ
기분에	ᄀ ᅵ ᄇ ᅮ ᄂ ᅦ
따라	ᄄ ᅡ ᄅ ᅡ
부하직원들을	ᄇ ᅮ ᄒ ᅡ ᄌ ᅵ ᄀ ᅯ ᆫ ᄃ ᅳ ᄅ ᅳ ᆯ
평가하는	ᄑ ᅧ ᆼ ᄀ ᅡ ᄒ ᅡ ᄂ ᅳ ᆫ
상사랑	ᄉ ᅡ ᆼ ᄉ ᅡ ᄅ ᅡ ᆼ
일하는	ᄋ ᅵ ᆯ ᄒ ᅡ ᄂ ᅳ ᆫ
고역이야	ᄀ ᅩ ᄋ ᅧ ᄀ ᅵ ᄋ ᅣ
나랑	ᄂ ᅡ ᄅ ᅡ ᆼ
헤어지고	ᄒ ᅦ ᄋ ᅥ ᄌ ᅵ ᄀ ᅩ
달도	ᄃ ᅡ ᆯ ᄃ ᅩ
여자랑	ᄋ ᅧ ᄌ ᅡ ᄅ ᅡ ᆼ
결혼이라니	ᄀ ᅧ ᆯ ᄒ ᅩ ᄂ ᅵ ᄅ ᅡ ᄂ ᅵ
복수할	ᄇ ᅩ ᆨ ᄊ ᅮ ᄒ ᅡ ᆯ
적반하장도	ᄌ ᅥ ᆨ ᄈ ᅡ ᆫ ᄒ ᅡ ᄌ ᅡ ᆼ ᄃ ᅩ
유분수지	ᄋ ᅲ ᄇ ᅮ ᆫ ᄉ ᅮ ᄌ ᅵ
불난	ᄇ ᅮ ᆯ ᄅ ᅡ ᆫ
부채질하냐	ᄇ ᅮ ᄎ ᅢ ᄌ ᅵ ᆯ ᄒ ᅡ ᄂ ᅣ
신입사원들한테	ᄉ ᅵ ᄂ ᅵ ᆸ ᄊ ᅡ ᄋ ᅯ ᆫ ᄃ ᅳ ᆯ ᄒ ᅡ ᆫ ᄐ ᅦ
잘해줬더니	ᄌ ᅡ ᆯ ᄒ ᅢ ᄌ ᅯ ᆮ ᄄ ᅥ ᄂ ᅵ
봤는지	ᄇ ᅪ ᆫ ᄂ ᅳ ᆫ ᄌ ᅵ
기어올라서	ᄀ ᅵ ᄋ ᅥ ᄋ ᅩ ᆯ ᄅ ᅡ ᄉ ᅥ
받아	ᄇ ᅡ ᄃ ᅡ
다이어트만	ᄃ ᅡ ᄋ ᅵ ᄋ ᅥ ᄐ ᅳ ᄆ ᅡ ᆫ
시작하면	ᄉ ᅵ ᄌ ᅡ ᄏ ᅡ ᄆ ᅧ ᆫ
야식을	ᄋ ᅣ ᄉ ᅵ ᄀ ᅳ ᆯ
먹는다니까	ᄆ ᅥ ᆼ ᄂ ᅳ ᆫ ᄃ ᅡ ᄂ ᅵ ᄁ ᅡ
왠수가	ᄋ ᅫ ᆫ ᄉ ᅮ ᄀ ᅡ
신은	ᄉ ᅵ ᄂ ᅳ ᆫ
불공평해	ᄇ ᅮ ᆯ ᄀ ᅩ ᆼ ᄑ ᅧ ᆼ ᄒ ᅢ
물만	ᄆ ᅮ ᆯ ᄆ ᅡ ᆫ
먹어도	ᄆ ᅥ ᄀ ᅥ ᄃ ᅩ
찌는	ᄍ ᅵ ᄂ ᅳ ᆫ
소개팅남	ᄉ ᅩ ᄀ ᅢ ᄐ ᅵ ᆼ ᄂ ᅡ ᆷ
트림한	ᄐ ᅳ ᄅ ᅵ ᆷ ᄒ ᅡ ᆫ
창피하고	ᄎ ᅡ ᆼ ᄑ ᅵ ᄒ ᅡ ᄀ ᅩ
신경질	ᄉ ᅵ ᆫ ᄀ ᅧ ᆼ ᄌ ᅵ ᆯ
독박	ᄃ ᅩ ᆨ ᄈ ᅡ ᆨ
육아로	ᄋ ᅲ ᄀ ᅡ ᄅ ᅩ
힘들어하는	ᄒ ᅵ ᆷ ᄃ ᅳ ᄅ ᅥ ᄒ ᅡ ᄂ ᅳ ᆫ
보니까	ᄇ ᅩ ᄂ ᅵ ᄁ ᅡ
남	ᄂ ᅡ ᆷ
같지	ᄀ ᅡ ᆮ ᄍ ᅵ
선배라고	ᄉ ᅥ ᆫ ᄇ ᅢ ᄅ ᅡ ᄀ ᅩ
무조건	ᄆ ᅮ ᄌ ᅩ ᄀ ᅥ ᆫ
후배들에게	ᄒ ᅮ ᄇ ᅢ ᄃ ᅳ ᄅ ᅦ ᄀ ᅦ
사주고	ᄉ ᅡ ᄌ ᅮ ᄀ ᅩ
사주는	ᄉ ᅡ ᄌ ᅮ ᄂ ᅳ ᆫ
화장실에서	ᄒ ᅪ ᄌ ᅡ ᆼ ᄉ ᅵ ᄅ ᅦ ᄉ ᅥ
뒷말	ᄃ ᅱ ᆫ ᄆ ᅡ ᆯ
잡히면	ᄌ ᅡ ᄑ ᅵ ᄆ ᅧ ᆫ
가만두지	ᄀ ᅡ ᄆ ᅡ ᆫ ᄃ ᅮ ᄌ ᅵ
애지중지	ᄋ ᅢ ᄌ ᅵ ᄌ ᅮ ᆼ ᄌ ᅵ
모아온	ᄆ ᅩ ᄋ ᅡ ᄋ ᅩ ᆫ
피겨를	ᄑ ᅵ ᄀ ᅧ ᄅ ᅳ ᆯ
조카에게	ᄌ ᅩ ᄏ ᅡ ᄋ ᅦ ᄀ ᅦ
줘버렸어	ᄌ ᅯ ᄇ ᅥ ᄅ ᅧ ᄊ ᅥ
회식	ᄒ ᅬ ᄉ ᅵ ᆨ
권하는	ᄀ ᅯ ᆫ ᄒ ᅡ ᄂ ᅳ ᆫ
상사들은	ᄉ ᅡ ᆼ ᄉ ᅡ ᄃ ᅳ ᄅ ᅳ ᆫ
선거철만	ᄉ ᅥ ᆫ ᄀ ᅥ ᄎ ᅥ ᆯ ᄆ ᅡ ᆫ
간이고	ᄀ ᅡ ᄂ ᅵ ᄀ ᅩ
쓸개고	ᄊ ᅳ ᆯ ᄀ ᅢ ᄀ ᅩ
내줄	ᄂ ᅢ ᄌ ᅮ ᆯ
구는	ᄀ ᅮ ᄂ ᅳ ᆫ
꼴불견이야	ᄁ ᅩ ᆯ ᄇ ᅮ ᆯ ᄀ ᅧ ᄂ ᅵ ᄋ ᅣ
운전하는	ᄋ ᅮ ᆫ ᄌ ᅥ ᆫ ᄒ ᅡ ᄂ ᅳ ᆫ
무단횡단하는	ᄆ ᅮ ᄃ ᅡ ᆫ ᄒ ᅬ ᆼ ᄃ ᅡ ᆫ ᄒ ᅡ ᄂ ᅳ ᆫ
몰상식한	ᄆ ᅩ ᆯ ᄊ ᅡ ᆼ ᄉ ᅵ ᄏ ᅡ ᆫ
감수했다니까	ᄀ ᅡ ᆷ ᄉ ᅮ ᄒ ᅢ ᆮ ᄄ ᅡ ᄂ ᅵ ᄁ ᅡ
초보	ᄎ ᅩ ᄇ ᅩ
운전자에	ᄋ ᅮ ᆫ ᄌ ᅥ ᆫ ᄌ ᅡ ᄋ ᅦ
배려는커녕	ᄇ ᅢ ᄅ ᅧ ᄂ ᅳ ᆫ ᄏ ᅥ ᄂ ᅧ ᆼ
난폭	ᄂ ᅡ ᆫ ᄑ ᅩ ᆨ
운전자들	ᄋ ᅮ ᆫ ᄌ ᅥ ᆫ ᄌ ᅡ ᄃ ᅳ ᆯ
운전대만	ᄋ ᅮ ᆫ ᄌ ᅥ ᆫ ᄃ ᅢ ᄆ ᅡ ᆫ
잡으면	ᄌ ᅡ ᄇ ᅳ ᄆ ᅧ ᆫ
흥분돼	ᄒ ᅳ ᆼ ᄇ ᅮ ᆫ ᄃ ᅫ
정규직이	ᄌ ᅥ ᆼ ᄀ ᅲ ᄌ ᅵ ᄀ ᅵ
못된	ᄆ ᅩ ᆮ ᄄ ᅬ ᆫ
미래를	ᄆ ᅵ ᄅ ᅢ ᄅ ᅳ ᆯ
고작	ᄀ ᅩ ᄌ ᅡ ᆨ
연봉을	ᄋ ᅧ ᆫ ᄇ ᅩ ᆼ ᄋ ᅳ ᆯ
받으려고	ᄇ ᅡ ᄃ ᅳ ᄅ ᅧ ᄀ ᅩ
고생했었나	ᄀ ᅩ ᄉ ᅢ ᆼ ᄒ ᅢ ᄊ ᅥ ᆫ ᄂ ᅡ
억울하고	ᄋ ᅥ ᄀ ᅮ ᆯ ᄒ ᅡ ᄀ ᅩ
메뉴를	ᄆ ᅦ ᄂ ᅲ ᄅ ᅳ ᆯ
본인	ᄇ ᅩ ᄂ ᅵ ᆫ
마음대로	ᄆ ᅡ ᄋ ᅳ ᆷ ᄃ ᅢ ᄅ ᅩ
결정하는	ᄀ ᅧ ᆯ ᄌ ᅥ ᆼ ᄒ ᅡ ᄂ ᅳ ᆫ
상사를	ᄉ ᅡ ᆼ ᄉ ᅡ ᄅ ᅳ ᆯ
못마땅해	ᄆ ᅩ ᆫ ᄆ ᅡ ᄄ ᅡ ᆼ ᄒ ᅢ
단골집이	ᄃ ᅡ ᆫ ᄀ ᅩ ᆯ ᄌ ᅵ ᄇ ᅵ
뉴스에	ᄂ ᅲ ᄉ ᅳ ᄋ ᅦ
불결한	ᄇ ᅮ ᆯ ᄀ ᅧ ᆯ ᄒ ᅡ ᆫ
식당이었다니	ᄉ ᅵ ᆨ ᄄ ᅡ ᆼ ᄋ ᅵ ᄋ ᅥ ᆮ ᄄ ᅡ ᄂ ᅵ
해도	ᄒ ᅢ ᄃ ᅩ
끼쳐	ᄁ ᅵ ᄎ ᅥ
바쁜	ᄇ ᅡ ᄈ ᅳ ᆫ
보험	ᄇ ᅩ ᄒ ᅥ ᆷ
판매	ᄑ ᅡ ᆫ ᄆ ᅢ
구내식당은	ᄀ ᅮ ᄂ ᅢ ᄉ ᅵ ᆨ ᄄ ᅡ ᆼ ᄋ ᅳ ᆫ
저렴하고	ᄌ ᅥ ᄅ ᅧ ᆷ ᄒ ᅡ ᄀ ᅩ
깨끗해서	ᄁ ᅢ ᄁ ᅳ ᄐ ᅢ ᄉ ᅥ
좋지만	ᄌ ᅩ ᄎ ᅵ ᄆ ᅡ ᆫ
메뉴가	ᄆ ᅦ ᄂ ᅲ ᄀ ᅡ
한결같아서	ᄒ ᅡ ᆫ ᄀ ᅧ ᆯ ᄀ ᅡ ᄐ ᅡ ᄉ ᅥ
시간인데도	ᄉ ᅵ ᄀ ᅡ ᄂ ᅵ ᆫ ᄃ ᅦ ᄃ ᅩ
자리만	ᄌ ᅡ ᄅ ᅵ ᄆ ᅡ ᆫ
지키고	ᄌ ᅵ ᄏ ᅵ ᄀ ᅩ
부장님이	ᄇ ᅮ ᄌ ᅡ ᆼ ᄂ ᅵ ᄆ ᅵ
야속해	ᄋ ᅣ ᄉ ᅩ ᄏ ᅢ
구두	ᄀ ᅮ ᄃ ᅮ
신었다고	ᄉ ᅵ ᄂ ᅥ ᆮ ᄄ ᅡ ᄀ ᅩ
난리를	ᄂ ᅡ ᆯ ᄅ ᅵ ᄅ ᅳ ᆯ
치는	ᄎ ᅵ ᄂ ᅳ ᆫ
얄밉더라	ᄋ ᅣ ᆯ ᄆ ᅵ ᆸ ᄄ ᅥ ᄅ ᅡ
이건	ᄋ ᅵ ᄀ ᅥ ᆫ
명백한	ᄆ ᅧ ᆼ ᄇ ᅢ ᄏ ᅡ ᆫ
살인	ᄉ ᅡ ᄅ ᅵ ᆫ
미수인데	ᄆ ᅵ ᄉ ᅮ ᄋ ᅵ ᆫ ᄃ ᅦ
처벌이	ᄎ ᅥ ᄇ ᅥ ᄅ ᅵ
약한	ᄋ ᅣ ᄏ ᅡ ᆫ
얘기만	ᄋ ᅤ ᄀ ᅵ ᄆ ᅡ ᆫ
나오면	ᄂ ᅡ ᄋ ᅩ ᄆ ᅧ ᆫ
꽁무니를	ᄁ ᅩ ᆼ ᄆ ᅮ ᄂ ᅵ ᄅ ᅳ ᆯ
남자친구	ᄂ ᅡ ᆷ ᄌ ᅡ ᄎ ᅵ ᆫ ᄀ ᅮ
한정판	ᄒ ᅡ ᆫ ᄌ ᅥ ᆼ ᄑ ᅡ ᆫ
샀다고	ᄉ ᅡ ᆮ ᄄ ᅡ ᄀ ᅩ
여자친구가	ᄋ ᅧ ᄌ ᅡ ᄎ ᅵ ᆫ ᄀ ᅮ ᄀ ᅡ
헤어지자고	ᄒ ᅦ ᄋ ᅥ ᄌ ᅵ ᄌ ᅡ ᄀ ᅩ
산이라더니	ᄉ ᅡ ᄂ ᅵ ᄅ ᅡ ᄃ ᅥ ᄂ ᅵ
대출	ᄃ ᅢ ᄎ ᅮ ᆯ
끝나고	ᄁ ᅳ ᆫ ᄂ ᅡ ᄀ ᅩ
결혼자금이	ᄀ ᅧ ᆯ ᄒ ᅩ ᆫ ᄌ ᅡ ᄀ ᅳ ᄆ ᅵ
써온	ᄊ ᅥ ᄋ ᅩ ᆫ
이력서만	ᄋ ᅵ ᄅ ᅧ ᆨ ᄊ ᅥ ᄆ ᅡ ᆫ
백장이	ᄇ ᅢ ᆨ ᄍ ᅡ ᆼ ᄋ ᅵ
넘는다구	ᄂ ᅥ ᆷ ᄂ ᅳ ᆫ ᄃ ᅡ ᄀ ᅮ
동창회에	ᄃ ᅩ ᆼ ᄎ ᅡ ᆼ ᄒ ᅬ ᄋ ᅦ
나밖에	ᄂ ᅡ ᄇ ᅡ ᄁ ᅦ
없더라구	ᄋ ᅥ ᆸ ᄄ ᅥ ᄅ ᅡ ᄀ ᅮ
젊어서	ᄌ ᅥ ᆯ ᄆ ᅥ ᄉ ᅥ
고생은	ᄀ ᅩ ᄉ ᅢ ᆼ ᄋ ᅳ ᆫ
사서도	ᄉ ᅡ ᄉ ᅥ ᄃ ᅩ
고생	ᄀ ᅩ ᄉ ᅢ ᆼ
끝이냐고	ᄁ ᅳ ᄉ ᅵ ᄂ ᅣ ᄀ ᅩ
만나서	ᄆ ᅡ ᆫ ᄂ ᅡ ᄉ ᅥ
형편	ᄒ ᅧ ᆼ ᄑ ᅧ ᆫ
알면서	ᄋ ᅡ ᆯ ᄆ ᅧ ᆫ ᄉ ᅥ
신혼살림을	ᄉ ᅵ ᆫ ᄒ ᅩ ᆫ ᄉ ᅡ ᆯ ᄅ ᅵ ᄆ ᅳ ᆯ
아파트에서	ᄋ ᅡ ᄑ ᅡ ᄐ ᅳ ᄋ ᅦ ᄉ ᅥ
시작해야	ᄉ ᅵ ᄌ ᅡ ᄏ ᅢ ᄋ ᅣ
고집을	ᄀ ᅩ ᄌ ᅵ ᄇ ᅳ ᆯ
피우는	ᄑ ᅵ ᄋ ᅮ ᄂ ᅳ ᆫ
호감을	ᄒ ᅩ ᄀ ᅡ ᄆ ᅳ ᆯ
만나는	ᄆ ᅡ ᆫ ᄂ ᅡ ᄂ ᅳ ᆫ
동료가	ᄃ ᅩ ᆼ ᄂ ᅭ ᄀ ᅡ
있는데	ᄋ ᅵ ᆫ ᄂ ᅳ ᆫ ᄃ ᅦ
진심을	ᄌ ᅵ ᆫ ᄉ ᅵ ᄆ ᅳ ᆯ
겉모습만	ᄀ ᅥ ᆫ ᄆ ᅩ ᄉ ᅳ ᆷ ᄆ ᅡ ᆫ
번지르르하면	ᄇ ᅥ ᆫ ᄌ ᅵ ᄅ ᅳ ᄅ ᅳ ᄒ ᅡ ᄆ ᅧ ᆫ
공중	ᄀ ᅩ ᆼ ᄌ ᅮ ᆼ
도덕도	ᄃ ᅩ ᄃ ᅥ ᆨ ᄄ ᅩ
지키는데	ᄌ ᅵ ᄏ ᅵ ᄂ ᅳ ᆫ ᄃ ᅦ
발표	ᄇ ᅡ ᆯ ᄑ ᅭ
자료는	ᄌ ᅡ ᄅ ᅭ ᄂ ᅳ ᆫ
회의	ᄒ ᅬ ᄋ ᅴ
메일로	ᄆ ᅦ ᄋ ᅵ ᆯ ᄅ ᅩ
보내주세요	ᄇ ᅩ ᄂ ᅢ ᄌ ᅮ ᄉ ᅦ ᄋ ᅭ
전염병을	ᄌ ᅥ ᄂ ᅧ ᆷ ᄇ ᅧ ᆼ ᄋ ᅳ ᆯ
예방하려면	ᄋ ᅨ ᄇ ᅡ ᆼ ᄒ ᅡ ᄅ ᅧ ᄆ ᅧ ᆫ
철저한	ᄎ ᅥ ᆯ ᄌ ᅥ ᄒ ᅡ ᆫ
소독과	ᄉ ᅩ ᄃ ᅩ ᆨ ᄁ ᅪ
멸균이	ᄆ ᅧ ᆯ ᄀ ᅲ ᄂ ᅵ
중요합니다	ᄌ ᅮ ᆼ ᄋ ᅭ ᄒ ᅡ ᆷ ᄂ ᅵ ᄃ ᅡ
노르웨이에	ᄂ ᅩ ᄅ ᅳ ᄋ ᅰ ᄋ ᅵ ᄋ ᅦ
가실	ᄀ ᅡ ᄉ ᅵ ᆯ
거라면	ᄀ ᅥ ᄅ ᅡ ᄆ ᅧ ᆫ
여행하기	ᄋ ᅧ ᄒ ᅢ ᆼ ᄒ ᅡ ᄀ ᅵ
계절이에요	ᄀ ᅨ ᄌ ᅥ ᄅ ᅵ ᄋ ᅦ ᄋ ᅭ
미국	ᄆ ᅵ ᄀ ᅮ ᆨ
하와이주	ᄒ ᅡ ᄋ ᅪ ᄋ ᅵ ᄌ ᅮ
하와이	ᄒ ᅡ ᄋ ᅪ ᄋ ᅵ
섬에서	ᄉ ᅥ ᄆ ᅦ ᄉ ᅥ
칠일째	ᄎ ᅵ ᄅ ᅵ ᆯ ᄍ ᅢ
화산	ᄒ ᅪ ᄉ ᅡ ᆫ
지진	ᄌ ᅵ ᄌ ᅵ ᆫ
활동이	ᄒ ᅪ ᆯ ᄃ ᅩ ᆼ ᄋ ᅵ
계속되고	ᄀ ᅨ ᄉ ᅩ ᆨ ᄄ ᅬ ᄀ ᅩ
덕수궁	ᄃ ᅥ ᆨ ᄊ ᅮ ᄀ ᅮ ᆼ
석조전은	ᄉ ᅥ ᆨ ᄍ ᅩ ᄌ ᅥ ᄂ ᅳ ᆫ
최초의	ᄎ ᅬ ᄎ ᅩ ᄋ ᅴ
서양식	ᄉ ᅥ ᄋ ᅣ ᆼ ᄉ ᅵ ᆨ
석조	ᄉ ᅥ ᆨ ᄍ ᅩ
건물로	ᄀ ᅥ ᆫ ᄆ ᅮ ᆯ ᄅ ᅩ
알려졌어	ᄋ ᅡ ᆯ ᄅ ᅧ ᄌ ᅥ ᄊ ᅥ
입춘은	ᄋ ᅵ ᆸ ᄎ ᅮ ᄂ ᅳ ᆫ
대한과	ᄃ ᅢ ᄒ ᅡ ᆫ ᄀ ᅪ
우수	ᄋ ᅮ ᄉ ᅮ
절기입니다	ᄌ ᅥ ᆯ ᄀ ᅵ ᄋ ᅵ ᆷ ᄂ ᅵ ᄃ ᅡ
아보카도는	ᄋ ᅡ ᄇ ᅩ ᄏ ᅡ ᄃ ᅩ ᄂ ᅳ ᆫ
멕시코가	ᄆ ᅦ ᆨ ᄊ ᅵ ᄏ ᅩ ᄀ ᅡ
원산지이고	ᄋ ᅯ ᆫ ᄉ ᅡ ᆫ ᄌ ᅵ ᄋ ᅵ ᄀ ᅩ
비타민과	ᄇ ᅵ ᄐ ᅡ ᄆ ᅵ ᆫ ᄀ ᅪ
미네랄이	ᄆ ᅵ ᄂ ᅦ ᄅ ᅡ ᄅ ᅵ
풍부한	ᄑ ᅮ ᆼ ᄇ ᅮ ᄒ ᅡ ᆫ
과일이에요	ᄀ ᅪ ᄋ ᅵ ᄅ ᅵ ᄋ ᅦ ᄋ ᅭ
오트밀은	ᄋ ᅩ ᄐ ᅳ ᄆ ᅵ ᄅ ᅳ ᆫ
식이섬유가	ᄉ ᅵ ᄀ ᅵ ᄉ ᅥ ᄆ ᅲ ᄀ ᅡ
풍부해서	ᄑ ᅮ ᆼ ᄇ ᅮ ᄒ ᅢ ᄉ ᅥ
대용으로도	ᄃ ᅢ ᄋ ᅭ ᆼ ᄋ ᅳ ᄅ ᅩ ᄃ ᅩ
좋아	ᄌ ᅩ ᄋ ᅡ
프랑스	ᄑ ᅳ ᄅ ᅡ ᆼ ᄉ ᅳ
인권	ᄋ ᅵ ᆫ ᄀ ᅯ ᆫ
선언은	ᄉ ᅥ ᄂ ᅥ ᄂ ᅳ ᆫ
천칠백팔십구년에	ᄎ ᅥ ᆫ ᄎ ᅵ ᆯ ᄇ ᅢ ᆨ ᄑ ᅡ ᆯ ᄉ ᅵ ᆸ ᄁ ᅮ ᄂ ᅧ ᄂ ᅦ
선포되었습니다	ᄉ ᅥ ᆫ ᄑ ᅩ ᄃ ᅬ ᄋ ᅥ ᆮ ᄊ ᅳ ᆷ ᄂ ᅵ ᄃ ᅡ
프로젝트	ᄑ ᅳ ᄅ ᅩ ᄌ ᅦ ᆨ ᄐ ᅳ
마무리되는	ᄆ ᅡ ᄆ ᅮ ᄅ ᅵ ᄃ ᅬ ᄂ ᅳ ᆫ
연락해	ᄋ ᅧ ᆯ ᄅ ᅡ ᄏ ᅢ
나눠드린	ᄂ ᅡ ᄂ ᅯ ᄃ ᅳ ᄅ ᅵ ᆫ
유인물은	ᄋ ᅲ ᄋ ᅵ ᆫ ᄆ ᅮ ᄅ ᅳ ᆫ
시간에도	ᄉ ᅵ ᄀ ᅡ ᄂ ᅦ ᄃ ᅩ
챙겨오세요	ᄎ ᅢ ᆼ ᄀ ᅧ ᄋ ᅩ ᄉ ᅦ ᄋ ᅭ
쓰신	ᄊ ᅳ ᄉ ᅵ ᆫ
컵은	ᄏ ᅥ ᄇ ᅳ ᆫ
두시면	ᄃ ᅮ ᄉ ᅵ ᄆ ᅧ ᆫ
흰	ᄒ ᅵ ᆫ
셔츠에	ᄉ ᅧ ᄎ ᅳ ᄋ ᅦ
검은	ᄀ ᅥ ᄆ ᅳ ᆫ
입었던	ᄋ ᅵ ᄇ ᅥ ᆮ ᄄ ᅥ ᆫ
말이지	ᄆ ᅡ ᄅ ᅵ ᄌ ᅵ
경에	ᄀ ᅧ ᆼ ᄋ ᅦ
들를	ᄃ ᅳ ᆯ ᄅ ᅳ ᆯ
자료	ᄌ ᅡ ᄅ ᅭ
조사할	ᄌ ᅩ ᄉ ᅡ ᄒ ᅡ ᆯ
테니까	ᄐ ᅦ ᄂ ᅵ ᄁ ᅡ
스크립트	ᄉ ᅳ ᄏ ᅳ ᄅ ᅵ ᆸ ᄐ ᅳ
작성은	ᄌ ᅡ ᆨ ᄊ ᅥ ᆼ ᄋ ᅳ ᆫ
맡아줘	ᄆ ᅡ ᄐ ᅡ ᄌ ᅯ
하숙집은	ᄒ ᅡ ᄉ ᅮ ᆨ ᄍ ᅵ ᄇ ᅳ ᆫ
대문이	ᄃ ᅢ ᄆ ᅮ ᄂ ᅵ
파란색인	ᄑ ᅡ ᄅ ᅡ ᆫ ᄉ ᅢ ᄀ ᅵ ᆫ
삼층짜리	ᄉ ᅡ ᆷ ᄎ ᅳ ᆼ ᄍ ᅡ ᄅ ᅵ
집이야	ᄌ ᅵ ᄇ ᅵ ᄋ ᅣ
쭉	ᄍ ᅮ ᆨ
가시다가	ᄀ ᅡ ᄉ ᅵ ᄃ ᅡ ᄀ ᅡ
교차로	ᄀ ᅭ ᄎ ᅡ ᄅ ᅩ
끼고	ᄁ ᅵ ᄀ ᅩ
도시면	ᄃ ᅩ ᄉ ᅵ ᄆ ᅧ ᆫ
보여요	ᄇ ᅩ ᄋ ᅧ ᄋ ᅭ
내일은	ᄂ ᅢ ᄋ ᅵ ᄅ ᅳ ᆫ
자폐인의	ᄌ ᅡ ᄑ ᅨ ᄋ ᅵ ᄂ ᅴ
날이니	ᄂ ᅡ ᄅ ᅵ ᄂ ᅵ
파란색	ᄑ ᅡ ᄅ ᅡ ᆫ ᄉ ᅢ ᆨ
티를	ᄐ ᅵ ᄅ ᅳ ᆯ
입고	ᄋ ᅵ ᆸ ᄁ ᅩ
오렴	ᄋ ᅩ ᄅ ᅧ ᆷ
주차장	ᄌ ᅮ ᄎ ᅡ ᄌ ᅡ ᆼ
바닥	ᄇ ᅡ ᄃ ᅡ ᆨ
공사가	ᄀ ᅩ ᆼ ᄉ ᅡ ᄀ ᅡ
예정되어	ᄋ ᅨ ᄌ ᅥ ᆼ ᄃ ᅬ ᄋ ᅥ
차량을	ᄎ ᅡ ᄅ ᅣ ᆼ ᄋ ᅳ ᆯ
이동시켜	ᄋ ᅵ ᄃ ᅩ ᆼ ᄉ ᅵ ᄏ ᅧ
기숙사	ᄀ ᅵ ᄉ ᅮ ᆨ ᄊ ᅡ
생활을	ᄉ ᅢ ᆼ ᄒ ᅪ ᄅ ᅳ ᆯ
때는	ᄄ ᅢ ᄂ ᅳ ᆫ
생활이	ᄉ ᅢ ᆼ ᄒ ᅪ ᄅ ᅵ
규칙적이었어	ᄀ ᅲ ᄎ ᅵ ᆨ ᄍ ᅥ ᄀ ᅵ ᄋ ᅥ ᄊ ᅥ
최	ᄎ ᅬ
대리	ᄃ ᅢ ᄅ ᅵ
거래처에서	ᄀ ᅥ ᄅ ᅢ ᄎ ᅥ ᄋ ᅦ ᄉ ᅥ
장소	ᄌ ᅡ ᆼ ᄉ ᅩ
관련	ᄀ ᅪ ᆯ ᄅ ᅧ ᆫ
메일을	ᄆ ᅦ ᄋ ᅵ ᄅ ᅳ ᆯ
보냈더라	ᄇ ᅩ ᄂ ᅢ ᆮ ᄄ ᅥ ᄅ ᅡ
민주주의	ᄆ ᅵ ᆫ ᄌ ᅮ ᄌ ᅮ ᄋ ᅴ
국가의	ᄀ ᅮ ᆨ ᄁ ᅡ ᄋ ᅴ
주인은	ᄌ ᅮ ᄋ ᅵ ᄂ ᅳ ᆫ
국민입니다	ᄀ ᅮ ᆼ ᄆ ᅵ ᄂ ᅵ ᆷ ᄂ ᅵ ᄃ ᅡ
버스에는	ᄇ ᅥ ᄉ ᅳ ᄋ ᅦ ᄂ ᅳ ᆫ
컵에	ᄏ ᅥ ᄇ ᅦ
담긴	ᄃ ᅡ ᆷ ᄀ ᅵ ᆫ
음료를	ᄋ ᅳ ᆷ ᄂ ᅭ ᄅ ᅳ ᆯ
결제가	ᄀ ᅧ ᆯ ᄌ ᅦ ᄀ ᅡ
정상적으로	ᄌ ᅥ ᆼ ᄉ ᅡ ᆼ ᄌ ᅥ ᄀ ᅳ ᄅ ᅩ
정보	ᄌ ᅥ ᆼ ᄇ ᅩ
보호를	ᄇ ᅩ ᄒ ᅩ ᄅ ᅳ ᆯ
주기적으로	ᄌ ᅮ ᄀ ᅵ ᄌ ᅥ ᄀ ᅳ ᄅ ᅩ
비밀번호를	ᄇ ᅵ ᄆ ᅵ ᆯ ᄇ ᅥ ᆫ ᄒ ᅩ ᄅ ᅳ ᆯ
변경해	ᄇ ᅧ ᆫ ᄀ ᅧ ᆼ ᄒ ᅢ
손해보험	ᄉ ᅩ ᆫ ᄒ ᅢ ᄇ ᅩ ᄒ ᅥ ᆷ
홈페이지	ᄒ ᅩ ᆷ ᄑ ᅦ ᄋ ᅵ ᄌ ᅵ
회원이	ᄒ ᅬ ᄋ ᅯ ᄂ ᅵ
되신	ᄃ ᅬ ᄉ ᅵ ᆫ
환영합니다	ᄒ ᅪ ᄂ ᅧ ᆼ ᄒ ᅡ ᆷ ᄂ ᅵ ᄃ ᅡ
공모에	ᄀ ᅩ ᆼ ᄆ ᅩ ᄋ ᅦ
응모해	ᄋ ᅳ ᆼ ᄆ ᅩ ᄒ ᅢ
폭염	ᄑ ᅩ ᄀ ᅧ ᆷ
수준의	ᄉ ᅮ ᄌ ᅮ ᄂ ᅴ
더위가	ᄃ ᅥ ᄋ ᅱ ᄀ ᅡ
누그러지겠습니다	ᄂ ᅮ ᄀ ᅳ ᄅ ᅥ ᄌ ᅵ ᄀ ᅦ ᆮ ᄊ ᅳ ᆷ ᄂ ᅵ ᄃ ᅡ
피부	ᄑ ᅵ ᄇ ᅮ
노화를	ᄂ ᅩ ᄒ ᅪ ᄅ ᅳ ᆯ
유수분	ᄋ ᅲ ᄉ ᅮ ᄇ ᅮ ᆫ
균형에	ᄀ ᅲ ᆫ ᄒ ᅧ ᆼ ᄋ ᅦ
신경	ᄉ ᅵ ᆫ ᄀ ᅧ ᆼ
쓰셔야	ᄊ ᅳ ᄉ ᅧ ᄋ ᅣ
심폐소생술	ᄉ ᅵ ᆷ ᄑ ᅨ ᄉ ᅩ ᄉ ᅢ ᆼ ᄉ ᅮ ᆯ
자격증	ᄌ ᅡ ᄀ ᅧ ᆨ ᄍ ᅳ ᆼ
취득을	ᄎ ᅱ ᄃ ᅳ ᄀ ᅳ ᆯ
원하시면	ᄋ ᅯ ᆫ ᄒ ᅡ ᄉ ᅵ ᄆ ᅧ ᆫ
인터넷으로	ᄋ ᅵ ᆫ ᄐ ᅥ ᄂ ᅦ ᄉ ᅳ ᄅ ᅩ
신청해	ᄉ ᅵ ᆫ ᄎ ᅥ ᆼ ᄒ ᅢ
주연	ᄌ ᅮ ᄋ ᅧ ᆫ
배우	ᄇ ᅢ ᄋ ᅮ
캐스팅이	ᄏ ᅢ ᄉ ᅳ ᄐ ᅵ ᆼ ᄋ ᅵ
촬영을	ᄎ ᅪ ᄅ ᅧ ᆼ ᄋ ᅳ ᆯ
관계자	ᄀ ᅪ ᆫ ᄀ ᅨ ᄌ ᅡ
회의실로	ᄒ ᅬ ᄋ ᅴ ᄉ ᅵ ᆯ ᄅ ᅩ
들어와	ᄃ ᅳ ᄅ ᅥ ᄋ ᅪ
현재	ᄒ ᅧ ᆫ ᄌ ᅢ
사건과	ᄉ ᅡ ᄀ ᅥ ᆫ ᄀ ᅪ
관련하여	ᄀ ᅪ ᆯ ᄅ ᅧ ᆫ ᄒ ᅡ ᄋ ᅧ
내부	ᄂ ᅢ ᄇ ᅮ
감사를	ᄀ ᅡ ᆷ ᄉ ᅡ ᄅ ᅳ ᆯ
진행하고	ᄌ ᅵ ᆫ ᄒ ᅢ ᆼ ᄒ ᅡ ᄀ ᅩ
불국사와	ᄇ ᅮ ᆯ ᄀ ᅮ ᆨ ᄊ ᅡ ᄋ ᅪ
석굴암은	ᄉ ᅥ ᆨ ᄁ ᅮ ᄅ ᅡ ᄆ ᅳ ᆫ
유네스코	ᄋ ᅲ ᄂ ᅦ ᄉ ᅳ ᄏ ᅩ
세계문화유산으로	ᄉ ᅦ ᄀ ᅨ ᄆ ᅮ ᆫ ᄒ ᅪ ᄋ ᅲ ᄉ ᅡ ᄂ ᅳ ᄅ ᅩ
등재되어	ᄃ ᅳ ᆼ ᄌ ᅢ ᄃ ᅬ ᄋ ᅥ
회의에	ᄒ ᅬ ᄋ ᅴ ᄋ ᅦ
이번엔	ᄋ ᅵ ᄇ ᅥ ᄂ ᅦ ᆫ
플러쓰	ᄑ ᅳ ᆯ ᄅ ᅥ ᄊ ᅳ
족하다구	ᄌ ᅩ ᄏ ᅡ ᄃ ᅡ ᄀ ᅮ
아니구	ᄋ ᅡ ᄂ ᅵ ᄀ ᅮ
끝이냐구	ᄁ ᅳ ᄉ ᅵ ᄂ ᅣ ᄀ ᅮ
연락주세요	ᄋ ᅧ ᆯ ᄅ ᅡ ᆨ ᄍ ᅮ ᄉ ᅦ ᄋ ᅭ
들릴	ᄃ ᅳ ᆯ ᄅ ᅵ ᆯ
포식자라고	ᄑ ᅩ ᄉ ᅵ ᆨ ᄍ ᅡ ᄅ ᅡ ᄀ ᅩ
일곱에서	ᄋ ᅵ ᆯ ᄀ ᅩ ᄇ ᅦ ᄉ ᅥ
경치도	ᄀ ᅧ ᆼ ᄎ ᅵ ᄃ ᅩ
누굴	ᄂ ᅮ ᄀ ᅮ ᆯ
재미있게	ᄌ ᅢ ᄆ ᅵ ᄋ ᅵ ᆮ ᄁ ᅦ
먹먹해져	ᄆ ᅥ ᆼ ᄆ ᅥ ᄏ ᅢ ᄌ ᅥ
그리워하는	ᄀ ᅳ ᄅ ᅵ ᄋ ᅯ ᄒ ᅡ ᄂ ᅳ ᆫ
가증스런	ᄀ ᅡ ᄌ ᅳ ᆼ ᄉ ᅳ ᄅ ᅥ ᆫ
있을지	ᄋ ᅵ ᄊ ᅳ ᆯ ᄌ ᅵ
뵙지요	ᄇ ᅬ ᆸ ᄍ ᅵ ᄋ ᅭ
했는데	ᄒ ᅢ ᆫ ᄂ ᅳ ᆫ ᄃ ᅦ
정치인들	ᄌ ᅥ ᆼ ᄎ ᅵ ᄋ ᅵ ᆫ ᄃ ᅳ ᆯ
넘는다고	ᄂ ᅥ ᆷ ᄂ ᅳ ᆫ ᄃ ᅡ ᄀ ᅩ
없더라고	ᄋ ᅥ ᆸ ᄄ ᅥ ᄅ ᅡ ᄀ ᅩ
손님은	ᄉ ᅩ ᆫ ᄂ ᅵ ᄆ ᅳ ᆫ
들었다구요	ᄃ ᅳ ᄅ ᅥ ᆮ ᄄ ᅡ ᄀ ᅮ ᄋ ᅭ
당첨됐다구요	ᄃ ᅡ ᆼ ᄎ ᅥ ᆷ ᄃ ᅫ ᆮ ᄄ ᅡ ᄀ ᅮ ᄋ ᅭ
아버님의	ᄋ ᅡ ᄇ ᅥ ᄂ ᅵ ᄆ ᅴ
것두	ᄀ ᅥ ᆮ ᄄ ᅮ
싶지만	ᄉ ᅵ ᆸ ᄍ ᅵ ᄆ ᅡ ᆫ
시간에서	ᄉ ᅵ ᄀ ᅡ ᄂ ᅦ ᄉ ᅥ
죽구	ᄌ ᅮ ᆨ ᄁ ᅮ
사주구	ᄉ ᅡ ᄌ ᅮ ᄀ ᅮ
니	ᄂ ᅵ
아기가	ᄋ ᅡ ᄀ ᅵ ᄀ ᅡ
풀죽은	ᄑ ᅮ ᆯ ᄌ ᅮ ᄀ ᅳ ᆫ
마디	ᄆ ᅡ ᄃ ᅵ
하실	ᄒ ᅡ ᄉ ᅵ ᆯ
울구	ᄋ ᅮ ᆯ ᄀ ᅮ
무너진	ᄆ ᅮ ᄂ ᅥ ᄌ ᅵ ᆫ
알구	ᄋ ᅡ ᆯ ᄀ ᅮ
비닐봉지	ᄇ ᅵ ᄂ ᅵ ᆯ ᄇ ᅩ ᆼ ᄌ ᅵ
건강검진이	ᄀ ᅥ ᆫ ᄀ ᅡ ᆼ ᄀ ᅥ ᆷ ᄌ ᅵ ᄂ ᅵ
증명서를	ᄌ ᅳ ᆼ ᄆ ᅧ ᆼ ᄉ ᅥ ᄅ ᅳ ᆯ
주시구	ᄌ ᅮ ᄉ ᅵ ᄀ ᅮ
몰라두	ᄆ ᅩ ᆯ ᄅ ᅡ ᄃ ᅮ
쥐구멍에	ᄌ ᅱ ᄀ ᅮ ᄆ ᅥ ᆼ ᄋ ᅦ
그치구	ᄀ ᅳ ᄎ ᅵ ᄀ ᅮ
정신이	ᄌ ᅥ ᆼ ᄉ ᅵ ᄂ ᅵ
터진다구요	ᄐ ᅥ ᄌ ᅵ ᆫ ᄃ ᅡ ᄀ ᅮ ᄋ ᅭ
설치구	ᄉ ᅥ ᆯ ᄎ ᅵ ᄀ ᅮ
헤어지구	ᄒ ᅦ ᄋ ᅥ ᄌ ᅵ ᄀ ᅮ
적반하장	ᄌ ᅥ ᆨ ᄈ ᅡ ᆫ ᄒ ᅡ ᄌ ᅡ ᆼ
같지가	ᄀ ᅡ ᆮ ᄍ ᅵ ᄀ ᅡ
신었다구	ᄉ ᅵ ᄂ ᅥ ᆮ ᄄ ᅡ ᄀ ᅮ
해두	ᄒ ᅢ ᄃ ᅮ
오월	ᄋ ᅩ ᄋ ᅯ ᆯ
십칠일	ᄉ ᅵ ᆸ ᄎ ᅵ ᄅ ᅵ ᆯ
기준	ᄀ ᅵ ᄌ ᅮ ᆫ
홍수로	ᄒ ᅩ ᆼ ᄉ ᅮ ᄅ ᅩ
최소	ᄎ ᅬ ᄉ ᅩ
명이	ᄆ ᅧ ᆼ ᄋ ᅵ
사망했고	ᄉ ᅡ ᄆ ᅡ ᆼ ᄒ ᅢ ᆮ ᄁ ᅩ
만육천	ᄆ ᅡ ᄂ ᅲ ᆨ ᄎ ᅥ ᆫ
명	ᄆ ᅧ ᆼ
이상이	ᄋ ᅵ ᄉ ᅡ ᆼ ᄋ ᅵ
대피하였습니다	ᄃ ᅢ ᄑ ᅵ ᄒ ᅡ ᄋ ᅧ ᆮ ᄊ ᅳ ᆷ ᄂ ᅵ ᄃ ᅡ
또한	ᄄ ᅩ ᄒ ᅡ ᆫ
경찰은	ᄀ ᅧ ᆼ ᄎ ᅡ ᄅ ᅳ ᆫ
테러	ᄐ ᅦ ᄅ ᅥ
과정에서	ᄀ ᅪ ᄌ ᅥ ᆼ ᄋ ᅦ ᄉ ᅥ
두건	ᄃ ᅮ ᄀ ᅥ ᆫ
이상의	ᄋ ᅵ ᄉ ᅡ ᆼ ᄋ ᅴ
자살	ᄌ ᅡ ᄉ ᅡ ᆯ
폭탄	ᄑ ᅩ ᆨ ᄐ ᅡ ᆫ
테러가	ᄐ ᅦ ᄅ ᅥ ᄀ ᅡ
밝혔습니다	ᄇ ᅡ ᆯ ᄏ ᅧ ᆮ ᄊ ᅳ ᆷ ᄂ ᅵ ᄃ ᅡ
값이	ᄀ ᅡ ᆸ ᄊ ᅵ
실제	ᄉ ᅵ ᆯ ᄌ ᅦ
질량이라고	ᄌ ᅵ ᆯ ᄅ ᅣ ᆼ ᄋ ᅵ ᄅ ᅡ ᄀ ᅩ
가정하면	ᄀ ᅡ ᄌ ᅥ ᆼ ᄒ ᅡ ᄆ ᅧ ᆫ
토성보다도	ᄐ ᅩ ᄉ ᅥ ᆼ ᄇ ᅩ ᄃ ᅡ ᄃ ᅩ
가볍습니다	ᄀ ᅡ ᄇ ᅧ ᆸ ᄊ ᅳ ᆷ ᄂ ᅵ ᄃ ᅡ
오닉스	ᄋ ᅩ ᄂ ᅵ ᆨ ᄊ ᅳ
스톤과	ᄉ ᅳ ᄐ ᅩ ᆫ ᄀ ᅪ
호텔이	ᄒ ᅩ ᄐ ᅦ ᄅ ᅵ
혼합된	ᄒ ᅩ ᆫ ᄒ ᅡ ᆸ ᄄ ᅬ ᆫ
개념에서	ᄀ ᅢ ᄂ ᅧ ᄆ ᅦ ᄉ ᅥ
영감을	ᄋ ᅧ ᆼ ᄀ ᅡ ᄆ ᅳ ᆯ
지었다	ᄌ ᅵ ᄋ ᅥ ᆮ ᄄ ᅡ
골드	ᄀ ᅩ ᆯ ᄃ ᅳ
바는	ᄇ ᅡ ᄂ ᅳ ᆫ
막대	ᄆ ᅡ ᆨ ᄄ ᅢ
모양의	ᄆ ᅩ ᄋ ᅣ ᆼ ᄋ ᅴ
금괴를	ᄀ ᅳ ᆷ ᄀ ᅬ ᄅ ᅳ ᆯ
말하며	ᄆ ᅡ ᆯ ᄒ ᅡ ᄆ ᅧ
종류	ᄌ ᅩ ᆼ ᄂ ᅲ
무게	ᄆ ᅮ ᄀ ᅦ
모양	ᄆ ᅩ ᄋ ᅣ ᆼ
순도	ᄉ ᅮ ᆫ ᄃ ᅩ
등	ᄃ ᅳ ᆼ
다양하다	ᄃ ᅡ ᄋ ᅣ ᆼ ᄒ ᅡ ᄃ ᅡ
국제	ᄀ ᅮ ᆨ ᄍ ᅦ
연맹은	ᄋ ᅧ ᆫ ᄆ ᅢ ᆼ ᄋ ᅳ ᆫ
수학의	ᄉ ᅮ ᄒ ᅡ ᄀ ᅴ
발전을	ᄇ ᅡ ᆯ ᄍ ᅥ ᄂ ᅳ ᆯ
만들어진	ᄆ ᅡ ᆫ ᄃ ᅳ ᄅ ᅥ ᄌ ᅵ ᆫ
비정부	ᄇ ᅵ ᄌ ᅥ ᆼ ᄇ ᅮ
협력	ᄒ ᅧ ᆷ ᄂ ᅧ ᆨ
단체이다	ᄃ ᅡ ᆫ ᄎ ᅦ ᄋ ᅵ ᄃ ᅡ
인간	ᄋ ᅵ ᆫ ᄀ ᅡ ᆫ
연대의	ᄋ ᅧ ᆫ ᄃ ᅢ ᄋ ᅴ
날은	ᄂ ᅡ ᄅ ᅳ ᆫ
인식하기	ᄋ ᅵ ᆫ ᄉ ᅵ ᄏ ᅡ ᄀ ᅵ
유엔에서	ᄋ ᅲ ᄋ ᅦ ᄂ ᅦ ᄉ ᅥ
제정하였습니다	ᄌ ᅦ ᄌ ᅥ ᆼ ᄒ ᅡ ᄋ ᅧ ᆮ ᄊ ᅳ ᆷ ᄂ ᅵ ᄃ ᅡ
이사금은	ᄋ ᅵ ᄉ ᅡ ᄀ ᅳ ᄆ ᅳ ᆫ
서쪽	ᄉ ᅥ ᄍ ᅩ ᆨ
계림의	ᄀ ᅨ ᄅ ᅵ ᄆ ᅴ
숲에서	ᄉ ᅮ ᄑ ᅦ ᄉ ᅥ
닭	ᄃ ᅡ ᆨ
우는	ᄋ ᅮ ᄂ ᅳ ᆫ
이때부터	ᄋ ᅵ ᄄ ᅢ ᄇ ᅮ ᄐ ᅥ
직접	ᄌ ᅵ ᆨ ᄍ ᅥ ᆸ
관찰한	ᄀ ᅪ ᆫ ᄎ ᅡ ᆯ ᄒ ᅡ ᆫ
바탕으로	ᄇ ᅡ ᄐ ᅡ ᆼ ᄋ ᅳ ᄅ ᅩ
이론을	ᄋ ᅵ ᄅ ᅩ ᄂ ᅳ ᆯ
수립하였다	ᄉ ᅮ ᄅ ᅵ ᄑ ᅡ ᄋ ᅧ ᆮ ᄄ ᅡ
대전차	ᄃ ᅢ ᄌ ᅥ ᆫ ᄎ ᅡ
방호벽은	ᄇ ᅡ ᆼ ᄒ ᅩ ᄇ ᅧ ᄀ ᅳ ᆫ
콘크리트	ᄏ ᅩ ᆫ ᄏ ᅳ ᄅ ᅵ ᄐ ᅳ
구조물로	ᄀ ᅮ ᄌ ᅩ ᄆ ᅮ ᆯ ᄅ ᅩ
있으며	ᄋ ᅵ ᄊ ᅳ ᄆ ᅧ
모양이	ᄆ ᅩ ᄋ ᅣ ᆼ ᄋ ᅵ
초기에는	ᄎ ᅩ ᄀ ᅵ ᄋ ᅦ ᄂ ᅳ ᆫ
도화원이라	ᄃ ᅩ ᄒ ᅪ ᄋ ᅯ ᄂ ᅵ ᄅ ᅡ
하였으나	ᄒ ᅡ ᄋ ᅧ ᄊ ᅳ ᄂ ᅡ
일의	ᄋ ᅵ ᄅ ᅴ
격을	ᄀ ᅧ ᄀ ᅳ ᆯ
낮추어	ᄂ ᅡ ᆮ ᄎ ᅮ ᄋ ᅥ
도화서로	ᄃ ᅩ ᄒ ᅪ ᄉ ᅥ ᄅ ᅩ
개칭하였다	ᄀ ᅢ ᄎ ᅵ ᆼ ᄒ ᅡ ᄋ ᅧ ᆮ ᄄ ᅡ
청설모는	ᄎ ᅥ ᆼ ᄉ ᅥ ᆯ ᄆ ᅩ ᄂ ᅳ ᆫ
환경에서도	ᄒ ᅪ ᆫ ᄀ ᅧ ᆼ ᄋ ᅦ ᄉ ᅥ ᄃ ᅩ
적응했기	ᄌ ᅥ ᄀ ᅳ ᆼ ᄒ ᅢ ᆮ ᄁ ᅵ
미국이나	ᄆ ᅵ ᄀ ᅮ ᄀ ᅵ ᄂ ᅡ
캐나다의	ᄏ ᅢ ᄂ ᅡ ᄃ ᅡ ᄋ ᅴ
공원에서	ᄀ ᅩ ᆼ ᄋ ᅯ ᄂ ᅦ ᄉ ᅥ
흔히	ᄒ ᅳ ᆫ ᄒ ᅵ
대구의	ᄃ ᅢ ᄀ ᅮ ᄋ ᅴ
랜드마크로	ᄅ ᅢ ᆫ ᄃ ᅳ ᄆ ᅡ ᄏ ᅳ ᄅ ᅩ
전국에	ᄌ ᅥ ᆫ ᄀ ᅮ ᄀ ᅦ
위치한	ᄋ ᅱ ᄎ ᅵ ᄒ ᅡ ᆫ
위브	ᄋ ᅱ ᄇ ᅳ
착공하였으며	ᄎ ᅡ ᆨ ᄁ ᅩ ᆼ ᄒ ᅡ ᄋ ᅧ ᄊ ᅳ ᄆ ᅧ
완공되었다	ᄋ ᅪ ᆫ ᄀ ᅩ ᆼ ᄃ ᅬ ᄋ ᅥ ᆮ ᄄ ᅡ
예를	ᄋ ᅨ ᄅ ᅳ ᆯ
손잡이는	ᄉ ᅩ ᆫ ᄌ ᅡ ᄇ ᅵ ᄂ ᅳ ᆫ
오른손으로	ᄋ ᅩ ᄅ ᅳ ᆫ ᄉ ᅩ ᄂ ᅳ ᄅ ᅩ
글씨를	ᄀ ᅳ ᆯ ᄊ ᅵ ᄅ ᅳ ᆯ
왼손으로	ᄋ ᅬ ᆫ ᄉ ᅩ ᄂ ᅳ ᄅ ᅩ
그립니다	ᄀ ᅳ ᄅ ᅵ ᆷ ᄂ ᅵ ᄃ ᅡ
라이거는	ᄅ ᅡ ᄋ ᅵ ᄀ ᅥ ᄂ ᅳ ᆫ
호랑이의	ᄒ ᅩ ᄅ ᅡ ᆼ ᄋ ᅵ ᄋ ᅴ
특징을	ᄐ ᅳ ᆨ ᄍ ᅵ ᆼ ᄋ ᅳ ᆯ
헤엄을	ᄒ ᅦ ᄋ ᅥ ᄆ ᅳ ᆯ
즐기며	ᄌ ᅳ ᆯ ᄀ ᅵ ᄆ ᅧ
사자처럼	ᄉ ᅡ ᄌ ᅡ ᄎ ᅥ ᄅ ᅥ ᆷ
너울	ᄂ ᅥ ᄋ ᅮ ᆯ
가지가	ᄀ ᅡ ᄌ ᅵ ᄀ ᅡ
매우	ᄆ ᅢ ᄋ ᅮ
루터는	ᄅ ᅮ ᄐ ᅥ ᄂ ᅳ ᆫ
이단으로	ᄋ ᅵ ᄃ ᅡ ᄂ ᅳ ᄅ ᅩ
낙인찍히면서	ᄂ ᅡ ᄀ ᅵ ᆫ ᄍ ᅵ ᄏ ᅵ ᄆ ᅧ ᆫ ᄉ ᅥ
루터	ᄅ ᅮ ᄐ ᅥ
종교개혁의	ᄌ ᅩ ᆼ ᄀ ᅭ ᄀ ᅢ ᄒ ᅧ ᄀ ᅴ
도화선이	ᄃ ᅩ ᄒ ᅪ ᄉ ᅥ ᄂ ᅵ
되었다	ᄃ ᅬ ᄋ ᅥ ᆮ ᄄ ᅡ
팝업	ᄑ ᅡ ᄇ ᅥ ᆸ
전조	ᄌ ᅥ ᆫ ᄌ ᅩ
등이	ᄃ ᅳ ᆼ ᄋ ᅵ
구비된	ᄀ ᅮ ᄇ ᅵ ᄃ ᅬ ᆫ
차량은	ᄎ ᅡ ᄅ ᅣ ᆼ ᄋ ᅳ ᆫ
일세대이며	ᄋ ᅵ ᆯ ᄉ ᅦ ᄃ ᅢ ᄋ ᅵ ᄆ ᅧ
개방형	ᄀ ᅢ ᄇ ᅡ ᆼ ᄒ ᅧ ᆼ
세대입니다	ᄉ ᅦ ᄃ ᅢ ᄋ ᅵ ᆷ ᄂ ᅵ ᄃ ᅡ
레아는	ᄅ ᅦ ᄋ ᅡ ᄂ ᅳ ᆫ
그리스	ᄀ ᅳ ᄅ ᅵ ᄉ ᅳ
신화에	ᄉ ᅵ ᆫ ᄒ ᅪ ᄋ ᅦ
나오는	ᄂ ᅡ ᄋ ᅩ ᄂ ᅳ ᆫ
거인족	ᄀ ᅥ ᄋ ᅵ ᆫ ᄌ ᅩ ᆨ
티탄인	ᄐ ᅵ ᄐ ᅡ ᄂ ᅵ ᆫ
레아에서	ᄅ ᅦ ᄋ ᅡ ᄋ ᅦ ᄉ ᅥ
유래했으며	ᄋ ᅲ ᄅ ᅢ ᄒ ᅢ ᄊ ᅳ ᄆ ᅧ
태양계의	ᄐ ᅢ ᄋ ᅣ ᆼ ᄀ ᅨ ᄋ ᅴ
위성	ᄋ ᅱ ᄉ ᅥ ᆼ
번째로	ᄇ ᅥ ᆫ ᄍ ᅢ ᄅ ᅩ
큽니다	ᄏ ᅳ ᆷ ᄂ ᅵ ᄃ ᅡ
집시는	ᄌ ᅵ ᆸ ᄊ ᅵ ᄂ ᅳ ᆫ
나치	ᄂ ᅡ ᄎ ᅵ
독일의	ᄃ ᅩ ᄀ ᅵ ᄅ ᅴ
홀로코스트와	ᄒ ᅩ ᆯ ᄅ ᅩ ᄏ ᅩ ᄉ ᅳ ᄐ ᅳ ᄋ ᅪ
강제	ᄀ ᅡ ᆼ ᄌ ᅦ
노역으로	ᄂ ᅩ ᄋ ᅧ ᄀ ᅳ ᄅ ᅩ
팔십만	ᄑ ᅡ ᆯ ᄉ ᅵ ᆷ ᄆ ᅡ ᆫ
비극의	ᄇ ᅵ ᄀ ᅳ ᄀ ᅴ
갖고	ᄀ ᅡ ᆮ ᄁ ᅩ
무덤이	ᄆ ᅮ ᄃ ᅥ ᄆ ᅵ
일기만	ᄋ ᅵ ᆯ ᄀ ᅵ ᄆ ᅡ ᆫ
있다면	ᄋ ᅵ ᆮ ᄄ ᅡ ᄆ ᅧ ᆫ
묘지와	ᄆ ᅭ ᄌ ᅵ ᄋ ᅪ
묘역은	ᄆ ᅭ ᄋ ᅧ ᄀ ᅳ ᆫ
동일한	ᄃ ᅩ ᆼ ᄋ ᅵ ᆯ ᄒ ᅡ ᆫ
영역을	ᄋ ᅧ ᆼ ᄋ ᅧ ᄀ ᅳ ᆯ
나타낸다	ᄂ ᅡ ᄐ ᅡ ᄂ ᅢ ᆫ ᄃ ᅡ
교황청의	ᄀ ᅭ ᄒ ᅪ ᆼ ᄎ ᅥ ᆼ ᄋ ᅴ
보안	ᄇ ᅩ ᄋ ᅡ ᆫ
책임지고	ᄎ ᅢ ᄀ ᅵ ᆷ ᄌ ᅵ ᄀ ᅩ
기타	ᄀ ᅵ ᄐ ᅡ
바티칸	ᄇ ᅡ ᄐ ᅵ ᄏ ᅡ ᆫ
시국에서의	ᄉ ᅵ ᄀ ᅮ ᄀ ᅦ ᄉ ᅥ ᄋ ᅴ
일상적인	ᄋ ᅵ ᆯ ᄉ ᅡ ᆼ ᄌ ᅥ ᄀ ᅵ ᆫ
임무를	ᄋ ᅵ ᆷ ᄆ ᅮ ᄅ ᅳ ᆯ
맡고	ᄆ ᅡ ᆮ ᄁ ᅩ
봄에	ᄇ ᅩ ᄆ ᅦ
종업식	ᄌ ᅩ ᆼ ᄋ ᅥ ᆸ ᄊ ᅵ ᆨ
대략	ᄃ ᅢ ᄅ ᅣ ᆨ
주일간	ᄌ ᅮ ᄋ ᅵ ᆯ ᄀ ᅡ ᆫ
학년	ᄒ ᅡ ᆼ ᄂ ᅧ ᆫ
방학을	ᄇ ᅡ ᆼ ᄒ ᅡ ᄀ ᅳ ᆯ
브래지어는	ᄇ ᅳ ᄅ ᅢ ᄌ ᅵ ᄋ ᅥ ᄂ ᅳ ᆫ
브라라고	ᄇ ᅳ ᄅ ᅡ ᄅ ᅡ ᄀ ᅩ
일컬으며	ᄋ ᅵ ᆯ ᄏ ᅥ ᄅ ᅳ ᄆ ᅧ
유방을	ᄋ ᅲ ᄇ ᅡ ᆼ ᄋ ᅳ ᆯ
가리고	ᄀ ᅡ ᄅ ᅵ ᄀ ᅩ
지탱해	ᄌ ᅵ ᄐ ᅢ ᆼ ᄒ ᅢ
옷의	ᄋ ᅩ ᄉ ᅴ
형태이다	ᄒ ᅧ ᆼ ᄐ ᅢ ᄋ ᅵ ᄃ ᅡ
수면	ᄉ ᅮ ᄆ ᅧ ᆫ
발생하는	ᄇ ᅡ ᆯ ᄉ ᅢ ᆼ ᄒ ᅡ ᄂ ᅳ ᆫ
질환의	ᄌ ᅵ ᆯ ᄒ ᅪ ᄂ ᅴ
원인을	ᄋ ᅯ ᄂ ᅵ ᄂ ᅳ ᆯ
알아내기	ᄋ ᅡ ᄅ ᅡ ᄂ ᅢ ᄀ ᅵ
다원	ᄃ ᅡ ᄋ ᅯ ᆫ
검사를	ᄀ ᅥ ᆷ ᄉ ᅡ ᄅ ᅳ ᆯ
진행했다	ᄌ ᅵ ᆫ ᄒ ᅢ ᆼ ᄒ ᅢ ᆮ ᄄ ᅡ
상자들과	ᄉ ᅡ ᆼ ᄌ ᅡ ᄃ ᅳ ᆯ ᄀ ᅪ
조작의	ᄌ ᅩ ᄌ ᅡ ᄀ ᅴ
흐름을	ᄒ ᅳ ᄅ ᅳ ᄆ ᅳ ᆯ
화살표	ᄒ ᅪ ᄉ ᅡ ᆯ ᄑ ᅭ
연결로	ᄋ ᅧ ᆫ ᄀ ᅧ ᆯ ᄅ ᅩ
프로세스	ᄑ ᅳ ᄅ ᅩ ᄉ ᅦ ᄉ ᅳ
작용을	ᄌ ᅡ ᄀ ᅭ ᆼ ᄋ ᅳ ᆯ
나타냈다	ᄂ ᅡ ᄐ ᅡ ᄂ ᅢ ᆮ ᄄ ᅡ
개인용	ᄀ ᅢ ᄋ ᅵ ᄂ ᅭ ᆼ
컴퓨터	ᄏ ᅥ ᆷ ᄑ ᅲ ᄐ ᅥ
애호가들이	ᄋ ᅢ ᄒ ᅩ ᄀ ᅡ ᄃ ᅳ ᄅ ᅵ
성능을	ᄉ ᅥ ᆼ ᄂ ᅳ ᆼ ᄋ ᅳ ᆯ
높이기	ᄂ ᅩ ᄑ ᅵ ᄀ ᅵ
클럭을	ᄏ ᅳ ᆯ ᄅ ᅥ ᄀ ᅳ ᆯ
높이기도	ᄂ ᅩ ᄑ ᅵ ᄀ ᅵ ᄃ ᅩ
음악	ᄋ ᅳ ᄆ ᅡ ᆨ
치료사들은	ᄎ ᅵ ᄅ ᅭ ᄉ ᅡ ᄃ ᅳ ᄅ ᅳ ᆫ
치매	ᄎ ᅵ ᄆ ᅢ
환자나	ᄒ ᅪ ᆫ ᄌ ᅡ ᄂ ᅡ
어린아이들의	ᄋ ᅥ ᄅ ᅵ ᄂ ᅡ ᄋ ᅵ ᄃ ᅳ ᄅ ᅴ
몸과	ᄆ ᅩ ᆷ ᄀ ᅪ
치료하는	ᄎ ᅵ ᄅ ᅭ ᄒ ᅡ ᄂ ᅳ ᆫ
세계대전	ᄉ ᅦ ᄀ ᅨ ᄃ ᅢ ᄌ ᅥ ᆫ
직후인	ᄌ ᅵ ᄏ ᅮ ᄋ ᅵ ᆫ
천구백십구년에	ᄎ ᅥ ᆫ ᄀ ᅮ ᄇ ᅢ ᆨ ᄊ ᅵ ᆸ ᄁ ᅮ ᄂ ᅧ ᄂ ᅦ
폴란드	ᄑ ᅩ ᆯ ᄅ ᅡ ᆫ ᄃ ᅳ
공화국의	ᄀ ᅩ ᆼ ᄒ ᅪ ᄀ ᅮ ᄀ ᅴ
탄생과	ᄐ ᅡ ᆫ ᄉ ᅢ ᆼ ᄀ ᅪ
동시에	ᄃ ᅩ ᆼ ᄉ ᅵ ᄋ ᅦ
초대	ᄎ ᅩ ᄃ ᅢ
수상이	ᄉ ᅮ ᄉ ᅡ ᆼ ᄋ ᅵ
호수에서	ᄒ ᅩ ᄉ ᅮ ᄋ ᅦ ᄉ ᅥ
물고기를	ᄆ ᅮ ᆯ ᄀ ᅩ ᄀ ᅵ ᄅ ᅳ ᆯ
잡거나	ᄌ ᅡ ᆸ ᄁ ᅥ ᄂ ᅡ
수경	ᄉ ᅮ ᄀ ᅧ ᆼ
재배로	ᄌ ᅢ ᄇ ᅢ ᄅ ᅩ
야채나	ᄋ ᅣ ᄎ ᅢ ᄂ ᅡ
방울토마토를	ᄇ ᅡ ᆼ ᄋ ᅮ ᆯ ᄐ ᅩ ᄆ ᅡ ᄐ ᅩ ᄅ ᅳ ᆯ
생산합니다	ᄉ ᅢ ᆼ ᄉ ᅡ ᆫ ᄒ ᅡ ᆷ ᄂ ᅵ ᄃ ᅡ
말해서	ᄆ ᅡ ᆯ ᄒ ᅢ ᄉ ᅥ
결과값이	ᄀ ᅧ ᆯ ᄀ ᅪ ᄀ ᅡ ᆸ ᄊ ᅵ
주어졌을	ᄌ ᅮ ᄋ ᅥ ᄌ ᅥ ᄊ ᅳ ᆯ
입력값을	ᄋ ᅵ ᆷ ᄂ ᅧ ᆨ ᄁ ᅡ ᆸ ᄊ ᅳ ᆯ
구하는	ᄀ ᅮ ᄒ ᅡ ᄂ ᅳ ᆫ
함수이다	ᄒ ᅡ ᆷ ᄉ ᅮ ᄋ ᅵ ᄃ ᅡ
열매가	ᄋ ᅧ ᆯ ᄆ ᅢ ᄀ ᅡ
익으면	ᄋ ᅵ ᄀ ᅳ ᄆ ᅧ ᆫ
사이의	ᄉ ᅡ ᄋ ᅵ ᄋ ᅴ
양쪽에	ᄋ ᅣ ᆼ ᄍ ᅩ ᄀ ᅦ
주름이	ᄌ ᅮ ᄅ ᅳ ᄆ ᅵ
생기며	ᄉ ᅢ ᆼ ᄀ ᅵ ᄆ ᅧ
각	ᄀ ᅡ ᆨ
마디에	ᄆ ᅡ ᄃ ᅵ ᄋ ᅦ
종자가	ᄌ ᅩ ᆼ ᄌ ᅡ ᄀ ᅡ
나온다	ᄂ ᅡ ᄋ ᅩ ᆫ ᄃ ᅡ
신축성이	ᄉ ᅵ ᆫ ᄎ ᅮ ᆨ ᄊ ᅥ ᆼ ᄋ ᅵ
강하고	ᄀ ᅡ ᆼ ᄒ ᅡ ᄀ ᅩ
긴	ᄀ ᅵ ᆫ
장대를	ᄌ ᅡ ᆼ ᄃ ᅢ ᄅ ᅳ ᆯ
쥐고	ᄌ ᅱ ᄀ ᅩ
도움닫기를	ᄃ ᅩ ᄋ ᅮ ᆷ ᄃ ᅡ ᆮ ᄁ ᅵ ᄅ ᅳ ᆯ
하여	ᄒ ᅡ ᄋ ᅧ
가로대를	ᄀ ᅡ ᄅ ᅩ ᄃ ᅢ ᄅ ᅳ ᆯ
넘는	ᄂ ᅥ ᆷ ᄂ ᅳ ᆫ
종목이	ᄌ ᅩ ᆼ ᄆ ᅩ ᄀ ᅵ
체중이	ᄎ ᅦ ᄌ ᅮ ᆼ ᄋ ᅵ
건강한	ᄀ ᅥ ᆫ ᄀ ᅡ ᆼ ᄒ ᅡ ᆫ
표준	ᄑ ᅭ ᄌ ᅮ ᆫ
체중보다	ᄎ ᅦ ᄌ ᅮ ᆼ ᄇ ᅩ ᄃ ᅡ
적은	ᄌ ᅥ ᄀ ᅳ ᆫ
상태를	ᄉ ᅡ ᆼ ᄐ ᅢ ᄅ ᅳ ᆯ
말한다	ᄆ ᅡ ᆯ ᄒ ᅡ ᆫ ᄃ ᅡ
법원이나	ᄇ ᅥ ᄇ ᅯ ᄂ ᅵ ᄂ ᅡ
정부	ᄌ ᅥ ᆼ ᄇ ᅮ
기관에서	ᄀ ᅵ ᄀ ᅪ ᄂ ᅦ ᄉ ᅥ
정지	ᄌ ᅥ ᆼ ᄌ ᅵ
명령을	ᄆ ᅧ ᆼ ᄂ ᅧ ᆼ ᄋ ᅳ ᆯ
내릴	ᄂ ᅢ ᄅ ᅵ ᆯ
특수한	ᄐ ᅳ ᆨ ᄊ ᅮ ᄒ ᅡ ᆫ
개인도	ᄀ ᅢ ᄋ ᅵ ᆫ ᄃ ᅩ
생후	ᄉ ᅢ ᆼ ᄒ ᅮ
오일	ᄋ ᅩ ᄋ ᅵ ᆯ
사망하여	ᄉ ᅡ ᄆ ᅡ ᆼ ᄒ ᅡ ᄋ ᅧ
생전에	ᄉ ᅢ ᆼ ᄌ ᅥ ᄂ ᅦ
친왕	ᄎ ᅵ ᄂ ᅪ ᆼ
등의	ᄃ ᅳ ᆼ ᄋ ᅴ
작위를	ᄌ ᅡ ᄀ ᅱ ᄅ ᅳ ᆯ
봉작	ᄇ ᅩ ᆼ ᄌ ᅡ ᆨ
받지	ᄇ ᅡ ᆮ ᄍ ᅵ
못했다	ᄆ ᅩ ᄐ ᅢ ᆮ ᄄ ᅡ
중성미자의	ᄌ ᅮ ᆼ ᄉ ᅥ ᆼ ᄆ ᅵ ᄌ ᅡ ᄋ ᅴ
맛깔이	ᄆ ᅡ ᆮ ᄁ ᅡ ᄅ ᅵ
흐름에	ᄒ ᅳ ᄅ ᅳ ᄆ ᅦ
변하는	ᄇ ᅧ ᆫ ᄒ ᅡ ᄂ ᅳ ᆫ
양자	ᄋ ᅣ ᆼ ᄌ ᅡ
역학	ᄋ ᅧ ᄏ ᅡ ᆨ
현상이	ᄒ ᅧ ᆫ ᄉ ᅡ ᆼ ᄋ ᅵ
모습은	ᄆ ᅩ ᄉ ᅳ ᄇ ᅳ ᆫ
일반	ᄋ ᅵ ᆯ ᄇ ᅡ ᆫ
용과	ᄋ ᅭ ᆼ ᄀ ᅪ
다를	ᄃ ᅡ ᄅ ᅳ ᆯ
하나도	ᄒ ᅡ ᄂ ᅡ ᄃ ᅩ
없지만	ᄋ ᅥ ᆸ ᄍ ᅵ ᄆ ᅡ ᆫ
그대로	ᄀ ᅳ ᄃ ᅢ ᄅ ᅩ
푸른색을	ᄑ ᅮ ᄅ ᅳ ᆫ ᄉ ᅢ ᄀ ᅳ ᆯ
띠고	ᄄ ᅵ ᄀ ᅩ
과정이	ᄀ ᅪ ᄌ ᅥ ᆼ ᄋ ᅵ
심화되면	ᄉ ᅵ ᆷ ᄒ ᅪ ᄃ ᅬ ᄆ ᅧ ᆫ
소행성이	ᄉ ᅩ ᄒ ᅢ ᆼ ᄉ ᅥ ᆼ ᄋ ᅵ
되며	ᄃ ᅬ ᄆ ᅧ
진화를	ᄌ ᅵ ᆫ ᄒ ᅪ ᄅ ᅳ ᆯ
겪으면	ᄀ ᅧ ᄁ ᅳ ᄆ ᅧ ᆫ
행성으로	ᄒ ᅢ ᆼ ᄉ ᅥ ᆼ ᄋ ᅳ ᄅ ᅩ
자라나게	ᄌ ᅡ ᄅ ᅡ ᄂ ᅡ ᄀ ᅦ
판의	ᄑ ᅡ ᄂ ᅴ
경계에서는	ᄀ ᅧ ᆼ ᄀ ᅨ ᄋ ᅦ ᄉ ᅥ ᄂ ᅳ ᆫ
지진과	ᄌ ᅵ ᄌ ᅵ ᆫ ᄀ ᅪ
화산활동이	ᄒ ᅪ ᄉ ᅡ ᆫ ᄒ ᅪ ᆯ ᄃ ᅩ ᆼ ᄋ ᅵ
잦으며	ᄌ ᅡ ᄌ ᅳ ᄆ ᅧ
대부분의	ᄃ ᅢ ᄇ ᅮ ᄇ ᅮ ᄂ ᅴ
화산은	ᄒ ᅪ ᄉ ᅡ ᄂ ᅳ ᆫ
경계에	ᄀ ᅧ ᆼ ᄀ ᅨ ᄋ ᅦ
항공기	ᄒ ᅡ ᆼ ᄀ ᅩ ᆼ ᄀ ᅵ
날개에	ᄂ ᅡ ᆯ ᄀ ᅢ ᄋ ᅦ
걸리는	ᄀ ᅥ ᆯ ᄅ ᅵ ᄂ ᅳ ᆫ
하중의	ᄒ ᅡ ᄌ ᅮ ᆼ ᄋ ᅴ
크기를	ᄏ ᅳ ᄀ ᅵ ᄅ ᅳ ᆯ
기본하중으로	ᄀ ᅵ ᄇ ᅩ ᆫ ᄒ ᅡ ᄌ ᅮ ᆼ ᄋ ᅳ ᄅ ᅩ
나눈다	ᄂ ᅡ ᄂ ᅮ ᆫ ᄃ ᅡ
오른쪽	ᄋ ᅩ ᄅ ᅳ ᆫ ᄍ ᅩ ᆨ
눈은	ᄂ ᅮ ᄂ ᅳ ᆫ
라의	ᄅ ᅡ ᄋ ᅴ
상징하고	ᄉ ᅡ ᆼ ᄌ ᅵ ᆼ ᄒ ᅡ ᄀ ᅩ
토트의	ᄐ ᅩ ᄐ ᅳ ᄋ ᅴ
달을	ᄃ ᅡ ᄅ ᅳ ᆯ
상징한다	ᄉ ᅡ ᆼ ᄌ ᅵ ᆼ ᄒ ᅡ ᆫ ᄃ ᅡ
암컷은	ᄋ ᅡ ᆷ ᄏ ᅥ ᄉ ᅳ ᆫ
눈썹	ᄂ ᅮ ᆫ ᄊ ᅥ ᆸ
선도	ᄉ ᅥ ᆫ ᄃ ᅩ
흰색을	ᄒ ᅵ ᆫ ᄉ ᅢ ᄀ ᅳ ᆯ
띠며	ᄄ ᅵ ᄆ ᅧ
위는	ᄋ ᅱ ᄂ ᅳ ᆫ
갈색을	ᄀ ᅡ ᆯ ᄉ ᅢ ᄀ ᅳ ᆯ
띤다	ᄄ ᅵ ᆫ ᄃ ᅡ
특히	ᄐ ᅳ ᄏ ᅵ
빛의	ᄇ ᅵ ᄎ ᅴ
수면에	ᄉ ᅮ ᄆ ᅧ ᄂ ᅦ
빼놓을	ᄈ ᅢ ᄂ ᅩ ᄋ ᅳ ᆯ
역할을	ᄋ ᅧ ᄏ ᅡ ᄅ ᅳ ᆯ
오징어나	ᄋ ᅩ ᄌ ᅵ ᆼ ᄋ ᅥ ᄂ ᅡ
노가리를	ᄂ ᅩ ᄀ ᅡ ᄅ ᅵ ᄅ ᅳ ᆯ
불에	ᄇ ᅮ ᄅ ᅦ
구워서	ᄀ ᅮ ᄋ ᅯ ᄉ ᅥ
고추장이나	ᄀ ᅩ ᄎ ᅮ ᄌ ᅡ ᆼ ᄋ ᅵ ᄂ ᅡ
마요네즈에	ᄆ ᅡ ᄋ ᅭ ᄂ ᅦ ᄌ ᅳ ᄋ ᅦ
먹는다	ᄆ ᅥ ᆼ ᄂ ᅳ ᆫ ᄃ ᅡ
담근	ᄃ ᅡ ᆷ ᄀ ᅳ ᆫ
된	ᄃ ᅬ ᆫ
사용하면	ᄉ ᅡ ᄋ ᅭ ᆼ ᄒ ᅡ ᄆ ᅧ ᆫ
특유의	ᄐ ᅳ ᄀ ᅲ ᄋ ᅴ
때문입니다	ᄄ ᅢ ᄆ ᅮ ᄂ ᅵ ᆷ ᄂ ᅵ ᄃ ᅡ
질량에	ᄌ ᅵ ᆯ ᄅ ᅣ ᆼ ᄋ ᅦ
근거하여	ᄀ ᅳ ᆫ ᄀ ᅥ ᄒ ᅡ ᄋ ᅧ
행성은	ᄒ ᅢ ᆼ ᄉ ᅥ ᆼ ᄋ ᅳ ᆫ
딱딱한	ᄄ ᅡ ᆨ ᄄ ᅡ ᄏ ᅡ ᆫ
표면이	ᄑ ᅭ ᄆ ᅧ ᄂ ᅵ
행성일	ᄒ ᅢ ᆼ ᄉ ᅥ ᆼ ᄋ ᅵ ᆯ
것으로	ᄀ ᅥ ᄉ ᅳ ᄅ ᅩ
추측되고	ᄎ ᅮ ᄎ ᅳ ᆨ ᄄ ᅬ ᄀ ᅩ
앨범은	ᄋ ᅢ ᆯ ᄇ ᅥ ᄆ ᅳ ᆫ
대중적이라기보다는	ᄃ ᅢ ᄌ ᅮ ᆼ ᄌ ᅥ ᄀ ᅵ ᄅ ᅡ ᄀ ᅵ ᄇ ᅩ ᄃ ᅡ ᄂ ᅳ ᆫ
예술적인	ᄋ ᅨ ᄉ ᅮ ᆯ ᄌ ᅥ ᄀ ᅵ ᆫ
측면이	ᄎ ᅳ ᆼ ᄆ ᅧ ᄂ ᅵ
강함을	ᄀ ᅡ ᆼ ᄒ ᅡ ᄆ ᅳ ᆯ
느낄	ᄂ ᅳ ᄁ ᅵ ᆯ
풍뎅이와	ᄑ ᅮ ᆼ ᄃ ᅦ ᆼ ᄋ ᅵ ᄋ ᅪ
달리	ᄃ ᅡ ᆯ ᄅ ᅵ
앞날개를	ᄋ ᅡ ᆷ ᄂ ᅡ ᆯ ᄀ ᅢ ᄅ ᅳ ᆯ
살짝	ᄉ ᅡ ᆯ ᄍ ᅡ ᆨ
뒤	ᄃ ᅱ
뒷날개만	ᄃ ᅱ ᆫ ᄂ ᅡ ᆯ ᄀ ᅢ ᄆ ᅡ ᆫ
완전히	ᄋ ᅪ ᆫ ᄌ ᅥ ᆫ ᄒ ᅵ
펴서	ᄑ ᅧ ᄉ ᅥ
비행한다	ᄇ ᅵ ᄒ ᅢ ᆼ ᄒ ᅡ ᆫ ᄃ ᅡ
지방마다	ᄌ ᅵ ᄇ ᅡ ᆼ ᄆ ᅡ ᄃ ᅡ
상황에	ᄉ ᅡ ᆼ ᄒ ᅪ ᆼ ᄋ ᅦ
요리의	ᄋ ᅭ ᄅ ᅵ ᄋ ᅴ
특성이	ᄐ ᅳ ᆨ ᄊ ᅥ ᆼ ᄋ ᅵ
두드러지게	ᄃ ᅮ ᄃ ᅳ ᄅ ᅥ ᄌ ᅵ ᄀ ᅦ
보이는	ᄇ ᅩ ᄋ ᅵ ᄂ ᅳ ᆫ
손님들이	ᄉ ᅩ ᆫ ᄂ ᅵ ᆷ ᄃ ᅳ ᄅ ᅵ
도착할	ᄃ ᅩ ᄎ ᅡ ᄏ ᅡ ᆯ
맞이하며	ᄆ ᅡ ᄌ ᅵ ᄒ ᅡ ᄆ ᅧ
문이나	ᄆ ᅮ ᄂ ᅵ ᄂ ᅡ
준다	ᄌ ᅮ ᆫ ᄃ ᅡ
세계적으로	ᄉ ᅦ ᄀ ᅨ ᄌ ᅥ ᄀ ᅳ ᄅ ᅩ
대중적인	ᄃ ᅢ ᄌ ᅮ ᆼ ᄌ ᅥ ᄀ ᅵ ᆫ
인기를	ᄋ ᅵ ᆫ ᄀ ᅵ ᄅ ᅳ ᆯ
얻게	ᄋ ᅥ ᆮ ᄁ ᅦ
계기는	ᄀ ᅨ ᄀ ᅵ ᄂ ᅳ ᆫ
칠십년대	ᄎ ᅵ ᆯ ᄉ ᅵ ᆷ ᄂ ᅧ ᆫ ᄃ ᅢ
후반	ᄒ ᅮ ᄇ ᅡ ᆫ
뉴욕의	ᄂ ᅲ ᄋ ᅭ ᄀ ᅴ
디스코	ᄃ ᅵ ᄉ ᅳ ᄏ ᅩ
열풍이	ᄋ ᅧ ᆯ ᄑ ᅮ ᆼ ᄋ ᅵ
불면서였다	ᄇ ᅮ ᆯ ᄆ ᅧ ᆫ ᄉ ᅥ ᄋ ᅧ ᆮ ᄄ ᅡ
승패가	ᄉ ᅳ ᆼ ᄑ ᅢ ᄀ ᅡ
결정되면	ᄀ ᅧ ᆯ ᄌ ᅥ ᆼ ᄃ ᅬ ᄆ ᅧ ᆫ
결과에	ᄀ ᅧ ᆯ ᄀ ᅪ ᄋ ᅦ
상관없이	ᄉ ᅡ ᆼ ᄀ ᅪ ᄂ ᅥ ᆸ ᄊ ᅵ
인정을	ᄋ ᅵ ᆫ ᄌ ᅥ ᆼ ᄋ ᅳ ᆯ
베풀어	ᄇ ᅦ ᄑ ᅮ ᄅ ᅥ
화합하며	ᄒ ᅪ ᄒ ᅡ ᄑ ᅡ ᄆ ᅧ
즐겼다	ᄌ ᅳ ᆯ ᄀ ᅧ ᆮ ᄄ ᅡ
올림픽	ᄋ ᅩ ᆯ ᄅ ᅵ ᆷ ᄑ ᅵ ᆨ
대회에서	ᄃ ᅢ ᄒ ᅬ ᄋ ᅦ ᄉ ᅥ
금메달	ᄀ ᅳ ᆷ ᄆ ᅦ ᄃ ᅡ ᆯ
유일한	ᄋ ᅲ ᄋ ᅵ ᆯ ᄒ ᅡ ᆫ
스키점프	ᄉ ᅳ ᄏ ᅵ ᄌ ᅥ ᆷ ᄑ ᅳ
선수이다	ᄉ ᅥ ᆫ ᄉ ᅮ ᄋ ᅵ ᄃ ᅡ
효과로	ᄒ ᅭ ᄀ ᅪ ᄅ ᅩ
천문학	ᄎ ᅥ ᆫ ᄆ ᅮ ᆫ ᄒ ᅡ ᆨ
역사상	ᄋ ᅧ ᆨ ᄊ ᅡ ᄉ ᅡ ᆼ
발견들이	ᄇ ᅡ ᆯ ᄀ ᅧ ᆫ ᄃ ᅳ ᄅ ᅵ
사실	ᄉ ᅡ ᄉ ᅵ ᆯ
것이었음이	ᄀ ᅥ ᄉ ᅵ ᄋ ᅥ ᄊ ᅳ ᄆ ᅵ
밝혀졌다	ᄇ ᅡ ᆯ ᄏ ᅧ ᄌ ᅥ ᆮ ᄄ ᅡ
모낭	ᄆ ᅩ ᄂ ᅡ ᆼ
내에	ᄂ ᅢ ᄋ ᅦ
각질이	ᄀ ᅡ ᆨ ᄍ ᅵ ᄅ ᅵ
채워져	ᄎ ᅢ ᄋ ᅯ ᄌ ᅥ
있기	ᄋ ᅵ ᆮ ᄁ ᅵ
털은	ᄐ ᅥ ᄅ ᅳ ᆫ
각질	ᄀ ᅡ ᆨ ᄍ ᅵ ᆯ
박혀	ᄇ ᅡ ᄏ ᅧ
기름이	ᄀ ᅵ ᄅ ᅳ ᄆ ᅵ
적으면	ᄌ ᅥ ᄀ ᅳ ᄆ ᅧ ᆫ
재료가	ᄌ ᅢ ᄅ ᅭ ᄀ ᅡ
타기	ᄐ ᅡ ᄀ ᅵ
쉽고	ᄉ ᅱ ᆸ ᄁ ᅩ
많으면	ᄆ ᅡ ᄂ ᅳ ᄆ ᅧ ᆫ
음식이	ᄋ ᅳ ᆷ ᄉ ᅵ ᄀ ᅵ
깔끔하지	ᄁ ᅡ ᆯ ᄁ ᅳ ᆷ ᄒ ᅡ ᄌ ᅵ
주의해야	ᄌ ᅮ ᄋ ᅴ ᄒ ᅢ ᄋ ᅣ
물체를	ᄆ ᅮ ᆯ ᄎ ᅦ ᄅ ᅳ ᆯ
액체	ᄋ ᅢ ᆨ ᄎ ᅦ
넣으면	ᄂ ᅥ ᄋ ᅳ ᄆ ᅧ ᆫ
중력	ᄌ ᅮ ᆼ ᄂ ᅧ ᆨ
밀어	ᄆ ᅵ ᄅ ᅥ
떠오르게	ᄄ ᅥ ᄋ ᅩ ᄅ ᅳ ᄀ ᅦ
평탄한	ᄑ ᅧ ᆼ ᄐ ᅡ ᆫ ᄒ ᅡ ᆫ
지형	ᄌ ᅵ ᄒ ᅧ ᆼ
갑문이	ᄀ ᅡ ᆷ ᄆ ᅮ ᄂ ᅵ
없으며	ᄋ ᅥ ᆸ ᄊ ᅳ ᄆ ᅧ
운하	ᄋ ᅮ ᆫ ᄒ ᅡ
끝의	ᄁ ᅳ ᄉ ᅴ
바닷물이	ᄇ ᅡ ᄃ ᅡ ᆫ ᄆ ᅮ ᄅ ᅵ
자유로이	ᄌ ᅡ ᄋ ᅲ ᄅ ᅩ ᄋ ᅵ
흘러들어	ᄒ ᅳ ᆯ ᄅ ᅥ ᄃ ᅳ ᄅ ᅥ
온다	ᄋ ᅩ ᆫ ᄃ ᅡ
밥솥	ᄇ ᅡ ᆸ ᄊ ᅩ ᆮ
바닥에	ᄇ ᅡ ᄃ ᅡ ᄀ ᅦ
눌어붙은	ᄂ ᅮ ᄅ ᅥ ᄇ ᅮ ᄐ ᅳ ᆫ
누룽지에	ᄂ ᅮ ᄅ ᅮ ᆼ ᄌ ᅵ ᄋ ᅦ
붓고	ᄇ ᅮ ᆮ ᄁ ᅩ
한소끔	ᄒ ᅡ ᆫ ᄉ ᅩ ᄁ ᅳ ᆷ
내놓았다	ᄂ ᅢ ᄂ ᅩ ᄋ ᅡ ᆮ ᄄ ᅡ
액체와	ᄋ ᅢ ᆨ ᄎ ᅦ ᄋ ᅪ
고체가	ᄀ ᅩ ᄎ ᅦ ᄀ ᅡ
입자의	ᄋ ᅵ ᆸ ᄍ ᅡ ᄋ ᅴ
크기	ᄏ ᅳ ᄀ ᅵ
차이를	ᄎ ᅡ ᄋ ᅵ ᄅ ᅳ ᆯ
분리한다	ᄇ ᅮ ᆯ ᄅ ᅵ ᄒ ᅡ ᆫ ᄃ ᅡ
피사체에	ᄑ ᅵ ᄉ ᅡ ᄎ ᅦ ᄋ ᅦ
초점을	ᄎ ᅩ ᄌ ᅥ ᄆ ᅳ ᆯ
자동으로	ᄌ ᅡ ᄃ ᅩ ᆼ ᄋ ᅳ ᄅ ᅩ
맞추는	ᄆ ᅡ ᆮ ᄎ ᅮ ᄂ ᅳ ᆫ
광학	ᄀ ᅪ ᆼ ᄒ ᅡ ᆨ
시스템의	ᄉ ᅵ ᄉ ᅳ ᄐ ᅦ ᄆ ᅴ
기능도	ᄀ ᅵ ᄂ ᅳ ᆼ ᄃ ᅩ
타인이	ᄐ ᅡ ᄋ ᅵ ᄂ ᅵ
잃어버린	ᄋ ᅵ ᄅ ᅥ ᄇ ᅥ ᄅ ᅵ ᆫ
주워서	ᄌ ᅮ ᄋ ᅯ ᄉ ᅥ
임의로	ᄋ ᅵ ᄆ ᅴ ᄅ ᅩ
처분했다면	ᄎ ᅥ ᄇ ᅮ ᆫ ᄒ ᅢ ᆮ ᄄ ᅡ ᄆ ᅧ ᆫ
천구백사십사년	ᄎ ᅥ ᆫ ᄀ ᅮ ᄇ ᅢ ᆨ ᄊ ᅡ ᄉ ᅵ ᆸ ᄊ ᅡ ᄂ ᅧ ᆫ
여름까지	ᄋ ᅧ ᄅ ᅳ ᆷ ᄁ ᅡ ᄌ ᅵ
영국에서	ᄋ ᅧ ᆼ ᄀ ᅮ ᄀ ᅦ ᄉ ᅥ
받았으며	ᄇ ᅡ ᄃ ᅡ ᄊ ᅳ ᄆ ᅧ
병력은	ᄇ ᅧ ᆼ ᄂ ᅧ ᄀ ᅳ ᆫ
약	ᄋ ᅣ ᆨ
사천	ᄉ ᅡ ᄎ ᅥ ᆫ
명까지	ᄆ ᅧ ᆼ ᄁ ᅡ ᄌ ᅵ
늘어났다	ᄂ ᅳ ᄅ ᅥ ᄂ ᅡ ᆮ ᄄ ᅡ
메기는	ᄆ ᅦ ᄀ ᅵ ᄂ ᅳ ᆫ
움직이지	ᄋ ᅮ ᆷ ᄌ ᅵ ᄀ ᅵ ᄌ ᅵ
생활하는	ᄉ ᅢ ᆼ ᄒ ᅪ ᆯ ᄒ ᅡ ᄂ ᅳ ᆫ
흔치	ᄒ ᅳ ᆫ ᄎ ᅵ
어류입니다	ᄋ ᅥ ᄅ ᅲ ᄋ ᅵ ᆷ ᄂ ᅵ ᄃ ᅡ
그곳의	ᄀ ᅳ ᄀ ᅩ ᄉ ᅴ
아이들은	ᄋ ᅡ ᄋ ᅵ ᄃ ᅳ ᄅ ᅳ ᆫ
비석	ᄇ ᅵ ᄉ ᅥ ᆨ
세워	ᄉ ᅦ ᄋ ᅯ
맞혀	ᄆ ᅡ ᄎ ᅧ
쓰러뜨리면서	ᄊ ᅳ ᄅ ᅥ ᄄ ᅳ ᄅ ᅵ ᄆ ᅧ ᆫ ᄉ ᅥ
놀고	ᄂ ᅩ ᆯ ᄀ ᅩ
마그마	ᄆ ᅡ ᄀ ᅳ ᄆ ᅡ
물질이	ᄆ ᅮ ᆯ ᄍ ᅵ ᄅ ᅵ
행성	ᄒ ᅢ ᆼ ᄉ ᅥ ᆼ
표면을	ᄑ ᅭ ᄆ ᅧ ᄂ ᅳ ᆯ
뚫고	ᄄ ᅮ ᆯ ᄏ ᅩ
분출하여	ᄇ ᅮ ᆫ ᄎ ᅮ ᆯ ᄒ ᅡ ᄋ ᅧ
꿀이나	ᄁ ᅮ ᄅ ᅵ ᄂ ᅡ
설탕에	ᄉ ᅥ ᆯ ᄐ ᅡ ᆼ ᄋ ᅦ
재운	ᄌ ᅢ ᄋ ᅮ ᆫ
오미자	ᄋ ᅩ ᄆ ᅵ ᄌ ᅡ
청과	ᄎ ᅥ ᆼ ᄀ ᅪ
과일	ᄀ ᅪ ᄋ ᅵ ᆯ
꽃잎이나	ᄁ ᅩ ᆫ ᄂ ᅵ ᄇ ᅵ ᄂ ᅡ
실백을	ᄉ ᅵ ᆯ ᄇ ᅢ ᄀ ᅳ ᆯ
띄워	ᄄ ᅵ ᄋ ᅯ
곁들여	ᄀ ᅧ ᆮ ᄄ ᅳ ᄅ ᅧ
마시는	ᄆ ᅡ ᄉ ᅵ ᄂ ᅳ ᆫ
추천합니다	ᄎ ᅮ ᄎ ᅥ ᆫ ᄒ ᅡ ᆷ ᄂ ᅵ ᄃ ᅡ
스트레스를	ᄉ ᅳ ᄐ ᅳ ᄅ ᅦ ᄉ ᅳ ᄅ ᅳ ᆯ
그때그때	ᄀ ᅳ ᄄ ᅢ ᄀ ᅳ ᄄ ᅢ
불쾌감	ᄇ ᅮ ᆯ ᄏ ᅫ ᄀ ᅡ ᆷ
짜증이	ᄍ ᅡ ᄌ ᅳ ᆼ ᄋ ᅵ
생기면서	ᄉ ᅢ ᆼ ᄀ ᅵ ᄆ ᅧ ᆫ ᄉ ᅥ
긍정적인	ᄀ ᅳ ᆼ ᄌ ᅥ ᆼ ᄌ ᅥ ᄀ ᅵ ᆫ
하기	ᄒ ᅡ ᄀ ᅵ
어려워진다	ᄋ ᅥ ᄅ ᅧ ᄋ ᅯ ᄌ ᅵ ᆫ ᄃ ᅡ
화폐가	ᄒ ᅪ ᄑ ᅨ ᄀ ᅡ
각자	ᄀ ᅡ ᆨ ᄍ ᅡ
교환하여	ᄀ ᅭ ᄒ ᅪ ᆫ ᄒ ᅡ ᄋ ᅧ
거래하였다	ᄀ ᅥ ᄅ ᅢ ᄒ ᅡ ᄋ ᅧ ᆮ ᄄ ᅡ
야생화는	ᄋ ᅣ ᄉ ᅢ ᆼ ᄒ ᅪ ᄂ ᅳ ᆫ
호주가	ᄒ ᅩ ᄌ ᅮ ᄀ ᅡ
원산이며	ᄋ ᅯ ᆫ ᄉ ᅡ ᄂ ᅵ ᄆ ᅧ
특이한	ᄐ ᅳ ᄀ ᅵ ᄒ ᅡ ᆫ
꽃과	ᄁ ᅩ ᆮ ᄁ ᅪ
열매	ᄋ ᅧ ᆯ ᄆ ᅢ
원예	ᄋ ᅯ ᄂ ᅨ
식물로	ᄉ ᅵ ᆼ ᄆ ᅮ ᆯ ᄅ ᅩ
인기가	ᄋ ᅵ ᆫ ᄀ ᅵ ᄀ ᅡ
많습니다	ᄆ ᅡ ᆫ ᄊ ᅳ ᆷ ᄂ ᅵ ᄃ ᅡ
서식하며	ᄉ ᅥ ᄉ ᅵ ᄏ ᅡ ᄆ ᅧ
밤에는	ᄇ ᅡ ᄆ ᅦ ᄂ ᅳ ᆫ
물고기나	ᄆ ᅮ ᆯ ᄀ ᅩ ᄀ ᅵ ᄂ ᅡ
수생곤충	ᄉ ᅮ ᄉ ᅢ ᆼ ᄀ ᅩ ᆫ ᄎ ᅮ ᆼ
등을	ᄃ ᅳ ᆼ ᄋ ᅳ ᆯ
잡아먹습니다	ᄌ ᅡ ᄇ ᅡ ᄆ ᅥ ᆨ ᄊ ᅳ ᆷ ᄂ ᅵ ᄃ ᅡ
화물을	ᄒ ᅪ ᄆ ᅮ ᄅ ᅳ ᆯ
궤도로	ᄀ ᅰ ᄃ ᅩ ᄅ ᅩ
올리는	ᄋ ᅩ ᆯ ᄅ ᅵ ᄂ ᅳ ᆫ
어렵고	ᄋ ᅥ ᄅ ᅧ ᆸ ᄁ ᅩ
비용이	ᄇ ᅵ ᄋ ᅭ ᆼ ᄋ ᅵ
듭니다	ᄃ ᅳ ᆷ ᄂ ᅵ ᄃ ᅡ
선발	ᄉ ᅥ ᆫ ᄇ ᅡ ᆯ
투수가	ᄐ ᅮ ᄉ ᅮ ᄀ ᅡ
승리투수가	ᄉ ᅳ ᆼ ᄂ ᅵ ᄐ ᅮ ᄉ ᅮ ᄀ ᅡ
되는	ᄃ ᅬ ᄂ ᅳ ᆫ
요건은	ᄋ ᅭ ᄀ ᅥ ᄂ ᅳ ᆫ
오이닝	ᄋ ᅩ ᄋ ᅵ ᄂ ᅵ ᆼ
투구해야	ᄐ ᅮ ᄀ ᅮ ᄒ ᅢ ᄋ ᅣ
구매자가	ᄀ ᅮ ᄆ ᅢ ᄌ ᅡ ᄀ ᅡ
장물임을	ᄌ ᅡ ᆼ ᄆ ᅮ ᄅ ᅵ ᄆ ᅳ ᆯ
샀을	ᄉ ᅡ ᄊ ᅳ ᆯ
경우에는	ᄀ ᅧ ᆼ ᄋ ᅮ ᄋ ᅦ ᄂ ᅳ ᆫ
적용되며	ᄌ ᅥ ᄀ ᅭ ᆼ ᄃ ᅬ ᄆ ᅧ
물건은	ᄆ ᅮ ᆯ ᄀ ᅥ ᄂ ᅳ ᆫ
원소유자에게	ᄋ ᅯ ᆫ ᄉ ᅩ ᄋ ᅲ ᄌ ᅡ ᄋ ᅦ ᄀ ᅦ
귀속된다	ᄀ ᅱ ᄉ ᅩ ᆨ ᄄ ᅬ ᆫ ᄃ ᅡ
관이	ᄀ ᅪ ᄂ ᅵ
있고	ᄋ ᅵ ᆮ ᄁ ᅩ
바람을	ᄇ ᅡ ᄅ ᅡ ᄆ ᅳ ᆯ
넣을	ᄂ ᅥ ᄋ ᅳ ᆯ
있도록	ᄋ ᅵ ᆮ ᄄ ᅩ ᄅ ᅩ ᆨ
풀무가	ᄑ ᅮ ᆯ ᄆ ᅮ ᄀ ᅡ
정보를	ᄌ ᅥ ᆼ ᄇ ᅩ ᄅ ᅳ ᆯ
주지	ᄌ ᅮ ᄌ ᅵ
않으려는	ᄋ ᅡ ᄂ ᅳ ᄅ ᅧ ᄂ ᅳ ᆫ
러시아와	ᄅ ᅥ ᄉ ᅵ ᄋ ᅡ ᄋ ᅪ
입수하려는	ᄋ ᅵ ᆸ ᄊ ᅮ ᄒ ᅡ ᄅ ᅧ ᄂ ᅳ ᆫ
치열한	ᄎ ᅵ ᄋ ᅧ ᆯ ᄒ ᅡ ᆫ
기	ᄀ ᅵ
싸움이	ᄊ ᅡ ᄋ ᅮ ᄆ ᅵ
벌어졌다	ᄇ ᅥ ᄅ ᅥ ᄌ ᅥ ᆮ ᄄ ᅡ
일반적으로	ᄋ ᅵ ᆯ ᄇ ᅡ ᆫ ᄌ ᅥ ᄀ ᅳ ᄅ ᅩ
색온도가	ᄉ ᅢ ᄀ ᅩ ᆫ ᄃ ᅩ ᄀ ᅡ
높을수록	ᄂ ᅩ ᄑ ᅳ ᆯ ᄊ ᅮ ᄅ ᅩ ᆨ
집중력이	ᄌ ᅵ ᆸ ᄍ ᅮ ᆼ ᄂ ᅧ ᄀ ᅵ
상승하며	ᄉ ᅡ ᆼ ᄉ ᅳ ᆼ ᄒ ᅡ ᄆ ᅧ
낮을수록	ᄂ ᅡ ᄌ ᅳ ᆯ ᄊ ᅮ ᄅ ᅩ ᆨ
피로도가	ᄑ ᅵ ᄅ ᅩ ᄃ ᅩ ᄀ ᅡ
감소한다	ᄀ ᅡ ᆷ ᄉ ᅩ ᄒ ᅡ ᆫ ᄃ ᅡ
두꺼운	ᄃ ᅮ ᄁ ᅥ ᄋ ᅮ ᆫ
유리로	ᄋ ᅲ ᄅ ᅵ ᄅ ᅩ
세균을	ᄉ ᅦ ᄀ ᅲ ᄂ ᅳ ᆯ
배양하여	ᄇ ᅢ ᄋ ᅣ ᆼ ᄒ ᅡ ᄋ ᅧ
사용됩니다	ᄉ ᅡ ᄋ ᅭ ᆼ ᄃ ᅬ ᆷ ᄂ ᅵ ᄃ ᅡ
여성을	ᄋ ᅧ ᄉ ᅥ ᆼ ᄋ ᅳ ᆯ
골라	ᄀ ᅩ ᆯ ᄅ ᅡ
하얀색	ᄒ ᅡ ᄋ ᅣ ᆫ ᄉ ᅢ ᆨ
입히고	ᄋ ᅵ ᄑ ᅵ ᄀ ᅩ
피를	ᄑ ᅵ ᄅ ᅳ ᆯ
붉은	ᄇ ᅮ ᆯ ᄀ ᅳ ᆫ
허리띠를	ᄒ ᅥ ᄅ ᅵ ᄄ ᅵ ᄅ ᅳ ᆯ
두르게	ᄃ ᅮ ᄅ ᅳ ᄀ ᅦ
하였다	ᄒ ᅡ ᄋ ᅧ ᆮ ᄄ ᅡ
성능만이	ᄉ ᅥ ᆼ ᄂ ᅳ ᆼ ᄆ ᅡ ᄂ ᅵ
슈퍼카라	ᄉ ᅲ ᄑ ᅥ ᄏ ᅡ ᄅ ᅡ
부를	ᄇ ᅮ ᄅ ᅳ ᆯ
인지도라든지	ᄋ ᅵ ᆫ ᄌ ᅵ ᄃ ᅩ ᄅ ᅡ ᄃ ᅳ ᆫ ᄌ ᅵ
브랜드	ᄇ ᅳ ᄅ ᅢ ᆫ ᄃ ᅳ
가치를	ᄀ ᅡ ᄎ ᅵ ᄅ ᅳ ᆯ
중요시	ᄌ ᅮ ᆼ ᄋ ᅭ ᄉ ᅵ
윈도	ᄋ ᅱ ᆫ ᄃ ᅩ
비스타부터	ᄇ ᅵ ᄉ ᅳ ᄐ ᅡ ᄇ ᅮ ᄐ ᅥ
화려한	ᄒ ᅪ ᄅ ᅧ ᄒ ᅡ ᆫ
그래픽	ᄀ ᅳ ᄅ ᅢ ᄑ ᅵ ᆨ
효과가	ᄒ ᅭ ᄀ ᅪ ᄀ ᅡ
추가되어	ᄎ ᅮ ᄀ ᅡ ᄃ ᅬ ᄋ ᅥ
화려하게	ᄒ ᅪ ᄅ ᅧ ᄒ ᅡ ᄀ ᅦ
이슬람의	ᄋ ᅵ ᄉ ᅳ ᆯ ᄅ ᅡ ᄆ ᅴ
숙원사업을	ᄉ ᅮ ᄀ ᅯ ᆫ ᄉ ᅡ ᄋ ᅥ ᄇ ᅳ ᆯ
재빠르게	ᄌ ᅢ ᄈ ᅡ ᄅ ᅳ ᄀ ᅦ
자신의	ᄌ ᅡ ᄉ ᅵ ᄂ ᅴ
이룩하고	ᄋ ᅵ ᄅ ᅮ ᄏ ᅡ ᄀ ᅩ
싶었기	ᄉ ᅵ ᄑ ᅥ ᆮ ᄁ ᅵ
욕실에서	ᄋ ᅭ ᆨ ᄊ ᅵ ᄅ ᅦ ᄉ ᅥ
미끄러져	ᄆ ᅵ ᄁ ᅳ ᄅ ᅥ ᄌ ᅥ
다치면서	ᄃ ᅡ ᄎ ᅵ ᄆ ᅧ ᆫ ᄉ ᅥ
급사하였습니다	ᄀ ᅳ ᆸ ᄊ ᅡ ᄒ ᅡ ᄋ ᅧ ᆮ ᄊ ᅳ ᆷ ᄂ ᅵ ᄃ ᅡ
술탄의	ᄉ ᅮ ᆯ ᄐ ᅡ ᄂ ᅴ
외우게	ᄋ ᅬ ᄋ ᅮ ᄀ ᅦ
난처한	ᄂ ᅡ ᆫ ᄎ ᅥ ᄒ ᅡ ᆫ
일이어서	ᄋ ᅵ ᄅ ᅵ ᄋ ᅥ ᄉ ᅥ
거두어	ᄀ ᅥ ᄃ ᅮ ᄋ ᅥ
간청하였습니다	ᄀ ᅡ ᆫ ᄎ ᅥ ᆼ ᄒ ᅡ ᄋ ᅧ ᆮ ᄊ ᅳ ᆷ ᄂ ᅵ ᄃ ᅡ
좀처럼	ᄌ ᅩ ᆷ ᄎ ᅥ ᄅ ᅥ ᆷ
만족하지	ᄆ ᅡ ᆫ ᄌ ᅩ ᄏ ᅡ ᄌ ᅵ
못했고	ᄆ ᅩ ᄐ ᅢ ᆮ ᄁ ᅩ
권력을	ᄀ ᅯ ᆯ ᄅ ᅧ ᄀ ᅳ ᆯ
음모를	ᄋ ᅳ ᆷ ᄆ ᅩ ᄅ ᅳ ᆯ
꾸미고	ᄁ ᅮ ᄆ ᅵ ᄀ ᅩ
형태로	ᄒ ᅧ ᆼ ᄐ ᅢ ᄅ ᅩ
마실	ᄆ ᅡ ᄉ ᅵ ᆯ
먹습니다	ᄆ ᅥ ᆨ ᄊ ᅳ ᆷ ᄂ ᅵ ᄃ ᅡ
괜히	ᄀ ᅫ ᆫ ᄒ ᅵ
안주	ᄋ ᅡ ᆫ ᄌ ᅮ
마시게	ᄆ ᅡ ᄉ ᅵ ᄀ ᅦ
취하게	ᄎ ᅱ ᄒ ᅡ ᄀ ᅦ
되므로	ᄃ ᅬ ᄆ ᅳ ᄅ ᅩ
쇠고기는	ᄉ ᅬ ᄀ ᅩ ᄀ ᅵ ᄂ ᅳ ᆫ
질겨져	ᄌ ᅵ ᆯ ᄀ ᅧ ᄌ ᅥ
일반적으론	ᄋ ᅵ ᆯ ᄇ ᅡ ᆫ ᄌ ᅥ ᄀ ᅳ ᄅ ᅩ ᆫ
사용하지	ᄉ ᅡ ᄋ ᅭ ᆼ ᄒ ᅡ ᄌ ᅵ
김치는	ᄀ ᅵ ᆷ ᄎ ᅵ ᄂ ᅳ ᆫ
온도로	ᄋ ᅩ ᆫ ᄃ ᅩ ᄅ ᅩ
끓일	ᄁ ᅳ ᄅ ᅵ ᆯ
유산균이	ᄋ ᅲ ᄉ ᅡ ᆫ ᄀ ᅲ ᄂ ᅵ
파괴되므로	ᄑ ᅡ ᄀ ᅬ ᄃ ᅬ ᄆ ᅳ ᄅ ᅩ
조리하지	ᄌ ᅩ ᄅ ᅵ ᄒ ᅡ ᄌ ᅵ
몸에	ᄆ ᅩ ᄆ ᅦ
볶을	ᄇ ᅩ ᄁ ᅳ ᆯ
사용되는	ᄉ ᅡ ᄋ ᅭ ᆼ ᄃ ᅬ ᄂ ᅳ ᆫ
기름	ᄀ ᅵ ᄅ ᅳ ᆷ
지방	ᄌ ᅵ ᄇ ᅡ ᆼ
함량도	ᄒ ᅡ ᆷ ᄂ ᅣ ᆼ ᄃ ᅩ
편입니다	ᄑ ᅧ ᄂ ᅵ ᆷ ᄂ ᅵ ᄃ ᅡ
생산권	ᄉ ᅢ ᆼ ᄉ ᅡ ᆫ ᄀ ᅯ ᆫ
확보와	ᄒ ᅪ ᆨ ᄈ ᅩ ᄋ ᅪ
유통을	ᄋ ᅲ ᄐ ᅩ ᆼ ᄋ ᅳ ᆯ
장악하기	ᄌ ᅡ ᆼ ᄋ ᅡ ᄏ ᅡ ᄀ ᅵ
온갖	ᄋ ᅩ ᆫ ᄀ ᅡ ᆮ
지혜를	ᄌ ᅵ ᄒ ᅨ ᄅ ᅳ ᆯ
짜내느라	ᄍ ᅡ ᄂ ᅢ ᄂ ᅳ ᄅ ᅡ
고심했다	ᄀ ᅩ ᄉ ᅵ ᆷ ᄒ ᅢ ᆮ ᄄ ᅡ
처음에는	ᄎ ᅥ ᄋ ᅳ ᄆ ᅦ ᄂ ᅳ ᆫ
많지도	ᄆ ᅡ ᆫ ᄎ ᅵ ᄃ ᅩ
싸지도	ᄊ ᅡ ᄌ ᅵ ᄃ ᅩ
않아서	ᄋ ᅡ ᄂ ᅡ ᄉ ᅥ
곳에서는	ᄀ ᅩ ᄉ ᅦ ᄉ ᅥ ᄂ ᅳ ᆫ
꿀을	ᄁ ᅮ ᄅ ᅳ ᆯ
애용하였다	ᄋ ᅢ ᄋ ᅭ ᆼ ᄒ ᅡ ᄋ ᅧ ᆮ ᄄ ᅡ
수많은	ᄉ ᅮ ᄆ ᅡ ᄂ ᅳ ᆫ
초기	ᄎ ᅩ ᄀ ᅵ
사회들은	ᄉ ᅡ ᄒ ᅬ ᄃ ᅳ ᄅ ᅳ ᆫ
신들이	ᄉ ᅵ ᆫ ᄃ ᅳ ᄅ ᅵ
내려준	ᄂ ᅢ ᄅ ᅧ ᄌ ᅮ ᆫ
생각하였다	ᄉ ᅢ ᆼ ᄀ ᅡ ᄏ ᅡ ᄋ ᅧ ᆮ ᄄ ᅡ
빠져나오는	ᄈ ᅡ ᄌ ᅥ ᄂ ᅡ ᄋ ᅩ ᄂ ᅳ ᆫ
탈수	ᄐ ᅡ ᆯ ᄉ ᅮ
반응이	ᄇ ᅡ ᄂ ᅳ ᆼ ᄋ ᅵ
진행되어	ᄌ ᅵ ᆫ ᄒ ᅢ ᆼ ᄃ ᅬ ᄋ ᅥ
미라가	ᄆ ᅵ ᄅ ᅡ ᄀ ᅡ
구소련이	ᄀ ᅮ ᄉ ᅩ ᄅ ᅧ ᄂ ᅵ
해체될	ᄒ ᅢ ᄎ ᅦ ᄃ ᅬ ᆯ
공화국	ᄀ ᅩ ᆼ ᄒ ᅪ ᄀ ᅮ ᆨ
경계대로	ᄀ ᅧ ᆼ ᄀ ᅨ ᄃ ᅢ ᄅ ᅩ
신생	ᄉ ᅵ ᆫ ᄉ ᅢ ᆼ
주권	ᄌ ᅮ ᄀ ᅯ ᆫ
국가들이	ᄀ ᅮ ᆨ ᄁ ᅡ ᄃ ᅳ ᄅ ᅵ
출범하였다	ᄎ ᅮ ᆯ ᄇ ᅥ ᆷ ᄒ ᅡ ᄋ ᅧ ᆮ ᄄ ᅡ
검색을	ᄀ ᅥ ᆷ ᄉ ᅢ ᄀ ᅳ ᆯ
때도	ᄄ ᅢ ᄃ ᅩ
넣어야	ᄂ ᅥ ᄋ ᅥ ᄋ ᅣ
하며	ᄒ ᅡ ᄆ ᅧ
결과	ᄀ ᅧ ᆯ ᄀ ᅪ
글자가	ᄀ ᅳ ᆯ ᄌ ᅡ ᄀ ᅡ
배열된다	ᄇ ᅢ ᄋ ᅧ ᆯ ᄃ ᅬ ᆫ ᄃ ᅡ
과학자들이	ᄀ ᅪ ᄒ ᅡ ᆨ ᄍ ᅡ ᄃ ᅳ ᄅ ᅵ
유전자	ᄋ ᅲ ᄌ ᅥ ᆫ ᄌ ᅡ
조작을	ᄌ ᅩ ᄌ ᅡ ᄀ ᅳ ᆯ
배아를	ᄇ ᅢ ᄋ ᅡ ᄅ ᅳ ᆯ
만들었다고	ᄆ ᅡ ᆫ ᄃ ᅳ ᄅ ᅥ ᆮ ᄄ ᅡ ᄀ ᅩ
정신을	ᄌ ᅥ ᆼ ᄉ ᅵ ᄂ ᅳ ᆯ
바짝	ᄇ ᅡ ᄍ ᅡ ᆨ
차리고	ᄎ ᅡ ᄅ ᅵ ᄀ ᅩ
조작이라고	ᄌ ᅩ ᄌ ᅡ ᄀ ᅵ ᄅ ᅡ ᄀ ᅩ
이야기하라고	ᄋ ᅵ ᄋ ᅣ ᄀ ᅵ ᄒ ᅡ ᄅ ᅡ ᄀ ᅩ
지시했다	ᄌ ᅵ ᄉ ᅵ ᄒ ᅢ ᆮ ᄄ ᅡ
조작하는	ᄌ ᅩ ᄌ ᅡ ᄏ ᅡ ᄂ ᅳ ᆫ
발생할	ᄇ ᅡ ᆯ ᄉ ᅢ ᆼ ᄒ ᅡ ᆯ
상황을	ᄉ ᅡ ᆼ ᄒ ᅪ ᆼ ᄋ ᅳ ᆯ
놓았다	ᄂ ᅩ ᄋ ᅡ ᆮ ᄄ ᅡ
스토리의	ᄉ ᅳ ᄐ ᅩ ᄅ ᅵ ᄋ ᅴ
흐름과는	ᄒ ᅳ ᄅ ᅳ ᆷ ᄀ ᅪ ᄂ ᅳ ᆫ
연관성이	ᄋ ᅧ ᆫ ᄀ ᅪ ᆫ ᄉ ᅥ ᆼ ᄋ ᅵ
보였다	ᄇ ᅩ ᄋ ᅧ ᆮ ᄄ ᅡ
한기만	ᄒ ᅡ ᆫ ᄀ ᅵ ᄆ ᅡ ᆫ
일에서	ᄋ ᅵ ᄅ ᅦ ᄉ ᅥ
이주일간	ᄋ ᅵ ᄌ ᅮ ᄋ ᅵ ᆯ ᄀ ᅡ ᆫ
강한	ᄀ ᅡ ᆼ ᄒ ᅡ ᆫ
윈도우	ᄋ ᅱ ᆫ ᄃ ᅩ ᄋ ᅮ
