심폐소생술	ᄉ ᅵ ᆷ ᄑ ᅨ ᄉ ᅩ ᄉ ᅢ ᆼ ᄉ ᅮ ᆯ
자격증	ᄌ ᅡ ᄀ ᅧ ᆨ ᄍ ᅳ ᆼ
취득을	ᄎ ᅱ ᄃ ᅳ ᄀ ᅳ ᆯ
원하시면	ᄋ ᅯ ᆫ ᄒ ᅡ ᄉ ᅵ ᄆ ᅧ ᆫ
인터넷으로	ᄋ ᅵ ᆫ ᄐ ᅥ ᄂ ᅦ ᄉ ᅳ ᄅ ᅩ
신청해	ᄉ ᅵ ᆫ ᄎ ᅥ ᆼ ᄒ ᅢ
주세요	ᄌ ᅮ ᄉ ᅦ ᄋ ᅭ
주연	ᄌ ᅮ ᄋ ᅧ ᆫ
배우	ᄇ ᅢ ᄋ ᅮ
캐스팅이	ᄏ ᅢ ᄉ ᅳ ᄐ ᅵ ᆼ ᄋ ᅵ
마무리되는	ᄆ ᅡ ᄆ ᅮ ᄅ ᅵ ᄃ ᅬ ᄂ ᅳ ᆫ
대로	ᄃ ᅢ ᄅ ᅩ
촬영을	ᄎ ᅪ ᄅ ᅧ ᆼ ᄋ ᅳ ᆯ
시작할	ᄉ ᅵ ᄌ ᅡ ᄏ ᅡ ᆯ
거래	ᄀ ᅥ ᄅ ᅢ
드라마	ᄃ ᅳ ᄅ ᅡ ᄆ ᅡ
관계자	ᄀ ᅪ ᆫ ᄀ ᅨ ᄌ ᅡ
분들은	ᄇ ᅮ ᆫ ᄃ ᅳ ᄅ ᅳ ᆫ
모두	ᄆ ᅩ ᄃ ᅮ
회의실로	ᄒ ᅬ ᄋ ᅴ ᄉ ᅵ ᆯ ᄅ ᅩ
들어와	ᄃ ᅳ ᄅ ᅥ ᄋ ᅪ
주십시오	ᄌ ᅮ ᄉ ᅵ ᆸ ᄊ ᅵ ᄋ ᅩ
현재	ᄒ ᅧ ᆫ ᄌ ᅢ
본	ᄇ ᅩ ᆫ
사건과	ᄉ ᅡ ᄀ ᅥ ᆫ ᄀ ᅪ
관련하여	ᄀ ᅪ ᆯ ᄅ ᅧ ᆫ ᄒ ᅡ ᄋ ᅧ
내부	ᄂ ᅢ ᄇ ᅮ
감사를	ᄀ ᅡ ᆷ ᄉ ᅡ ᄅ ᅳ ᆯ
진행하고	ᄌ ᅵ ᆫ ᄒ ᅢ ᆼ ᄒ ᅡ ᄀ ᅩ
있습니다	ᄋ ᅵ ᆮ ᄊ ᅳ ᆷ ᄂ ᅵ ᄃ ᅡ
불국사와	ᄇ ᅮ ᆯ ᄀ ᅮ ᆨ ᄊ ᅡ ᄋ ᅪ
석굴암은	ᄉ ᅥ ᆨ ᄁ ᅮ ᄅ ᅡ ᄆ ᅳ ᆫ
유네스코	ᄋ ᅲ ᄂ ᅦ ᄉ ᅳ ᄏ ᅩ
세계문화유산으로	ᄉ ᅦ ᄀ ᅨ ᄆ ᅮ ᆫ ᄒ ᅪ ᄋ ᅲ ᄉ ᅡ ᄂ ᅳ ᄅ ᅩ
등재되어	ᄃ ᅳ ᆼ ᄌ ᅢ ᄃ ᅬ ᄋ ᅥ
있어	ᄋ ᅵ ᄊ ᅥ
우정을	ᄋ ᅮ ᄌ ᅥ ᆼ ᄋ ᅳ ᆯ
진화심리학의	ᄌ ᅵ ᆫ ᄒ ᅪ ᄉ ᅵ ᆷ ᄂ ᅵ ᄒ ᅡ ᄀ ᅴ
관점에서	ᄀ ᅪ ᆫ ᄌ ᅥ ᄆ ᅦ ᄉ ᅥ
분석하려는	ᄇ ᅮ ᆫ ᄉ ᅥ ᄏ ᅡ ᄅ ᅧ ᄂ ᅳ ᆫ
시도가	ᄉ ᅵ ᄃ ᅩ ᄀ ᅡ
있었습니다	ᄋ ᅵ ᄊ ᅥ ᆮ ᄊ ᅳ ᆷ ᄂ ᅵ ᄃ ᅡ
죄송하지만	ᄌ ᅬ ᄉ ᅩ ᆼ ᄒ ᅡ ᄌ ᅵ ᄆ ᅡ ᆫ
여기서	ᄋ ᅧ ᄀ ᅵ ᄉ ᅥ
가장	ᄀ ᅡ ᄌ ᅡ ᆼ
가까운	ᄀ ᅡ ᄁ ᅡ ᄋ ᅮ ᆫ
버스	ᄇ ᅥ ᄉ ᅳ
정류장이	ᄌ ᅥ ᆼ ᄂ ᅲ ᄌ ᅡ ᆼ ᄋ ᅵ
어디에	ᄋ ᅥ ᄃ ᅵ ᄋ ᅦ
있습니까	ᄋ ᅵ ᆮ ᄊ ᅳ ᆷ ᄂ ᅵ ᄁ ᅡ
소설	ᄉ ᅩ ᄉ ᅥ ᆯ
백경의	ᄇ ᅢ ᆨ ᄁ ᅧ ᆼ ᄋ ᅴ
주인공으로	ᄌ ᅮ ᄋ ᅵ ᆫ ᄀ ᅩ ᆼ ᄋ ᅳ ᄅ ᅩ
나왔던	ᄂ ᅡ ᄋ ᅪ ᆮ ᄄ ᅥ ᆫ
향유고래의	ᄒ ᅣ ᆼ ᄋ ᅲ ᄀ ᅩ ᄅ ᅢ ᄋ ᅴ
몸무게는	ᄆ ᅩ ᆷ ᄆ ᅮ ᄀ ᅦ ᄂ ᅳ ᆫ
수십	ᄉ ᅮ ᄉ ᅵ ᆸ
톤에	ᄐ ᅩ ᄂ ᅦ
달합니다	ᄃ ᅡ ᆯ ᄒ ᅡ ᆷ ᄂ ᅵ ᄃ ᅡ
지구	ᄌ ᅵ ᄀ ᅮ
온난화로	ᄋ ᅩ ᆫ ᄂ ᅡ ᆫ ᄒ ᅪ ᄅ ᅩ
인해	ᄋ ᅵ ᆫ ᄒ ᅢ
나타나는	ᄂ ᅡ ᄐ ᅡ ᄂ ᅡ ᄂ ᅳ ᆫ
현상들을	ᄒ ᅧ ᆫ ᄉ ᅡ ᆼ ᄃ ᅳ ᄅ ᅳ ᆯ
잘	ᄌ ᅡ ᆯ
정리해	ᄌ ᅥ ᆼ ᄂ ᅵ ᄒ ᅢ
보세요	ᄇ ᅩ ᄉ ᅦ ᄋ ᅭ
국립중앙박물관의	ᄀ ᅮ ᆼ ᄂ ᅵ ᆸ ᄍ ᅮ ᆼ ᄋ ᅡ ᆼ ᄇ ᅡ ᆼ ᄆ ᅮ ᆯ ᄀ ᅪ ᄂ ᅴ
개관	ᄀ ᅢ ᄀ ᅪ ᆫ
시간은	ᄉ ᅵ ᄀ ᅡ ᄂ ᅳ ᆫ
오전	ᄋ ᅩ ᄌ ᅥ ᆫ
열	ᄋ ᅧ ᆯ
시입니다	ᄉ ᅵ ᄋ ᅵ ᆷ ᄂ ᅵ ᄃ ᅡ
세종문화회관에서	ᄉ ᅦ ᄌ ᅩ ᆼ ᄆ ᅮ ᆫ ᄒ ᅪ ᄒ ᅬ ᄀ ᅪ ᄂ ᅦ ᄉ ᅥ
사진전이	ᄉ ᅡ ᄌ ᅵ ᆫ ᄌ ᅥ ᄂ ᅵ
있다는데	ᄋ ᅵ ᆮ ᄄ ᅡ ᄂ ᅳ ᆫ ᄃ ᅦ
같이	ᄀ ᅡ ᄎ ᅵ
가볼래	ᄀ ᅡ ᄇ ᅩ ᆯ ᄅ ᅢ
오월은	ᄋ ᅩ ᄋ ᅯ ᄅ ᅳ ᆫ
가정의	ᄀ ᅡ ᄌ ᅥ ᆼ ᄋ ᅴ
달이라	ᄃ ᅡ ᄅ ᅵ ᄅ ᅡ
특별	ᄐ ᅳ ᆨ ᄈ ᅧ ᆯ
공연이	ᄀ ᅩ ᆼ ᄋ ᅧ ᄂ ᅵ
많이	ᄆ ᅡ ᄂ ᅵ
계획되어	ᄀ ᅨ ᄒ ᅬ ᆨ ᄄ ᅬ ᄋ ᅥ
있대	ᄋ ᅵ ᆮ ᄄ ᅢ
오늘	ᄋ ᅩ ᄂ ᅳ ᆯ
오후에	ᄋ ᅩ ᄒ ᅮ ᄋ ᅦ
비가	ᄇ ᅵ ᄀ ᅡ
온다고	ᄋ ᅩ ᆫ ᄃ ᅡ ᄀ ᅩ
하니까	ᄒ ᅡ ᄂ ᅵ ᄁ ᅡ
우산을	ᄋ ᅮ ᄉ ᅡ ᄂ ᅳ ᆯ
꼭	ᄁ ᅩ ᆨ
챙겨	ᄎ ᅢ ᆼ ᄀ ᅧ
불규칙한	ᄇ ᅮ ᆯ ᄀ ᅲ ᄎ ᅵ ᄏ ᅡ ᆫ
식사	ᄉ ᅵ ᆨ ᄊ ᅡ
습관과	ᄉ ᅳ ᆸ ᄁ ᅪ ᆫ ᄀ ᅪ
과식은	ᄀ ᅪ ᄉ ᅵ ᄀ ᅳ ᆫ
소화	ᄉ ᅩ ᄒ ᅪ
불량의	ᄇ ᅮ ᆯ ᄅ ᅣ ᆼ ᄋ ᅴ
원인이	ᄋ ᅯ ᄂ ᅵ ᄂ ᅵ
돼	ᄃ ᅫ
그	ᄀ ᅳ
문제는	ᄆ ᅮ ᆫ ᄌ ᅦ ᄂ ᅳ ᆫ
중앙선거관리위원회에	ᄌ ᅮ ᆼ ᄋ ᅡ ᆼ ᄉ ᅥ ᆫ ᄀ ᅥ ᄀ ᅪ ᆯ ᄅ ᅵ ᄋ ᅱ ᄋ ᅯ ᆫ ᄒ ᅬ ᄋ ᅦ
문의해	ᄆ ᅮ ᄂ ᅴ ᄒ ᅢ
보셔야	ᄇ ᅩ ᄉ ᅧ ᄋ ᅣ
합니다	ᄒ ᅡ ᆷ ᄂ ᅵ ᄃ ᅡ
북미	ᄇ ᅮ ᆼ ᄆ ᅵ
정상회담의	ᄌ ᅥ ᆼ ᄉ ᅡ ᆼ ᄒ ᅬ ᄃ ᅡ ᄆ ᅴ
일정과	ᄋ ᅵ ᆯ ᄌ ᅥ ᆼ ᄀ ᅪ
장소가	ᄌ ᅡ ᆼ ᄉ ᅩ ᄀ ᅡ
이번	ᄋ ᅵ ᄇ ᅥ ᆫ
주	ᄌ ᅮ
내로	ᄂ ᅢ ᄅ ᅩ
공개될	ᄀ ᅩ ᆼ ᄀ ᅢ ᄃ ᅬ ᆯ
예정입니다	ᄋ ᅨ ᄌ ᅥ ᆼ ᄋ ᅵ ᆷ ᄂ ᅵ ᄃ ᅡ
아프가니스탄에서	ᄋ ᅡ ᄑ ᅳ ᄀ ᅡ ᄂ ᅵ ᄉ ᅳ ᄐ ᅡ ᄂ ᅦ ᄉ ᅥ
지진으로	ᄌ ᅵ ᄌ ᅵ ᄂ ᅳ ᄅ ᅩ
현재까지	ᄒ ᅧ ᆫ ᄌ ᅢ ᄁ ᅡ ᄌ ᅵ
명의	ᄆ ᅧ ᆼ ᄋ ᅴ
부상자가	ᄇ ᅮ ᄉ ᅡ ᆼ ᄌ ᅡ ᄀ ᅡ
발생했다고	ᄇ ᅡ ᆯ ᄉ ᅢ ᆼ ᄒ ᅢ ᆮ ᄄ ᅡ ᄀ ᅩ
전해졌습니다	ᄌ ᅥ ᆫ ᄒ ᅢ ᄌ ᅥ ᆮ ᄊ ᅳ ᆷ ᄂ ᅵ ᄃ ᅡ
파블로	ᄑ ᅡ ᄇ ᅳ ᆯ ᄅ ᅩ
피카소의	ᄑ ᅵ ᄏ ᅡ ᄉ ᅩ ᄋ ᅴ
그림이	ᄀ ᅳ ᄅ ᅵ ᄆ ᅵ
천오백억	ᄎ ᅥ ᄂ ᅩ ᄇ ᅢ ᄀ ᅥ ᆨ
원에	ᄋ ᅯ ᄂ ᅦ
낙찰되었대요	ᄂ ᅡ ᆨ ᄎ ᅡ ᆯ ᄃ ᅬ ᄋ ᅥ ᆮ ᄄ ᅢ ᄋ ᅭ
내년	ᄂ ᅢ ᄂ ᅧ ᆫ
초	ᄎ ᅩ
어린이용	ᄋ ᅥ ᄅ ᅵ ᄂ ᅵ ᄋ ᅭ ᆼ
스마트워치가	ᄉ ᅳ ᄆ ᅡ ᄐ ᅳ ᄋ ᅯ ᄎ ᅵ ᄀ ᅡ
출시될	ᄎ ᅮ ᆯ ᄉ ᅵ ᄃ ᅬ ᆯ
말초	ᄆ ᅡ ᆯ ᄎ ᅩ
신경계는	ᄉ ᅵ ᆫ ᄀ ᅧ ᆼ ᄀ ᅨ ᄂ ᅳ ᆫ
몸	ᄆ ᅩ ᆷ
신경계와	ᄉ ᅵ ᆫ ᄀ ᅧ ᆼ ᄀ ᅨ ᄋ ᅪ
자율신경계로	ᄌ ᅡ ᄋ ᅲ ᆯ ᄉ ᅵ ᆫ ᄀ ᅧ ᆼ ᄀ ᅨ ᄅ ᅩ
나뉩니다	ᄂ ᅡ ᄂ ᅱ ᆷ ᄂ ᅵ ᄃ ᅡ
두산	ᄃ ᅮ ᄉ ᅡ ᆫ
베어스	ᄇ ᅦ ᄋ ᅥ ᄉ ᅳ
선수단이	ᄉ ᅥ ᆫ ᄉ ᅮ ᄃ ᅡ ᄂ ᅵ
내일	ᄂ ᅢ ᄋ ᅵ ᆯ
호주로	ᄒ ᅩ ᄌ ᅮ ᄅ ᅩ
전지	ᄌ ᅥ ᆫ ᄌ ᅵ
훈련을	ᄒ ᅮ ᆯ ᄅ ᅧ ᄂ ᅳ ᆯ
떠날	ᄄ ᅥ ᄂ ᅡ ᆯ
이	ᄋ ᅵ
대리와	ᄃ ᅢ ᄅ ᅵ ᄋ ᅪ
김	ᄀ ᅵ ᆷ
대리는	ᄃ ᅢ ᄅ ᅵ ᄂ ᅳ ᆫ
백화점에서	ᄇ ᅢ ᄏ ᅪ ᄌ ᅥ ᄆ ᅦ ᄉ ᅥ
시장조사를	ᄉ ᅵ ᄌ ᅡ ᆼ ᄌ ᅩ ᄉ ᅡ ᄅ ᅳ ᆯ
해주세요	ᄒ ᅢ ᄌ ᅮ ᄉ ᅦ ᄋ ᅭ
화장품도	ᄒ ᅪ ᄌ ᅡ ᆼ ᄑ ᅮ ᆷ ᄃ ᅩ
유통기한과	ᄋ ᅲ ᄐ ᅩ ᆼ ᄀ ᅵ ᄒ ᅡ ᆫ ᄀ ᅪ
제조	ᄌ ᅦ ᄌ ᅩ
일자를	ᄋ ᅵ ᆯ ᄌ ᅡ ᄅ ᅳ ᆯ
확인하고	ᄒ ᅪ ᄀ ᅵ ᆫ ᄒ ᅡ ᄀ ᅩ
써야	ᄊ ᅥ ᄋ ᅣ
해	ᄒ ᅢ
색상은	ᄉ ᅢ ᆨ ᄊ ᅡ ᆼ ᄋ ᅳ ᆫ
베이지로	ᄇ ᅦ ᄋ ᅵ ᄌ ᅵ ᄅ ᅩ
크기는	ᄏ ᅳ ᄀ ᅵ ᄂ ᅳ ᆫ
작은	ᄌ ᅡ ᄀ ᅳ ᆫ
치수로	ᄎ ᅵ ᄉ ᅮ ᄅ ᅩ
하나	ᄒ ᅡ ᄂ ᅡ
이태원에	ᄋ ᅵ ᄐ ᅢ ᄋ ᅯ ᄂ ᅦ
새로	ᄉ ᅢ ᄅ ᅩ
생긴	ᄉ ᅢ ᆼ ᄀ ᅵ ᆫ
쌀국수집	ᄊ ᅡ ᆯ ᄀ ᅮ ᆨ ᄊ ᅮ ᄌ ᅵ ᆸ
가서	ᄀ ᅡ ᄉ ᅥ
저녁	ᄌ ᅥ ᄂ ᅧ ᆨ
먹자	ᄆ ᅥ ᆨ ᄍ ᅡ
그럼	ᄀ ᅳ ᄅ ᅥ ᆷ
아홉	ᄋ ᅡ ᄒ ᅩ ᆸ
시에	ᄉ ᅵ ᄋ ᅦ
회사	ᄒ ᅬ ᄉ ᅡ
앞	ᄋ ᅡ ᆸ
카페에서	ᄏ ᅡ ᄑ ᅦ ᄋ ᅦ ᄉ ᅥ
뵙죠	ᄇ ᅬ ᆸ ᄍ ᅭ
개명은	ᄀ ᅢ ᄆ ᅧ ᆼ ᄋ ᅳ ᆫ
법률상	ᄇ ᅥ ᆷ ᄂ ᅲ ᆯ ᄉ ᅡ ᆼ
이름을	ᄋ ᅵ ᄅ ᅳ ᄆ ᅳ ᆯ
바꾸는	ᄇ ᅡ ᄁ ᅮ ᄂ ᅳ ᆫ
일을	ᄋ ᅵ ᄅ ᅳ ᆯ
말해	ᄆ ᅡ ᆯ ᄒ ᅢ
황제펭귄은	ᄒ ᅪ ᆼ ᄌ ᅦ ᄑ ᅦ ᆼ ᄀ ᅱ ᄂ ᅳ ᆫ
지구상에	ᄌ ᅵ ᄀ ᅮ ᄉ ᅡ ᆼ ᄋ ᅦ
있는	ᄋ ᅵ ᆫ ᄂ ᅳ ᆫ
펭귄	ᄑ ᅦ ᆼ ᄀ ᅱ ᆫ
중	ᄌ ᅮ ᆼ
몸집이	ᄆ ᅩ ᆷ ᄌ ᅵ ᄇ ᅵ
커	ᄏ ᅥ
양키	ᄋ ᅣ ᆼ ᄏ ᅵ
스타디움은	ᄉ ᅳ ᄐ ᅡ ᄃ ᅵ ᄋ ᅮ ᄆ ᅳ ᆫ
메이저리그를	ᄆ ᅦ ᄋ ᅵ ᄌ ᅥ ᄅ ᅵ ᄀ ᅳ ᄅ ᅳ ᆯ
상징하는	ᄉ ᅡ ᆼ ᄌ ᅵ ᆼ ᄒ ᅡ ᄂ ᅳ ᆫ
야구장이죠	ᄋ ᅣ ᄀ ᅮ ᄌ ᅡ ᆼ ᄋ ᅵ ᄌ ᅭ
지문으로	ᄌ ᅵ ᄆ ᅮ ᄂ ᅳ ᄅ ᅩ
범인을	ᄇ ᅥ ᄆ ᅵ ᄂ ᅳ ᆯ
찾을	ᄎ ᅡ ᄌ ᅳ ᆯ
방법에	ᄇ ᅡ ᆼ ᄇ ᅥ ᄇ ᅦ
대해	ᄃ ᅢ ᄒ ᅢ
알고	ᄋ ᅡ ᆯ ᄀ ᅩ
계세요	ᄀ ᅨ ᄉ ᅦ ᄋ ᅭ
발표	ᄇ ᅡ ᆯ ᄑ ᅭ
자료는	ᄌ ᅡ ᄅ ᅭ ᄂ ᅳ ᆫ
회의	ᄒ ᅬ ᄋ ᅴ
전에	ᄌ ᅥ ᄂ ᅦ
미리	ᄆ ᅵ ᄅ ᅵ
메일로	ᄆ ᅦ ᄋ ᅵ ᆯ ᄅ ᅩ
보내주세요	ᄇ ᅩ ᄂ ᅢ ᄌ ᅮ ᄉ ᅦ ᄋ ᅭ
전염병을	ᄌ ᅥ ᄂ ᅧ ᆷ ᄇ ᅧ ᆼ ᄋ ᅳ ᆯ
예방하려면	ᄋ ᅨ ᄇ ᅡ ᆼ ᄒ ᅡ ᄅ ᅧ ᄆ ᅧ ᆫ
철저한	ᄎ ᅥ ᆯ ᄌ ᅥ ᄒ ᅡ ᆫ
소독과	ᄉ ᅩ ᄃ ᅩ ᆨ ᄁ ᅪ
멸균이	ᄆ ᅧ ᆯ ᄀ ᅲ ᄂ ᅵ
중요합니다	ᄌ ᅮ ᆼ ᄋ ᅭ ᄒ ᅡ ᆷ ᄂ ᅵ ᄃ ᅡ
노르웨이에	ᄂ ᅩ ᄅ ᅳ ᄋ ᅰ ᄋ ᅵ ᄋ ᅦ
가실	ᄀ ᅡ ᄉ ᅵ ᆯ
거라면	ᄀ ᅥ ᄅ ᅡ ᄆ ᅧ ᆫ
여름이	ᄋ ᅧ ᄅ ᅳ ᄆ ᅵ
여행하기	ᄋ ᅧ ᄒ ᅢ ᆼ ᄒ ᅡ ᄀ ᅵ
좋은	ᄌ ᅩ ᄋ ᅳ ᆫ
계절이에요	ᄀ ᅨ ᄌ ᅥ ᄅ ᅵ ᄋ ᅦ ᄋ ᅭ
미국	ᄆ ᅵ ᄀ ᅮ ᆨ
하와이주	ᄒ ᅡ ᄋ ᅪ ᄋ ᅵ ᄌ ᅮ
하와이	ᄒ ᅡ ᄋ ᅪ ᄋ ᅵ
섬에서	ᄉ ᅥ ᄆ ᅦ ᄉ ᅥ
칠일째	ᄎ ᅵ ᄅ ᅵ ᆯ ᄍ ᅢ
화산	ᄒ ᅪ ᄉ ᅡ ᆫ
지진	ᄌ ᅵ ᄌ ᅵ ᆫ
활동이	ᄒ ᅪ ᆯ ᄃ ᅩ ᆼ ᄋ ᅵ
계속되고	ᄀ ᅨ ᄉ ᅩ ᆨ ᄄ ᅬ ᄀ ᅩ
덕수궁	ᄃ ᅥ ᆨ ᄊ ᅮ ᄀ ᅮ ᆼ
석조전은	ᄉ ᅥ ᆨ ᄍ ᅩ ᄌ ᅥ ᄂ ᅳ ᆫ
최초의	ᄎ ᅬ ᄎ ᅩ ᄋ ᅴ
서양식	ᄉ ᅥ ᄋ ᅣ ᆼ ᄉ ᅵ ᆨ
석조	ᄉ ᅥ ᆨ ᄍ ᅩ
건물로	ᄀ ᅥ ᆫ ᄆ ᅮ ᆯ ᄅ ᅩ
알려졌어	ᄋ ᅡ ᆯ ᄅ ᅧ ᄌ ᅥ ᄊ ᅥ
입춘은	ᄋ ᅵ ᆸ ᄎ ᅮ ᄂ ᅳ ᆫ
대한과	ᄃ ᅢ ᄒ ᅡ ᆫ ᄀ ᅪ
우수	ᄋ ᅮ ᄉ ᅮ
사이에	ᄉ ᅡ ᄋ ᅵ ᄋ ᅦ
절기입니다	ᄌ ᅥ ᆯ ᄀ ᅵ ᄋ ᅵ ᆷ ᄂ ᅵ ᄃ ᅡ
아보카도는	ᄋ ᅡ ᄇ ᅩ ᄏ ᅡ ᄃ ᅩ ᄂ ᅳ ᆫ
멕시코가	ᄆ ᅦ ᆨ ᄊ ᅵ ᄏ ᅩ ᄀ ᅡ
원산지이고	ᄋ ᅯ ᆫ ᄉ ᅡ ᆫ ᄌ ᅵ ᄋ ᅵ ᄀ ᅩ
비타민과	ᄇ ᅵ ᄐ ᅡ ᄆ ᅵ ᆫ ᄀ ᅪ
미네랄이	ᄆ ᅵ ᄂ ᅦ ᄅ ᅡ ᄅ ᅵ
풍부한	ᄑ ᅮ ᆼ ᄇ ᅮ ᄒ ᅡ ᆫ
과일이에요	ᄀ ᅪ ᄋ ᅵ ᄅ ᅵ ᄋ ᅦ ᄋ ᅭ
오트밀은	ᄋ ᅩ ᄐ ᅳ ᄆ ᅵ ᄅ ᅳ ᆫ
식이섬유가	ᄉ ᅵ ᄀ ᅵ ᄉ ᅥ ᄆ ᅲ ᄀ ᅡ
풍부해서	ᄑ ᅮ ᆼ ᄇ ᅮ ᄒ ᅢ ᄉ ᅥ
아침	ᄋ ᅡ ᄎ ᅵ ᆷ
대용으로도	ᄃ ᅢ ᄋ ᅭ ᆼ ᄋ ᅳ ᄅ ᅩ ᄃ ᅩ
좋아	ᄌ ᅩ ᄋ ᅡ
프랑스	ᄑ ᅳ ᄅ ᅡ ᆼ ᄉ ᅳ
인권	ᄋ ᅵ ᆫ ᄀ ᅯ ᆫ
선언은	ᄉ ᅥ ᄂ ᅥ ᄂ ᅳ ᆫ
천칠백팔십구년에	ᄎ ᅥ ᆫ ᄎ ᅵ ᆯ ᄇ ᅢ ᆨ ᄑ ᅡ ᆯ ᄉ ᅵ ᆸ ᄁ ᅮ ᄂ ᅧ ᄂ ᅦ
선포되었습니다	ᄉ ᅥ ᆫ ᄑ ᅩ ᄃ ᅬ ᄋ ᅥ ᆮ ᄊ ᅳ ᆷ ᄂ ᅵ ᄃ ᅡ
프로젝트	ᄑ ᅳ ᄅ ᅩ ᄌ ᅦ ᆨ ᄐ ᅳ
연락해	ᄋ ᅧ ᆯ ᄅ ᅡ ᄏ ᅢ
나눠드린	ᄂ ᅡ ᄂ ᅯ ᄃ ᅳ ᄅ ᅵ ᆫ
유인물은	ᄋ ᅲ ᄋ ᅵ ᆫ ᄆ ᅮ ᄅ ᅳ ᆫ
다음	ᄃ ᅡ ᄋ ᅳ ᆷ
수업	ᄉ ᅮ ᄋ ᅥ ᆸ
시간에도	ᄉ ᅵ ᄀ ᅡ ᄂ ᅦ ᄃ ᅩ
챙겨오세요	ᄎ ᅢ ᆼ ᄀ ᅧ ᄋ ᅩ ᄉ ᅦ ᄋ ᅭ
다	ᄃ ᅡ
쓰신	ᄊ ᅳ ᄉ ᅵ ᆫ
일회용	ᄋ ᅵ ᆯ ᄒ ᅬ ᄋ ᅭ ᆼ
컵은	ᄏ ᅥ ᄇ ᅳ ᆫ
여기에	ᄋ ᅧ ᄀ ᅵ ᄋ ᅦ
두시면	ᄃ ᅮ ᄉ ᅵ ᄆ ᅧ ᆫ
됩니다	ᄃ ᅬ ᆷ ᄂ ᅵ ᄃ ᅡ
어제	ᄋ ᅥ ᄌ ᅦ
흰	ᄒ ᅵ ᆫ
셔츠에	ᄉ ᅧ ᄎ ᅳ ᄋ ᅦ
검은	ᄀ ᅥ ᄆ ᅳ ᆫ
바지	ᄇ ᅡ ᄌ ᅵ
입었던	ᄋ ᅵ ᄇ ᅥ ᆮ ᄄ ᅥ ᆫ
분	ᄇ ᅮ ᆫ
말이지	ᄆ ᅡ ᄅ ᅵ ᄌ ᅵ
달	ᄃ ᅡ ᆯ
경에	ᄀ ᅧ ᆼ ᄋ ᅦ
한	ᄒ ᅡ ᆫ
번	ᄇ ᅥ ᆫ
들를	ᄃ ᅳ ᆯ ᄅ ᅳ ᆯ
일이	ᄋ ᅵ ᄅ ᅵ
있을	ᄋ ᅵ ᄊ ᅳ ᆯ
것	ᄀ ᅥ ᆮ
같아	ᄀ ᅡ ᄐ ᅡ
내가	ᄂ ᅢ ᄀ ᅡ
자료	ᄌ ᅡ ᄅ ᅭ
조사할	ᄌ ᅩ ᄉ ᅡ ᄒ ᅡ ᆯ
테니까	ᄐ ᅦ ᄂ ᅵ ᄁ ᅡ
스크립트	ᄉ ᅳ ᄏ ᅳ ᄅ ᅵ ᆸ ᄐ ᅳ
작성은	ᄌ ᅡ ᆨ ᄊ ᅥ ᆼ ᄋ ᅳ ᆫ
네가	ᄂ ᅦ ᄀ ᅡ
맡아줘	ᄆ ᅡ ᄐ ᅡ ᄌ ᅯ
우리	ᄋ ᅮ ᄅ ᅵ
하숙집은	ᄒ ᅡ ᄉ ᅮ ᆨ ᄍ ᅵ ᄇ ᅳ ᆫ
벽에	ᄇ ᅧ ᄀ ᅦ
대문이	ᄃ ᅢ ᄆ ᅮ ᄂ ᅵ
파란색인	ᄑ ᅡ ᄅ ᅡ ᆫ ᄉ ᅢ ᄀ ᅵ ᆫ
삼층짜리	ᄉ ᅡ ᆷ ᄎ ᅳ ᆼ ᄍ ᅡ ᄅ ᅵ
집이야	ᄌ ᅵ ᄇ ᅵ ᄋ ᅣ
쭉	ᄍ ᅮ ᆨ
가시다가	ᄀ ᅡ ᄉ ᅵ ᄃ ᅡ ᄀ ᅡ
교차로	ᄀ ᅭ ᄎ ᅡ ᄅ ᅩ
끼고	ᄁ ᅵ ᄀ ᅩ
오른쪽으로	ᄋ ᅩ ᄅ ᅳ ᆫ ᄍ ᅩ ᄀ ᅳ ᄅ ᅩ
도시면	ᄃ ᅩ ᄉ ᅵ ᄆ ᅧ ᆫ
보여요	ᄇ ᅩ ᄋ ᅧ ᄋ ᅭ
내일은	ᄂ ᅢ ᄋ ᅵ ᄅ ᅳ ᆫ
자폐인의	ᄌ ᅡ ᄑ ᅨ ᄋ ᅵ ᄂ ᅴ
날이니	ᄂ ᅡ ᄅ ᅵ ᄂ ᅵ
파란색	ᄑ ᅡ ᄅ ᅡ ᆫ ᄉ ᅢ ᆨ
티를	ᄐ ᅵ ᄅ ᅳ ᆯ
입고	ᄋ ᅵ ᆸ ᄁ ᅩ
오렴	ᄋ ᅩ ᄅ ᅧ ᆷ
주차장	ᄌ ᅮ ᄎ ᅡ ᄌ ᅡ ᆼ
바닥	ᄇ ᅡ ᄃ ᅡ ᆨ
공사가	ᄀ ᅩ ᆼ ᄉ ᅡ ᄀ ᅡ
예정되어	ᄋ ᅨ ᄌ ᅥ ᆼ ᄃ ᅬ ᄋ ᅥ
있으니	ᄋ ᅵ ᄊ ᅳ ᄂ ᅵ
차량을	ᄎ ᅡ ᄅ ᅣ ᆼ ᄋ ᅳ ᆯ
이동시켜	ᄋ ᅵ ᄃ ᅩ ᆼ ᄉ ᅵ ᄏ ᅧ
기숙사	ᄀ ᅵ ᄉ ᅮ ᆨ ᄊ ᅡ
생활을	ᄉ ᅢ ᆼ ᄒ ᅪ ᄅ ᅳ ᆯ
할	ᄒ ᅡ ᆯ
때는	ᄄ ᅢ ᄂ ᅳ ᆫ
생활이	ᄉ ᅢ ᆼ ᄒ ᅪ ᄅ ᅵ
규칙적이었어	ᄀ ᅲ ᄎ ᅵ ᆨ ᄍ ᅥ ᄀ ᅵ ᄋ ᅥ ᄊ ᅥ
최	ᄎ ᅬ
대리	ᄃ ᅢ ᄅ ᅵ
거래처에서	ᄀ ᅥ ᄅ ᅢ ᄎ ᅥ ᄋ ᅦ ᄉ ᅥ
장소	ᄌ ᅡ ᆼ ᄉ ᅩ
관련	ᄀ ᅪ ᆯ ᄅ ᅧ ᆫ
메일을	ᄆ ᅦ ᄋ ᅵ ᄅ ᅳ ᆯ
보냈더라	ᄇ ᅩ ᄂ ᅢ ᆮ ᄄ ᅥ ᄅ ᅡ
민주주의	ᄆ ᅵ ᆫ ᄌ ᅮ ᄌ ᅮ ᄋ ᅴ
국가의	ᄀ ᅮ ᆨ ᄁ ᅡ ᄋ ᅴ
주인은	ᄌ ᅮ ᄋ ᅵ ᄂ ᅳ ᆫ
국민입니다	ᄀ ᅮ ᆼ ᄆ ᅵ ᄂ ᅵ ᆷ ᄂ ᅵ ᄃ ᅡ
버스에는	ᄇ ᅥ ᄉ ᅳ ᄋ ᅦ ᄂ ᅳ ᆫ
컵에	ᄏ ᅥ ᄇ ᅦ
담긴	ᄃ ᅡ ᆷ ᄀ ᅵ ᆫ
음료를	ᄋ ᅳ ᆷ ᄂ ᅭ ᄅ ᅳ ᆯ
들고	ᄃ ᅳ ᆯ ᄀ ᅩ
탈	ᄐ ᅡ ᆯ
수	ᄉ ᅮ
없습니다	ᄋ ᅥ ᆸ ᄊ ᅳ ᆷ ᄂ ᅵ ᄃ ᅡ
결제가	ᄀ ᅧ ᆯ ᄌ ᅦ ᄀ ᅡ
정상적으로	ᄌ ᅥ ᆼ ᄉ ᅡ ᆼ ᄌ ᅥ ᄀ ᅳ ᄅ ᅩ
완료되었습니다	ᄋ ᅪ ᆯ ᄅ ᅭ ᄃ ᅬ ᄋ ᅥ ᆮ ᄊ ᅳ ᆷ ᄂ ᅵ ᄃ ᅡ
소중한	ᄉ ᅩ ᄌ ᅮ ᆼ ᄒ ᅡ ᆫ
정보	ᄌ ᅥ ᆼ ᄇ ᅩ
보호를	ᄇ ᅩ ᄒ ᅩ ᄅ ᅳ ᆯ
위해	ᄋ ᅱ ᄒ ᅢ
주기적으로	ᄌ ᅮ ᄀ ᅵ ᄌ ᅥ ᄀ ᅳ ᄅ ᅩ
비밀번호를	ᄇ ᅵ ᄆ ᅵ ᆯ ᄇ ᅥ ᆫ ᄒ ᅩ ᄅ ᅳ ᆯ
변경해	ᄇ ᅧ ᆫ ᄀ ᅧ ᆼ ᄒ ᅢ
손해보험	ᄉ ᅩ ᆫ ᄒ ᅢ ᄇ ᅩ ᄒ ᅥ ᆷ
홈페이지	ᄒ ᅩ ᆷ ᄑ ᅦ ᄋ ᅵ ᄌ ᅵ
회원이	ᄒ ᅬ ᄋ ᅯ ᄂ ᅵ
되신	ᄃ ᅬ ᄉ ᅵ ᆫ
것을	ᄀ ᅥ ᄉ ᅳ ᆯ
환영합니다	ᄒ ᅪ ᄂ ᅧ ᆼ ᄒ ᅡ ᆷ ᄂ ᅵ ᄃ ᅡ
공모에	ᄀ ᅩ ᆼ ᄆ ᅩ ᄋ ᅦ
응모해	ᄋ ᅳ ᆼ ᄆ ᅩ ᄒ ᅢ
주셔서	ᄌ ᅮ ᄉ ᅧ ᄉ ᅥ
감사합니다	ᄀ ᅡ ᆷ ᄉ ᅡ ᄒ ᅡ ᆷ ᄂ ᅵ ᄃ ᅡ
오늘은	ᄋ ᅩ ᄂ ᅳ ᄅ ᅳ ᆫ
폭염	ᄑ ᅩ ᄀ ᅧ ᆷ
수준의	ᄉ ᅮ ᄌ ᅮ ᄂ ᅴ
더위가	ᄃ ᅥ ᄋ ᅱ ᄀ ᅡ
누그러지겠습니다	ᄂ ᅮ ᄀ ᅳ ᄅ ᅥ ᄌ ᅵ ᄀ ᅦ ᆮ ᄊ ᅳ ᆷ ᄂ ᅵ ᄃ ᅡ
피부	ᄑ ᅵ ᄇ ᅮ
노화를	ᄂ ᅩ ᄒ ᅪ ᄅ ᅳ ᆯ
막으려면	ᄆ ᅡ ᄀ ᅳ ᄅ ᅧ ᄆ ᅧ ᆫ
유수분	ᄋ ᅲ ᄉ ᅮ ᄇ ᅮ ᆫ
균형에	ᄀ ᅲ ᆫ ᄒ ᅧ ᆼ ᄋ ᅦ
신경	ᄉ ᅵ ᆫ ᄀ ᅧ ᆼ
쓰셔야	ᄊ ᅳ ᄉ ᅧ ᄋ ᅣ
자외선에	ᄌ ᅡ ᄋ ᅬ ᄉ ᅥ ᄂ ᅦ
노출된	ᄂ ᅩ ᄎ ᅮ ᆯ ᄃ ᅬ ᆫ
모발은	ᄆ ᅩ ᄇ ᅡ ᄅ ᅳ ᆫ
단백질이	ᄃ ᅡ ᆫ ᄇ ᅢ ᆨ ᄍ ᅵ ᄅ ᅵ
파괴되고	ᄑ ᅡ ᄀ ᅬ ᄃ ᅬ ᄀ ᅩ
윤기와	ᄋ ᅲ ᆫ ᄀ ᅵ ᄋ ᅪ
탄력을	ᄐ ᅡ ᆯ ᄅ ᅧ ᄀ ᅳ ᆯ
잃어요	ᄋ ᅵ ᄅ ᅥ ᄋ ᅭ
바다의	ᄇ ᅡ ᄃ ᅡ ᄋ ᅴ
포식자로	ᄑ ᅩ ᄉ ᅵ ᆨ ᄍ ᅡ ᄅ ᅩ
불리는	ᄇ ᅮ ᆯ ᄅ ᅵ ᄂ ᅳ ᆫ
백상아리	ᄇ ᅢ ᆨ ᄊ ᅡ ᆼ ᄋ ᅡ ᄅ ᅵ
마리가	ᄆ ᅡ ᄅ ᅵ ᄀ ᅡ
발견되었어요	ᄇ ᅡ ᆯ ᄀ ᅧ ᆫ ᄃ ᅬ ᄋ ᅥ ᄊ ᅥ ᄋ ᅭ
투표는	ᄐ ᅮ ᄑ ᅭ ᄂ ᅳ ᆫ
국민의	ᄀ ᅮ ᆼ ᄆ ᅵ ᄂ ᅴ
권리입니다	ᄀ ᅯ ᆯ ᄅ ᅵ ᄋ ᅵ ᆷ ᄂ ᅵ ᄃ ᅡ
소방차의	ᄉ ᅩ ᄇ ᅡ ᆼ ᄎ ᅡ ᄋ ᅴ
출동을	ᄎ ᅮ ᆯ ᄃ ᅩ ᆼ ᄋ ᅳ ᆯ
방해할	ᄇ ᅡ ᆼ ᄒ ᅢ ᄒ ᅡ ᆯ
경우	ᄀ ᅧ ᆼ ᄋ ᅮ
최대	ᄎ ᅬ ᄃ ᅢ
이백만	ᄋ ᅵ ᄇ ᅢ ᆼ ᄆ ᅡ ᆫ
원의	ᄋ ᅯ ᄂ ᅴ
과태료가	ᄀ ᅪ ᄐ ᅢ ᄅ ᅭ ᄀ ᅡ
부과된	ᄇ ᅮ ᄀ ᅪ ᄃ ᅬ ᆫ
대	ᄃ ᅢ
언제부터	ᄋ ᅥ ᆫ ᄌ ᅦ ᄇ ᅮ ᄐ ᅥ
소방차는	ᄉ ᅩ ᄇ ᅡ ᆼ ᄎ ᅡ ᄂ ᅳ ᆫ
빨간색이	ᄈ ᅡ ᆯ ᄀ ᅡ ᆫ ᄉ ᅢ ᄀ ᅵ
되었을까	ᄃ ᅬ ᄋ ᅥ ᄊ ᅳ ᆯ ᄁ ᅡ
지나가는	ᄌ ᅵ ᄂ ᅡ ᄀ ᅡ ᄂ ᅳ ᆫ
소방차에	ᄉ ᅩ ᄇ ᅡ ᆼ ᄎ ᅡ ᄋ ᅦ
길을	ᄀ ᅵ ᄅ ᅳ ᆯ
열어주세요	ᄋ ᅧ ᄅ ᅥ ᄌ ᅮ ᄉ ᅦ ᄋ ᅭ
오신	ᄋ ᅩ ᄉ ᅵ ᆫ
순서대로	ᄉ ᅮ ᆫ ᄉ ᅥ ᄃ ᅢ ᄅ ᅩ
처리해	ᄎ ᅥ ᄅ ᅵ ᄒ ᅢ
드리겠습니다	ᄃ ᅳ ᄅ ᅵ ᄀ ᅦ ᆮ ᄊ ᅳ ᆷ ᄂ ᅵ ᄃ ᅡ
신용카드를	ᄉ ᅵ ᄂ ᅭ ᆼ ᄏ ᅡ ᄃ ᅳ ᄅ ᅳ ᆯ
지참하시고	ᄌ ᅵ ᄎ ᅡ ᆷ ᄒ ᅡ ᄉ ᅵ ᄀ ᅩ
고객센터에서	ᄀ ᅩ ᄀ ᅢ ᆨ ᄊ ᅦ ᆫ ᄐ ᅥ ᄋ ᅦ ᄉ ᅥ
영수증	ᄋ ᅧ ᆼ ᄉ ᅮ ᄌ ᅳ ᆼ
재발급을	ᄌ ᅢ ᄇ ᅡ ᆯ ᄀ ᅳ ᄇ ᅳ ᆯ
받으면	ᄇ ᅡ ᄃ ᅳ ᄆ ᅧ ᆫ
해변가에	ᄒ ᅢ ᄇ ᅧ ᆫ ᄀ ᅡ ᄋ ᅦ
상어가	ᄉ ᅡ ᆼ ᄋ ᅥ ᄀ ᅡ
출몰해	ᄎ ᅮ ᆯ ᄆ ᅩ ᆯ ᄒ ᅢ
피서객들의	ᄑ ᅵ ᄉ ᅥ ᄀ ᅢ ᆨ ᄄ ᅳ ᄅ ᅴ
주의가	ᄌ ᅮ ᄋ ᅴ ᄀ ᅡ
필요합니다	ᄑ ᅵ ᄅ ᅭ ᄒ ᅡ ᆷ ᄂ ᅵ ᄃ ᅡ
방울토마토는	ᄇ ᅡ ᆼ ᄋ ᅮ ᆯ ᄐ ᅩ ᄆ ᅡ ᄐ ᅩ ᄂ ᅳ ᆫ
꼭지가	ᄁ ᅩ ᆨ ᄍ ᅵ ᄀ ᅡ
싱싱한	ᄉ ᅵ ᆼ ᄉ ᅵ ᆼ ᄒ ᅡ ᆫ
게	ᄀ ᅦ
상품이야	ᄉ ᅡ ᆼ ᄑ ᅮ ᄆ ᅵ ᄋ ᅣ
아침은	ᄋ ᅡ ᄎ ᅵ ᄆ ᅳ ᆫ
쌀밥	ᄊ ᅡ ᆯ ᄇ ᅡ ᆸ
대신	ᄃ ᅢ ᄉ ᅵ ᆫ
귀리나	ᄀ ᅱ ᄅ ᅵ ᄂ ᅡ
오트밀	ᄋ ᅩ ᄐ ᅳ ᄆ ᅵ ᆯ
점심은	ᄌ ᅥ ᆷ ᄉ ᅵ ᄆ ᅳ ᆫ
황제처럼	ᄒ ᅪ ᆼ ᄌ ᅦ ᄎ ᅥ ᄅ ᅥ ᆷ
저녁은	ᄌ ᅥ ᄂ ᅧ ᄀ ᅳ ᆫ
든든하게	ᄃ ᅳ ᆫ ᄃ ᅳ ᆫ ᄒ ᅡ ᄀ ᅦ
점심	ᄌ ᅥ ᆷ ᄉ ᅵ ᆷ
특선	ᄐ ᅳ ᆨ ᄊ ᅥ ᆫ
메뉴는	ᄆ ᅦ ᄂ ᅲ ᄂ ᅳ ᆫ
갈비탕	ᄀ ᅡ ᆯ ᄇ ᅵ ᄐ ᅡ ᆼ
이래	ᄋ ᅵ ᄅ ᅢ
비닐봉지도	ᄇ ᅵ ᄂ ᅵ ᆯ ᄇ ᅩ ᆼ ᄌ ᅵ ᄃ ᅩ
이제는	ᄋ ᅵ ᄌ ᅦ ᄂ ᅳ ᆫ
돈	ᄃ ᅩ ᆫ
주고	ᄌ ᅮ ᄀ ᅩ
사야	ᄉ ᅡ ᄋ ᅣ
회원님	ᄒ ᅬ ᄋ ᅯ ᆫ ᄂ ᅵ ᆷ
영화	ᄋ ᅧ ᆼ ᄒ ᅪ
예매가	ᄋ ᅨ ᄆ ᅢ ᄀ ᅡ
기프티카드로	ᄀ ᅵ ᄑ ᅳ ᄐ ᅵ ᄏ ᅡ ᄃ ᅳ ᄅ ᅩ
사람들에게	ᄉ ᅡ ᄅ ᅡ ᆷ ᄃ ᅳ ᄅ ᅦ ᄀ ᅦ
마음을	ᄆ ᅡ ᄋ ᅳ ᄆ ᅳ ᆯ
전하세요	ᄌ ᅥ ᆫ ᄒ ᅡ ᄉ ᅦ ᄋ ᅭ
콜드	ᄏ ᅩ ᆯ ᄃ ᅳ
부루는	ᄇ ᅮ ᄅ ᅮ ᄂ ᅳ ᆫ
커피	ᄏ ᅥ ᄑ ᅵ
원두를	ᄋ ᅯ ᆫ ᄃ ᅮ ᄅ ᅳ ᆯ
차가운	ᄎ ᅡ ᄀ ᅡ ᄋ ᅮ ᆫ
물로	ᄆ ᅮ ᆯ ᄅ ᅩ
오랜	ᄋ ᅩ ᄅ ᅢ ᆫ
시간을	ᄉ ᅵ ᄀ ᅡ ᄂ ᅳ ᆯ
들여	ᄃ ᅳ ᄅ ᅧ
우려내는	ᄋ ᅮ ᄅ ᅧ ᄂ ᅢ ᄂ ᅳ ᆫ
방식을	ᄇ ᅡ ᆼ ᄉ ᅵ ᄀ ᅳ ᆯ
무분별한	ᄆ ᅮ ᄇ ᅮ ᆫ ᄇ ᅧ ᆯ ᄒ ᅡ ᆫ
종이컵	ᄌ ᅩ ᆼ ᄋ ᅵ ᄏ ᅥ ᆸ
사용을	ᄉ ᅡ ᄋ ᅭ ᆼ ᄋ ᅳ ᆯ
자제하고	ᄌ ᅡ ᄌ ᅦ ᄒ ᅡ ᄀ ᅩ
텀블러	ᄐ ᅥ ᆷ ᄇ ᅳ ᆯ ᄅ ᅥ
생활화합시다	ᄉ ᅢ ᆼ ᄒ ᅪ ᆯ ᄒ ᅪ ᄒ ᅡ ᆸ ᄊ ᅵ ᄃ ᅡ
미세먼지	ᄆ ᅵ ᄉ ᅦ ᄆ ᅥ ᆫ ᄌ ᅵ
제거에	ᄌ ᅦ ᄀ ᅥ ᄋ ᅦ
효과적인	ᄒ ᅭ ᄀ ᅪ ᄌ ᅥ ᄀ ᅵ ᆫ
공기청정기를	ᄀ ᅩ ᆼ ᄀ ᅵ ᄎ ᅥ ᆼ ᄌ ᅥ ᆼ ᄀ ᅵ ᄅ ᅳ ᆯ
추천해	ᄎ ᅮ ᄎ ᅥ ᆫ ᄒ ᅢ
하루	ᄒ ᅡ ᄅ ᅮ
일곱	ᄋ ᅵ ᆯ ᄀ ᅩ ᆸ
여덟	ᄋ ᅧ ᄃ ᅥ ᆯ
시간의	ᄉ ᅵ ᄀ ᅡ ᄂ ᅴ
수면이	ᄉ ᅮ ᄆ ᅧ ᄂ ᅵ
건강에	ᄀ ᅥ ᆫ ᄀ ᅡ ᆼ ᄋ ᅦ
좋다는	ᄌ ᅩ ᄐ ᅡ ᄂ ᅳ ᆫ
연구	ᄋ ᅧ ᆫ ᄀ ᅮ
결과가	ᄀ ᅧ ᆯ ᄀ ᅪ ᄀ ᅡ
나왔어	ᄂ ᅡ ᄋ ᅪ ᄊ ᅥ
점심을	ᄌ ᅥ ᆷ ᄉ ᅵ ᄆ ᅳ ᆯ
누가	ᄂ ᅮ ᄀ ᅡ
살지	ᄉ ᅡ ᆯ ᄌ ᅵ
사다리	ᄉ ᅡ ᄃ ᅡ ᄅ ᅵ
타기로	ᄐ ᅡ ᄀ ᅵ ᄅ ᅩ
정하자	ᄌ ᅥ ᆼ ᄒ ᅡ ᄌ ᅡ
에너지	ᄋ ᅦ ᄂ ᅥ ᄌ ᅵ
절약과	ᄌ ᅥ ᄅ ᅣ ᆨ ᄁ ᅪ
건강을	ᄀ ᅥ ᆫ ᄀ ᅡ ᆼ ᄋ ᅳ ᆯ
저층은	ᄌ ᅥ ᄎ ᅳ ᆼ ᄋ ᅳ ᆫ
계단을	ᄀ ᅨ ᄃ ᅡ ᄂ ᅳ ᆯ
이용합시다	ᄋ ᅵ ᄋ ᅭ ᆼ ᄒ ᅡ ᆸ ᄊ ᅵ ᄃ ᅡ
정부가	ᄌ ᅥ ᆼ ᄇ ᅮ ᄀ ᅡ
권장하는	ᄀ ᅯ ᆫ ᄌ ᅡ ᆼ ᄒ ᅡ ᄂ ᅳ ᆫ
여름철	ᄋ ᅧ ᄅ ᅳ ᆷ ᄎ ᅥ ᆯ
실내	ᄉ ᅵ ᆯ ᄅ ᅢ
적정	ᄌ ᅥ ᆨ ᄍ ᅥ ᆼ
온도는	ᄋ ᅩ ᆫ ᄃ ᅩ ᄂ ᅳ ᆫ
이십육에서	ᄋ ᅵ ᄉ ᅵ ᄇ ᅲ ᄀ ᅦ ᄉ ᅥ
이십팔	ᄋ ᅵ ᄉ ᅵ ᆸ ᄑ ᅡ ᆯ
도입니다	ᄃ ᅩ ᄋ ᅵ ᆷ ᄂ ᅵ ᄃ ᅡ
반소매	ᄇ ᅡ ᆫ ᄉ ᅩ ᄆ ᅢ
와이셔츠에	ᄋ ᅪ ᄋ ᅵ ᄉ ᅧ ᄎ ᅳ ᄋ ᅦ
넥타이를	ᄂ ᅦ ᆨ ᄐ ᅡ ᄋ ᅵ ᄅ ᅳ ᆯ
매지	ᄆ ᅢ ᄌ ᅵ
않으면	ᄋ ᅡ ᄂ ᅳ ᄆ ᅧ ᆫ
체감온도를	ᄎ ᅦ ᄀ ᅡ ᄆ ᅩ ᆫ ᄃ ᅩ ᄅ ᅳ ᆯ
이도	ᄋ ᅵ ᄃ ᅩ
낮출	ᄂ ᅡ ᆮ ᄎ ᅮ ᆯ
드신	ᄃ ᅳ ᄉ ᅵ ᆫ
식판의	ᄉ ᅵ ᆨ ᄑ ᅡ ᄂ ᅴ
음식	ᄋ ᅳ ᆷ ᄉ ᅵ ᆨ
찌꺼기는	ᄍ ᅵ ᄁ ᅥ ᄀ ᅵ ᄂ ᅳ ᆫ
음식물	ᄋ ᅳ ᆷ ᄉ ᅵ ᆼ ᄆ ᅮ ᆯ
쓰레기통에	ᄊ ᅳ ᄅ ᅦ ᄀ ᅵ ᄐ ᅩ ᆼ ᄋ ᅦ
버려주세요	ᄇ ᅥ ᄅ ᅧ ᄌ ᅮ ᄉ ᅦ ᄋ ᅭ
회식에	ᄒ ᅬ ᄉ ᅵ ᄀ ᅦ
참석이	ᄎ ᅡ ᆷ ᄉ ᅥ ᄀ ᅵ
어려우신	ᄋ ᅥ ᄅ ᅧ ᄋ ᅮ ᄉ ᅵ ᆫ
말씀해	ᄆ ᅡ ᆯ ᄊ ᅳ ᆷ ᄒ ᅢ
칸에서	ᄏ ᅡ ᄂ ᅦ ᄉ ᅥ
수상한	ᄉ ᅮ ᄉ ᅡ ᆼ ᄒ ᅡ ᆫ
영화인	ᄋ ᅧ ᆼ ᄒ ᅪ ᄋ ᅵ ᆫ
만큼	ᄆ ᅡ ᆫ ᄏ ᅳ ᆷ
작품성은	ᄌ ᅡ ᆨ ᄑ ᅮ ᆷ ᄉ ᅥ ᆼ ᄋ ᅳ ᆫ
보장하지	ᄇ ᅩ ᄌ ᅡ ᆼ ᄒ ᅡ ᄌ ᅵ
음식은	ᄋ ᅳ ᆷ ᄉ ᅵ ᄀ ᅳ ᆫ
맛도	ᄆ ᅡ ᆮ ᄄ ᅩ
중요하지만	ᄌ ᅮ ᆼ ᄋ ᅭ ᄒ ᅡ ᄌ ᅵ ᄆ ᅡ ᆫ
스타일링도	ᄉ ᅳ ᄐ ᅡ ᄋ ᅵ ᆯ ᄅ ᅵ ᆼ ᄃ ᅩ
중요하다고	ᄌ ᅮ ᆼ ᄋ ᅭ ᄒ ᅡ ᄃ ᅡ ᄀ ᅩ
생각해	ᄉ ᅢ ᆼ ᄀ ᅡ ᄏ ᅢ
원만한	ᄋ ᅯ ᆫ ᄆ ᅡ ᆫ ᄒ ᅡ ᆫ
인간관계를	ᄋ ᅵ ᆫ ᄀ ᅡ ᆫ ᄀ ᅪ ᆫ ᄀ ᅨ ᄅ ᅳ ᆯ
위해서는	ᄋ ᅱ ᄒ ᅢ ᄉ ᅥ ᄂ ᅳ ᆫ
하얀	ᄒ ᅡ ᄋ ᅣ ᆫ
거짓말도	ᄀ ᅥ ᄌ ᅵ ᆫ ᄆ ᅡ ᆯ ᄃ ᅩ
필요하다고	ᄑ ᅵ ᄅ ᅭ ᄒ ᅡ ᄃ ᅡ ᄀ ᅩ
봐	ᄇ ᅪ
다이어트를	ᄃ ᅡ ᄋ ᅵ ᄋ ᅥ ᄐ ᅳ ᄅ ᅳ ᆯ
하려면	ᄒ ᅡ ᄅ ᅧ ᄆ ᅧ ᆫ
기초대사량을	ᄀ ᅵ ᄎ ᅩ ᄃ ᅢ ᄉ ᅡ ᄅ ᅣ ᆼ ᄋ ᅳ ᆯ
높이는	ᄂ ᅩ ᄑ ᅵ ᄂ ᅳ ᆫ
중요해	ᄌ ᅮ ᆼ ᄋ ᅭ ᄒ ᅢ
점심때	ᄌ ᅥ ᆷ ᄉ ᅵ ᆷ ᄄ ᅢ
상추를	ᄉ ᅡ ᆼ ᄎ ᅮ ᄅ ᅳ ᆯ
먹어서	ᄆ ᅥ ᄀ ᅥ ᄉ ᅥ
졸린	ᄌ ᅩ ᆯ ᄅ ᅵ ᆫ
아니라	ᄋ ᅡ ᄂ ᅵ ᄅ ᅡ
만성	ᄆ ᅡ ᆫ ᄉ ᅥ ᆼ
피로가	ᄑ ᅵ ᄅ ᅩ ᄀ ᅡ
문제야	ᄆ ᅮ ᆫ ᄌ ᅦ ᄋ ᅣ
커피를	ᄏ ᅥ ᄑ ᅵ ᄅ ᅳ ᆯ
마시면	ᄆ ᅡ ᄉ ᅵ ᄆ ᅧ ᆫ
이뇨작용이	ᄋ ᅵ ᄂ ᅭ ᄌ ᅡ ᄀ ᅭ ᆼ ᄋ ᅵ
심해져서	ᄉ ᅵ ᆷ ᄒ ᅢ ᄌ ᅥ ᄉ ᅥ
물을	ᄆ ᅮ ᄅ ᅳ ᆯ
더	ᄃ ᅥ
마셔줘야	ᄆ ᅡ ᄉ ᅧ ᄌ ᅯ ᄋ ᅣ
내	ᄂ ᅢ
동안의	ᄃ ᅩ ᆼ ᄋ ᅡ ᄂ ᅴ
비결은	ᄇ ᅵ ᄀ ᅧ ᄅ ᅳ ᆫ
육식보다는	ᄋ ᅲ ᆨ ᄊ ᅵ ᆨ ᄈ ᅩ ᄃ ᅡ ᄂ ᅳ ᆫ
채식을	ᄎ ᅢ ᄉ ᅵ ᄀ ᅳ ᆯ
선호한다는	ᄉ ᅥ ᆫ ᄒ ᅩ ᄒ ᅡ ᆫ ᄃ ᅡ ᄂ ᅳ ᆫ
거야	ᄀ ᅥ ᄋ ᅣ
건강	ᄀ ᅥ ᆫ ᄀ ᅡ ᆼ
검진	ᄀ ᅥ ᆷ ᄌ ᅵ ᆫ
예약이	ᄋ ᅨ ᄋ ᅣ ᄀ ᅵ
되어	ᄃ ᅬ ᄋ ᅥ
있어서	ᄋ ᅵ ᄊ ᅥ ᄉ ᅥ
금식이야	ᄀ ᅳ ᆷ ᄉ ᅵ ᄀ ᅵ ᄋ ᅣ
부모님의	ᄇ ᅮ ᄆ ᅩ ᄂ ᅵ ᄆ ᅴ
결혼기념일	ᄀ ᅧ ᆯ ᄒ ᅩ ᆫ ᄀ ᅵ ᄂ ᅧ ᄆ ᅵ ᆯ
선물로	ᄉ ᅥ ᆫ ᄆ ᅮ ᆯ ᄅ ᅩ
뭐가	ᄆ ᅯ ᄀ ᅡ
좋을까	ᄌ ᅩ ᄋ ᅳ ᆯ ᄁ ᅡ
피자는	ᄑ ᅵ ᄌ ᅡ ᄂ ᅳ ᆫ
이렇게	ᄋ ᅵ ᄅ ᅥ ᄏ ᅦ
손으로	ᄉ ᅩ ᄂ ᅳ ᄅ ᅩ
먹어야	ᄆ ᅥ ᄀ ᅥ ᄋ ᅣ
제	ᄌ ᅦ
맛이	ᄆ ᅡ ᄉ ᅵ
지	ᄌ ᅵ
비상구의	ᄇ ᅵ ᄉ ᅡ ᆼ ᄀ ᅮ ᄋ ᅴ
문을	ᄆ ᅮ ᄂ ᅳ ᆯ
잠그거나	ᄌ ᅡ ᆷ ᄀ ᅳ ᄀ ᅥ ᄂ ᅡ
물건을	ᄆ ᅮ ᆯ ᄀ ᅥ ᄂ ᅳ ᆯ
쌓아두는	ᄊ ᅡ ᄋ ᅡ ᄃ ᅮ ᄂ ᅳ ᆫ
건	ᄀ ᅥ ᆫ
불법이야	ᄇ ᅮ ᆯ ᄇ ᅥ ᄇ ᅵ ᄋ ᅣ
좋다고	ᄌ ᅩ ᄐ ᅡ ᄀ ᅩ
착각하는	ᄎ ᅡ ᆨ ᄁ ᅡ ᄏ ᅡ ᄂ ᅳ ᆫ
음식들이	ᄋ ᅳ ᆷ ᄉ ᅵ ᆨ ᄄ ᅳ ᄅ ᅵ
의외로	ᄋ ᅴ ᄋ ᅬ ᄅ ᅩ
많다고	ᄆ ᅡ ᆫ ᄐ ᅡ ᄀ ᅩ
온라인에서	ᄋ ᅩ ᆯ ᄅ ᅡ ᄋ ᅵ ᄂ ᅦ ᄉ ᅥ
졸업	ᄌ ᅩ ᄅ ᅥ ᆸ
증명서와	ᄌ ᅳ ᆼ ᄆ ᅧ ᆼ ᄉ ᅥ ᄋ ᅪ
성적	ᄉ ᅥ ᆼ ᄌ ᅥ ᆨ
증명서	ᄌ ᅳ ᆼ ᄆ ᅧ ᆼ ᄉ ᅥ
발급하는	ᄇ ᅡ ᆯ ᄀ ᅳ ᄑ ᅡ ᄂ ᅳ ᆫ
방법을	ᄇ ᅡ ᆼ ᄇ ᅥ ᄇ ᅳ ᆯ
알려주세요	ᄋ ᅡ ᆯ ᄅ ᅧ ᄌ ᅮ ᄉ ᅦ ᄋ ᅭ
추가	ᄎ ᅮ ᄀ ᅡ
주문하시겠습니까	ᄌ ᅮ ᄆ ᅮ ᆫ ᄒ ᅡ ᄉ ᅵ ᄀ ᅦ ᆮ ᄊ ᅳ ᆷ ᄂ ᅵ ᄁ ᅡ
레몬의	ᄅ ᅦ ᄆ ᅩ ᄂ ᅴ
상큼함이	ᄉ ᅡ ᆼ ᄏ ᅳ ᆷ ᄒ ᅡ ᄆ ᅵ
입	ᄋ ᅵ ᆸ
안	ᄋ ᅡ ᆫ
가득	ᄀ ᅡ ᄃ ᅳ ᆨ
퍼져요	ᄑ ᅥ ᄌ ᅥ ᄋ ᅭ
요즘	ᄋ ᅭ ᄌ ᅳ ᆷ
제주도에	ᄌ ᅦ ᄌ ᅮ ᄃ ᅩ ᄋ ᅦ
맹독을	ᄆ ᅢ ᆼ ᄃ ᅩ ᄀ ᅳ ᆯ
지닌	ᄌ ᅵ ᄂ ᅵ ᆫ
파란	ᄑ ᅡ ᄅ ᅡ ᆫ
고리문어가	ᄀ ᅩ ᄅ ᅵ ᄆ ᅮ ᄂ ᅥ ᄀ ᅡ
자주	ᄌ ᅡ ᄌ ᅮ
오랫동안	ᄋ ᅩ ᄅ ᅢ ᆮ ᄄ ᅩ ᆼ ᄋ ᅡ ᆫ
짝사랑해왔던	ᄍ ᅡ ᆨ ᄊ ᅡ ᄅ ᅡ ᆼ ᄒ ᅢ ᄋ ᅪ ᆮ ᄄ ᅥ ᆫ
니가	ᄂ ᅵ ᄀ ᅡ
지금	ᄌ ᅵ ᄀ ᅳ ᆷ
곁에	ᄀ ᅧ ᄐ ᅦ
있다는	ᄋ ᅵ ᆮ ᄄ ᅡ ᄂ ᅳ ᆫ
꿈만	ᄁ ᅮ ᆷ ᄆ ᅡ ᆫ
경치	ᄀ ᅧ ᆼ ᄎ ᅵ
좋고	ᄌ ᅩ ᄏ ᅩ
음식도	ᄋ ᅳ ᆷ ᄉ ᅵ ᆨ ᄄ ᅩ
맛있고	ᄆ ᅡ ᄉ ᅵ ᆮ ᄁ ᅩ
여행은	ᄋ ᅧ ᄒ ᅢ ᆼ ᄋ ᅳ ᆫ
대만족이야	ᄃ ᅢ ᄆ ᅡ ᆫ ᄌ ᅩ ᄀ ᅵ ᄋ ᅣ
보잘것없는	ᄇ ᅩ ᄌ ᅡ ᆯ ᄀ ᅥ ᄉ ᅥ ᆷ ᄂ ᅳ ᆫ
선물이지만	ᄉ ᅥ ᆫ ᄆ ᅮ ᄅ ᅵ ᄌ ᅵ ᄆ ᅡ ᆫ
좋아해	ᄌ ᅩ ᄋ ᅡ ᄒ ᅢ
주니까	ᄌ ᅮ ᄂ ᅵ ᄁ ᅡ
정말	ᄌ ᅥ ᆼ ᄆ ᅡ ᆯ
기뻐	ᄀ ᅵ ᄈ ᅥ
난	ᄂ ᅡ ᆫ
널	ᄂ ᅥ ᆯ
바라보고	ᄇ ᅡ ᄅ ᅡ ᄇ ᅩ ᄀ ᅩ
것만으로도	ᄀ ᅥ ᆫ ᄆ ᅡ ᄂ ᅳ ᄅ ᅩ ᄃ ᅩ
행복해	ᄒ ᅢ ᆼ ᄇ ᅩ ᄏ ᅢ
드디어	ᄃ ᅳ ᄃ ᅵ ᄋ ᅥ
내일이	ᄂ ᅢ ᄋ ᅵ ᄅ ᅵ
동안	ᄃ ᅩ ᆼ ᄋ ᅡ ᆫ
기다리던	ᄀ ᅵ ᄃ ᅡ ᄅ ᅵ ᄃ ᅥ ᆫ
월급날이라서	ᄋ ᅯ ᆯ ᄀ ᅳ ᆷ ᄂ ᅡ ᄅ ᅵ ᄅ ᅡ ᄉ ᅥ
그런지	ᄀ ᅳ ᄅ ᅥ ᆫ ᄌ ᅵ
기분	ᄀ ᅵ ᄇ ᅮ ᆫ
최고야	ᄎ ᅬ ᄀ ᅩ ᄋ ᅣ
항상	ᄒ ᅡ ᆼ ᄉ ᅡ ᆼ
옆에	ᄋ ᅧ ᄑ ᅦ
줘서	ᄌ ᅯ ᄉ ᅥ
고마워	ᄀ ᅩ ᄆ ᅡ ᄋ ᅯ
이런	ᄋ ᅵ ᄅ ᅥ ᆫ
선물까지	ᄉ ᅥ ᆫ ᄆ ᅮ ᆯ ᄁ ᅡ ᄌ ᅵ
주시고	ᄌ ᅮ ᄉ ᅵ ᄀ ᅩ
풀려서	ᄑ ᅮ ᆯ ᄅ ᅧ ᄉ ᅥ
살맛	ᄉ ᅡ ᆯ ᄆ ᅡ ᆮ
난다	ᄂ ᅡ ᆫ ᄃ ᅡ
에피소드	ᄋ ᅦ ᄑ ᅵ ᄉ ᅩ ᄃ ᅳ
진짜	ᄌ ᅵ ᆫ ᄍ ᅡ
재밌더라	ᄌ ᅢ ᄆ ᅵ ᆮ ᄄ ᅥ ᄅ ᅡ
해외여행은	ᄒ ᅢ ᄋ ᅬ ᄋ ᅧ ᄒ ᅢ ᆼ ᄋ ᅳ ᆫ
처음이라	ᄎ ᅥ ᄋ ᅳ ᄆ ᅵ ᄅ ᅡ
엄청나게	ᄋ ᅥ ᆷ ᄎ ᅥ ᆼ ᄂ ᅡ ᄀ ᅦ
들떠	ᄃ ᅳ ᆯ ᄄ ᅥ
곧	ᄀ ᅩ ᆮ
만날	ᄆ ᅡ ᆫ ᄂ ᅡ ᆯ
있다고	ᄋ ᅵ ᆮ ᄄ ᅡ ᄀ ᅩ
생각하니	ᄉ ᅢ ᆼ ᄀ ᅡ ᄏ ᅡ ᄂ ᅵ
너무	ᄂ ᅥ ᄆ ᅮ
설렌다	ᄉ ᅥ ᆯ ᄅ ᅦ ᆫ ᄃ ᅡ
친구야	ᄎ ᅵ ᆫ ᄀ ᅮ ᄋ ᅣ
축하해줘	ᄎ ᅮ ᄏ ᅡ ᄒ ᅢ ᄌ ᅯ
나	ᄂ ᅡ
여자친구	ᄋ ᅧ ᄌ ᅡ ᄎ ᅵ ᆫ ᄀ ᅮ
생겼어	ᄉ ᅢ ᆼ ᄀ ᅧ ᄊ ᅥ
먹자마자	ᄆ ᅥ ᆨ ᄍ ᅡ ᄆ ᅡ ᄌ ᅡ
안에서	ᄋ ᅡ ᄂ ᅦ ᄉ ᅥ
살살	ᄉ ᅡ ᆯ ᄉ ᅡ ᆯ
녹는데	ᄂ ᅩ ᆼ ᄂ ᅳ ᆫ ᄃ ᅦ
지금까지	ᄌ ᅵ ᄀ ᅳ ᆷ ᄁ ᅡ ᄌ ᅵ
뮤지컬	ᄆ ᅲ ᄌ ᅵ ᄏ ᅥ ᆯ
중에서	ᄌ ᅮ ᆼ ᄋ ᅦ ᄉ ᅥ
무대가	ᄆ ᅮ ᄃ ᅢ ᄀ ᅡ
제일	ᄌ ᅦ ᄋ ᅵ ᆯ
멋졌어	ᄆ ᅥ ᆮ ᄍ ᅥ ᄊ ᅥ
집	ᄌ ᅵ ᆸ
강아지는	ᄀ ᅡ ᆼ ᄋ ᅡ ᄌ ᅵ ᄂ ᅳ ᆫ
하는	ᄒ ᅡ ᄂ ᅳ ᆫ
짓이	ᄌ ᅵ ᄉ ᅵ
귀엽고	ᄀ ᅱ ᄋ ᅧ ᆸ ᄁ ᅩ
사랑스러워	ᄉ ᅡ ᄅ ᅡ ᆼ ᄉ ᅳ ᄅ ᅥ ᄋ ᅯ
산	ᄉ ᅡ ᆫ
정상이라	ᄌ ᅥ ᆼ ᄉ ᅡ ᆼ ᄋ ᅵ ᄅ ᅡ
공기	ᄀ ᅩ ᆼ ᄀ ᅵ
상쾌하다	ᄉ ᅡ ᆼ ᄏ ᅫ ᄒ ᅡ ᄃ ᅡ
직구	ᄌ ᅵ ᆨ ᄁ ᅮ
성공해서	ᄉ ᅥ ᆼ ᄀ ᅩ ᆼ ᄒ ᅢ ᄉ ᅥ
콧노래가	ᄏ ᅩ ᆫ ᄂ ᅩ ᄅ ᅢ ᄀ ᅡ
절로	ᄌ ᅥ ᆯ ᄅ ᅩ
나와	ᄂ ᅡ ᄋ ᅪ
선물이	ᄉ ᅥ ᆫ ᄆ ᅮ ᄅ ᅵ
마음에	ᄆ ᅡ ᄋ ᅳ ᄆ ᅦ
들어	ᄃ ᅳ ᄅ ᅥ
소개팅	ᄉ ᅩ ᄀ ᅢ ᄐ ᅵ ᆼ
생각만	ᄉ ᅢ ᆼ ᄀ ᅡ ᆼ ᄆ ᅡ ᆫ
하면	ᄒ ᅡ ᄆ ᅧ ᆫ
자꾸만	ᄌ ᅡ ᄁ ᅮ ᄆ ᅡ ᆫ
웃음이	ᄋ ᅮ ᄉ ᅳ ᄆ ᅵ
너	ᄂ ᅥ
놈이구나	ᄂ ᅩ ᄆ ᅵ ᄀ ᅮ ᄂ ᅡ
여기	ᄋ ᅧ ᄀ ᅵ
레스토랑	ᄅ ᅦ ᄉ ᅳ ᄐ ᅩ ᄅ ᅡ ᆼ
분위기도	ᄇ ᅮ ᄂ ᅱ ᄀ ᅵ ᄃ ᅩ
근사한데	ᄀ ᅳ ᆫ ᄉ ᅡ ᄒ ᅡ ᆫ ᄃ ᅦ
가격	ᄀ ᅡ ᄀ ᅧ ᆨ
대비	ᄃ ᅢ ᄇ ᅵ
성능이	ᄉ ᅥ ᆼ ᄂ ᅳ ᆼ ᄋ ᅵ
꽤	ᄁ ᅫ
괜찮은	ᄀ ᅫ ᆫ ᄎ ᅡ ᄂ ᅳ ᆫ
걸	ᄀ ᅥ ᆯ
고양이	ᄀ ᅩ ᄋ ᅣ ᆼ ᄋ ᅵ
애교	ᄋ ᅢ ᄀ ᅭ
부리는	ᄇ ᅮ ᄅ ᅵ ᄂ ᅳ ᆫ
귀엽지	ᄀ ᅱ ᄋ ᅧ ᆸ ᄍ ᅵ
발표회	ᄇ ᅡ ᆯ ᄑ ᅭ ᄒ ᅬ
무대에서	ᄆ ᅮ ᄃ ᅢ ᄋ ᅦ ᄉ ᅥ
수진이가	ᄉ ᅮ ᄌ ᅵ ᄂ ᅵ ᄀ ᅡ
잘하던	ᄌ ᅡ ᆯ ᄒ ᅡ ᄃ ᅥ ᆫ
친구여서	ᄎ ᅵ ᆫ ᄀ ᅮ ᄋ ᅧ ᄉ ᅥ
든든하다	ᄃ ᅳ ᆫ ᄃ ᅳ ᆫ ᄒ ᅡ ᄃ ᅡ
역시	ᄋ ᅧ ᆨ ᄊ ᅵ
평양	ᄑ ᅧ ᆼ ᄋ ᅣ ᆼ
냉면이	ᄂ ᅢ ᆼ ᄆ ᅧ ᄂ ᅵ
전국에서	ᄌ ᅥ ᆫ ᄀ ᅮ ᄀ ᅦ ᄉ ᅥ
답답했던	ᄃ ᅡ ᆸ ᄄ ᅡ ᄑ ᅢ ᆮ ᄄ ᅥ ᆫ
속이	ᄉ ᅩ ᄀ ᅵ
뻥	ᄈ ᅥ ᆼ
뚫리는	ᄄ ᅮ ᆯ ᄅ ᅵ ᄂ ᅳ ᆫ
저	ᄌ ᅥ
남자	ᄂ ᅡ ᆷ ᄌ ᅡ
비현실적일	ᄇ ᅵ ᄒ ᅧ ᆫ ᄉ ᅵ ᆯ ᄌ ᅥ ᄀ ᅵ ᆯ
정도로	ᄌ ᅥ ᆼ ᄃ ᅩ ᄅ ᅩ
근사한	ᄀ ᅳ ᆫ ᄉ ᅡ ᄒ ᅡ ᆫ
통신사	ᄐ ᅩ ᆼ ᄉ ᅵ ᆫ ᄉ ᅡ
할인에	ᄒ ᅡ ᄅ ᅵ ᄂ ᅦ
오케이	ᄋ ᅩ ᄏ ᅦ ᄋ ᅵ
캐쉬백까지	ᄏ ᅢ ᄉ ᅱ ᄇ ᅢ ᆨ ᄁ ᅡ ᄌ ᅵ
완전	ᄋ ᅪ ᆫ ᄌ ᅥ ᆫ
굳었지요	ᄀ ᅮ ᄃ ᅥ ᆮ ᄍ ᅵ ᄋ ᅭ
작가가	ᄌ ᅡ ᆨ ᄁ ᅡ ᄀ ᅡ
웃기려고	ᄋ ᅮ ᆮ ᄁ ᅵ ᄅ ᅧ ᄀ ᅩ
작심했나	ᄌ ᅡ ᆨ ᄊ ᅵ ᆷ ᄒ ᅢ ᆫ ᄂ ᅡ
이거	ᄋ ᅵ ᄀ ᅥ
배꼽	ᄇ ᅢ ᄁ ᅩ ᆸ
빠지겠다	ᄈ ᅡ ᄌ ᅵ ᄀ ᅦ ᆮ ᄄ ᅡ
엄마	ᄋ ᅥ ᆷ ᄆ ᅡ
학교	ᄒ ᅡ ᆨ ᄁ ᅭ
백	ᄇ ᅢ ᆨ
미터	ᄆ ᅵ ᄐ ᅥ
달리기	ᄃ ᅡ ᆯ ᄅ ᅵ ᄀ ᅵ
신기록	ᄉ ᅵ ᆫ ᄀ ᅵ ᄅ ᅩ ᆨ
세웠어요	ᄉ ᅦ ᄋ ᅯ ᄊ ᅥ ᄋ ᅭ
모델	ᄆ ᅩ ᄃ ᅦ ᆯ
보는	ᄇ ᅩ ᄂ ᅳ ᆫ
것만으로	ᄀ ᅥ ᆫ ᄆ ᅡ ᄂ ᅳ ᄅ ᅩ
마음이	ᄆ ᅡ ᄋ ᅳ ᄆ ᅵ
훈훈해지네	ᄒ ᅮ ᆫ ᄒ ᅮ ᆫ ᄒ ᅢ ᄌ ᅵ ᄂ ᅦ
자기는	ᄌ ᅡ ᄀ ᅵ ᄂ ᅳ ᆫ
누구를	ᄂ ᅮ ᄀ ᅮ ᄅ ᅳ ᆯ
닮아서	ᄃ ᅡ ᆯ ᄆ ᅡ ᄉ ᅥ
예뻐	ᄋ ᅨ ᄈ ᅥ
예쁜	ᄋ ᅨ ᄈ ᅳ ᆫ
딸이	ᄄ ᅡ ᄅ ᅵ
뽀뽀해줘서	ᄈ ᅩ ᄈ ᅩ ᄒ ᅢ ᄌ ᅯ ᄉ ᅥ
아빠는	ᄋ ᅡ ᄈ ᅡ ᄂ ᅳ ᆫ
기분이	ᄀ ᅵ ᄇ ᅮ ᄂ ᅵ
날아갈	ᄂ ᅡ ᄅ ᅡ ᄀ ᅡ ᆯ
결혼식이라서	ᄀ ᅧ ᆯ ᄒ ᅩ ᆫ ᄉ ᅵ ᄀ ᅵ ᄅ ᅡ ᄉ ᅥ
설레서	ᄉ ᅥ ᆯ ᄅ ᅦ ᄉ ᅥ
잠이	ᄌ ᅡ ᄆ ᅵ
와	ᄋ ᅪ
십	ᄉ ᅵ ᆸ
년	ᄂ ᅧ ᆫ
준비한	ᄌ ᅮ ᆫ ᄇ ᅵ ᄒ ᅡ ᆫ
꿈이	ᄁ ᅮ ᄆ ᅵ
이루어졌어	ᄋ ᅵ ᄅ ᅮ ᄋ ᅥ ᄌ ᅥ ᄊ ᅥ
좋아하는	ᄌ ᅩ ᄋ ᅡ ᄒ ᅡ ᄂ ᅳ ᆫ
영화야	ᄋ ᅧ ᆼ ᄒ ᅪ ᄋ ᅣ
재밌겠지	ᄌ ᅢ ᄆ ᅵ ᆮ ᄁ ᅦ ᆮ ᄍ ᅵ
말로	ᄆ ᅡ ᆯ ᄅ ᅩ
표현할	ᄑ ᅭ ᄒ ᅧ ᆫ ᄒ ᅡ ᆯ
수가	ᄉ ᅮ ᄀ ᅡ
없을	ᄋ ᅥ ᆸ ᄊ ᅳ ᆯ
흐뭇하다	ᄒ ᅳ ᄆ ᅮ ᄐ ᅡ ᄃ ᅡ
울컥할	ᄋ ᅮ ᆯ ᄏ ᅥ ᄏ ᅡ ᆯ
따뜻해지는	ᄄ ᅡ ᄄ ᅳ ᄐ ᅢ ᄌ ᅵ ᄂ ᅳ ᆫ
장면이야	ᄌ ᅡ ᆼ ᄆ ᅧ ᄂ ᅵ ᄋ ᅣ
나를	ᄂ ᅡ ᄅ ᅳ ᆯ
준비했다니	ᄌ ᅮ ᆫ ᄇ ᅵ ᄒ ᅢ ᆮ ᄄ ᅡ ᄂ ᅵ
감동이야	ᄀ ᅡ ᆷ ᄃ ᅩ ᆼ ᄋ ᅵ ᄋ ᅣ
햇살도	ᄒ ᅢ ᄊ ᅡ ᆯ ᄃ ᅩ
바람도	ᄇ ᅡ ᄅ ᅡ ᆷ ᄃ ᅩ
선선하고	ᄉ ᅥ ᆫ ᄉ ᅥ ᆫ ᄒ ᅡ ᄀ ᅩ
날씨	ᄂ ᅡ ᆯ ᄊ ᅵ
좋죠	ᄌ ᅩ ᄎ ᅭ
결국	ᄀ ᅧ ᆯ ᄀ ᅮ ᆨ
해냈다니	ᄒ ᅢ ᄂ ᅢ ᆮ ᄄ ᅡ ᄂ ᅵ
자신이	ᄌ ᅡ ᄉ ᅵ ᄂ ᅵ
대견스러워	ᄃ ᅢ ᄀ ᅧ ᆫ ᄉ ᅳ ᄅ ᅥ ᄋ ᅯ
흥겨워서	ᄒ ᅳ ᆼ ᄀ ᅧ ᄋ ᅯ ᄉ ᅥ
노래가	ᄂ ᅩ ᄅ ᅢ ᄀ ᅡ
나는구먼	ᄂ ᅡ ᄂ ᅳ ᆫ ᄀ ᅮ ᄆ ᅥ ᆫ
신나서	ᄉ ᅵ ᆫ ᄂ ᅡ ᄉ ᅥ
춤이	ᄎ ᅮ ᄆ ᅵ
나네	ᄂ ᅡ ᄂ ᅦ
경사	ᄀ ᅧ ᆼ ᄉ ᅡ
났네	ᄂ ᅡ ᆫ ᄂ ᅦ
났어	ᄂ ᅡ ᄊ ᅥ
뭘	ᄆ ᅯ ᆯ
준비하시고	ᄌ ᅮ ᆫ ᄇ ᅵ ᄒ ᅡ ᄉ ᅵ ᄀ ᅩ
매번	ᄆ ᅢ ᄇ ᅥ ᆫ
고맙습니다	ᄀ ᅩ ᄆ ᅡ ᆸ ᄊ ᅳ ᆷ ᄂ ᅵ ᄃ ᅡ
너와	ᄂ ᅥ ᄋ ᅪ
함께	ᄒ ᅡ ᆷ ᄁ ᅦ
모든	ᄆ ᅩ ᄃ ᅳ ᆫ
시간이	ᄉ ᅵ ᄀ ᅡ ᄂ ᅵ
즐거워	ᄌ ᅳ ᆯ ᄀ ᅥ ᄋ ᅯ
딸	ᄄ ᅡ ᆯ
애교에	ᄋ ᅢ ᄀ ᅭ ᄋ ᅦ
녹는다	ᄂ ᅩ ᆼ ᄂ ᅳ ᆫ ᄃ ᅡ
녹아	ᄂ ᅩ ᄀ ᅡ
순간	ᄉ ᅮ ᆫ ᄀ ᅡ ᆫ
저는	ᄌ ᅥ ᄂ ᅳ ᆫ
운	ᄋ ᅮ ᆫ
사람입니다	ᄉ ᅡ ᄅ ᅡ ᄆ ᅵ ᆷ ᄂ ᅵ ᄃ ᅡ
천국이	ᄎ ᅥ ᆫ ᄀ ᅮ ᄀ ᅵ
따로	ᄄ ᅡ ᄅ ᅩ
있나	ᄋ ᅵ ᆫ ᄂ ᅡ
행복하면	ᄒ ᅢ ᆼ ᄇ ᅩ ᄏ ᅡ ᄆ ᅧ ᆫ
그곳이	ᄀ ᅳ ᄀ ᅩ ᄉ ᅵ
손님이	ᄉ ᅩ ᆫ ᄂ ᅵ ᄆ ᅵ
많아	ᄆ ᅡ ᄂ ᅡ
몸은	ᄆ ᅩ ᄆ ᅳ ᆫ
고돼도	ᄀ ᅩ ᄃ ᅫ ᄃ ᅩ
장사가	ᄌ ᅡ ᆼ ᄉ ᅡ ᄀ ᅡ
같은	ᄀ ᅡ ᄐ ᅳ ᆫ
사람이	ᄉ ᅡ ᄅ ᅡ ᄆ ᅵ
친구라니	ᄎ ᅵ ᆫ ᄀ ᅮ ᄅ ᅡ ᄂ ᅵ
행운아야	ᄒ ᅢ ᆼ ᄋ ᅮ ᄂ ᅡ ᄋ ᅣ
사장님	ᄉ ᅡ ᄌ ᅡ ᆼ ᄂ ᅵ ᆷ
오늘부로	ᄋ ᅩ ᄂ ᅳ ᆯ ᄇ ᅮ ᄅ ᅩ
아빠	ᄋ ᅡ ᄈ ᅡ
됐습니다	ᄃ ᅫ ᆮ ᄊ ᅳ ᆷ ᄂ ᅵ ᄃ ᅡ
자기야	ᄌ ᅡ ᄀ ᅵ ᄋ ᅣ
언니	ᄋ ᅥ ᆫ ᄂ ᅵ
사법고시	ᄉ ᅡ ᄇ ᅥ ᆸ ᄁ ᅩ ᄉ ᅵ
합격했어	ᄒ ᅡ ᆸ ᄁ ᅧ ᄏ ᅢ ᄊ ᅥ
순간이	ᄉ ᅮ ᆫ ᄀ ᅡ ᄂ ᅵ
영원했으면	ᄋ ᅧ ᆼ ᄋ ᅯ ᆫ ᄒ ᅢ ᄊ ᅳ ᄆ ᅧ ᆫ
좋겠다	ᄌ ᅩ ᄏ ᅦ ᆮ ᄄ ᅡ
하늘이	ᄒ ᅡ ᄂ ᅳ ᄅ ᅵ
청명하니	ᄎ ᅥ ᆼ ᄆ ᅧ ᆼ ᄒ ᅡ ᄂ ᅵ
기분도	ᄀ ᅵ ᄇ ᅮ ᆫ ᄃ ᅩ
웹	ᄋ ᅰ ᆸ
소설이	ᄉ ᅩ ᄉ ᅥ ᄅ ᅵ
순위권에	ᄉ ᅮ ᄂ ᅱ ᄀ ᅯ ᄂ ᅦ
들었다고요	ᄃ ᅳ ᄅ ᅥ ᆮ ᄄ ᅡ ᄀ ᅩ ᄋ ᅭ
오래간만에	ᄋ ᅩ ᄅ ᅢ ᄀ ᅡ ᆫ ᄆ ᅡ ᄂ ᅦ
기쁜	ᄀ ᅵ ᄈ ᅳ ᆫ
소식을	ᄉ ᅩ ᄉ ᅵ ᄀ ᅳ ᆯ
들으니	ᄃ ᅳ ᄅ ᅳ ᄂ ᅵ
좋네요	ᄌ ᅩ ᆫ ᄂ ᅦ ᄋ ᅭ
끝까지	ᄁ ᅳ ᆮ ᄁ ᅡ ᄌ ᅵ
최선을	ᄎ ᅬ ᄉ ᅥ ᄂ ᅳ ᆯ
다한	ᄃ ᅡ ᄒ ᅡ ᆫ
선수들	ᄉ ᅥ ᆫ ᄉ ᅮ ᄃ ᅳ ᆯ
자랑스럽습니다	ᄌ ᅡ ᄅ ᅡ ᆼ ᄉ ᅳ ᄅ ᅥ ᆸ ᄊ ᅳ ᆷ ᄂ ᅵ ᄃ ᅡ
영화에서나	ᄋ ᅧ ᆼ ᄒ ᅪ ᄋ ᅦ ᄉ ᅥ ᄂ ᅡ
볼	ᄇ ᅩ ᆯ
법한	ᄇ ᅥ ᄑ ᅡ ᆫ
풍경을	ᄑ ᅮ ᆼ ᄀ ᅧ ᆼ ᄋ ᅳ ᆯ
실제로	ᄉ ᅵ ᆯ ᄌ ᅦ ᄅ ᅩ
보다니	ᄇ ᅩ ᄃ ᅡ ᄂ ᅵ
황홀하다	ᄒ ᅪ ᆼ ᄒ ᅩ ᆯ ᄒ ᅡ ᄃ ᅡ
자식들	ᄌ ᅡ ᄉ ᅵ ᆨ ᄄ ᅳ ᆯ
덕을	ᄃ ᅥ ᄀ ᅳ ᆯ
톡톡히	ᄐ ᅩ ᆨ ᄐ ᅩ ᄏ ᅵ
보네	ᄇ ᅩ ᄂ ᅦ
그렇게	ᄀ ᅳ ᄅ ᅥ ᄏ ᅦ
칭찬해	ᄎ ᅵ ᆼ ᄎ ᅡ ᆫ ᄒ ᅢ
주시니	ᄌ ᅮ ᄉ ᅵ ᄂ ᅵ
둘	ᄃ ᅮ ᆯ
바를	ᄇ ᅡ ᄅ ᅳ ᆯ
모르겠네요	ᄆ ᅩ ᄅ ᅳ ᄀ ᅦ ᆫ ᄂ ᅦ ᄋ ᅭ
선생님의	ᄉ ᅥ ᆫ ᄉ ᅢ ᆼ ᄂ ᅵ ᄆ ᅴ
지도로	ᄌ ᅵ ᄃ ᅩ ᄅ ᅩ
해낼	ᄒ ᅢ ᄂ ᅢ ᆯ
있었어요	ᄋ ᅵ ᄊ ᅥ ᄊ ᅥ ᄋ ᅭ
여기에다	ᄋ ᅧ ᄀ ᅵ ᄋ ᅦ ᄃ ᅡ
김치를	ᄀ ᅵ ᆷ ᄎ ᅵ ᄅ ᅳ ᆯ
딱	ᄄ ᅡ ᆨ
얹어	ᄋ ᅥ ᆫ ᄌ ᅥ
먹으면	ᄆ ᅥ ᄀ ᅳ ᄆ ᅧ ᆫ
그만이야	ᄀ ᅳ ᄆ ᅡ ᄂ ᅵ ᄋ ᅣ
다른	ᄃ ᅡ ᄅ ᅳ ᆫ
몰라도	ᄆ ᅩ ᆯ ᄅ ᅡ ᄃ ᅩ
겉절이는	ᄀ ᅥ ᆮ ᄍ ᅥ ᄅ ᅵ ᄂ ᅳ ᆫ
끝내준다니까	ᄁ ᅳ ᆫ ᄂ ᅢ ᄌ ᅮ ᆫ ᄃ ᅡ ᄂ ᅵ ᄁ ᅡ
쥐구멍에도	ᄌ ᅱ ᄀ ᅮ ᄆ ᅥ ᆼ ᄋ ᅦ ᄃ ᅩ
볕들	ᄇ ᅧ ᆮ ᄄ ᅳ ᆯ
날이	ᄂ ᅡ ᄅ ᅵ
있다더니	ᄋ ᅵ ᆮ ᄄ ᅡ ᄃ ᅥ ᄂ ᅵ
인생에도	ᄋ ᅵ ᆫ ᄉ ᅢ ᆼ ᄋ ᅦ ᄃ ᅩ
영광이	ᄋ ᅧ ᆼ ᄀ ᅪ ᆼ ᄋ ᅵ
비치는구나	ᄇ ᅵ ᄎ ᅵ ᄂ ᅳ ᆫ ᄀ ᅮ ᄂ ᅡ
바로	ᄇ ᅡ ᄅ ᅩ
날을	ᄂ ᅡ ᄅ ᅳ ᆯ
위해서	ᄋ ᅱ ᄒ ᅢ ᄉ ᅥ
살아온	ᄉ ᅡ ᄅ ᅡ ᄋ ᅩ ᆫ
거	ᄀ ᅥ
아니겠어	ᄋ ᅡ ᄂ ᅵ ᄀ ᅦ ᄊ ᅥ
반	ᄇ ᅡ ᆫ
학생들의	ᄒ ᅡ ᆨ ᄊ ᅢ ᆼ ᄃ ᅳ ᄅ ᅴ
수학	ᄉ ᅮ ᄒ ᅡ ᆨ
실력이	ᄉ ᅵ ᆯ ᄅ ᅧ ᄀ ᅵ
날로	ᄂ ᅡ ᆯ ᄅ ᅩ
일취월장하네	ᄋ ᅵ ᆯ ᄎ ᅱ ᄋ ᅯ ᆯ ᄌ ᅡ ᆼ ᄒ ᅡ ᄂ ᅦ
이러니	ᄋ ᅵ ᄅ ᅥ ᄂ ᅵ
어떻게	ᄋ ᅥ ᄄ ᅥ ᄏ ᅦ
너를	ᄂ ᅥ ᄅ ᅳ ᆯ
사랑하지	ᄉ ᅡ ᄅ ᅡ ᆼ ᄒ ᅡ ᄌ ᅵ
않고	ᄋ ᅡ ᆫ ᄏ ᅩ
배기겠니	ᄇ ᅢ ᄀ ᅵ ᄀ ᅦ ᆫ ᄂ ᅵ
첫	ᄎ ᅥ ᆮ
아이가	ᄋ ᅡ ᄋ ᅵ ᄀ ᅡ
태어난	ᄐ ᅢ ᄋ ᅥ ᄂ ᅡ ᆫ
기쁨은	ᄀ ᅵ ᄈ ᅳ ᄆ ᅳ ᆫ
평생	ᄑ ᅧ ᆼ ᄉ ᅢ ᆼ
잊지	ᄋ ᅵ ᆮ ᄍ ᅵ
못할	ᄆ ᅩ ᄐ ᅡ ᆯ
풍경이	ᄑ ᅮ ᆼ ᄀ ᅧ ᆼ ᄋ ᅵ
아름다워서	ᄋ ᅡ ᄅ ᅳ ᆷ ᄃ ᅡ ᄋ ᅯ ᄉ ᅥ
가슴이	ᄀ ᅡ ᄉ ᅳ ᄆ ᅵ
뭉클할	ᄆ ᅮ ᆼ ᄏ ᅳ ᆯ ᄒ ᅡ ᆯ
정도야	ᄌ ᅥ ᆼ ᄃ ᅩ ᄋ ᅣ
도전에	ᄃ ᅩ ᄌ ᅥ ᄂ ᅦ
성공했다니	ᄉ ᅥ ᆼ ᄀ ᅩ ᆼ ᄒ ᅢ ᆮ ᄄ ᅡ ᄂ ᅵ
벅차올라서	ᄇ ᅥ ᆨ ᄎ ᅡ ᄋ ᅩ ᆯ ᄅ ᅡ ᄉ ᅥ
울고	ᄋ ᅮ ᆯ ᄀ ᅩ
싶다	ᄉ ᅵ ᆸ ᄄ ᅡ
이따	ᄋ ᅵ ᄄ ᅡ
친구들이랑	ᄎ ᅵ ᆫ ᄀ ᅮ ᄃ ᅳ ᄅ ᅵ ᄅ ᅡ ᆼ
놀러	ᄂ ᅩ ᆯ ᄅ ᅥ
갈	ᄀ ᅡ ᆯ
생각하니까	ᄉ ᅢ ᆼ ᄀ ᅡ ᄏ ᅡ ᄂ ᅵ ᄁ ᅡ
흥분된다	ᄒ ᅳ ᆼ ᄇ ᅮ ᆫ ᄃ ᅬ ᆫ ᄃ ᅡ
맛있는	ᄆ ᅡ ᄉ ᅵ ᆫ ᄂ ᅳ ᆫ
것도	ᄀ ᅥ ᆮ ᄄ ᅩ
먹고	ᄆ ᅥ ᆨ ᄁ ᅩ
재밌게	ᄌ ᅢ ᄆ ᅵ ᆮ ᄁ ᅦ
놀아야지	ᄂ ᅩ ᄅ ᅡ ᄋ ᅣ ᄌ ᅵ
기대된다	ᄀ ᅵ ᄃ ᅢ ᄃ ᅬ ᆫ ᄃ ᅡ
내게	ᄂ ᅢ ᄀ ᅦ
행운이	ᄒ ᅢ ᆼ ᄋ ᅮ ᄂ ᅵ
찾아왔다니	ᄎ ᅡ ᄌ ᅡ ᄋ ᅪ ᆮ ᄄ ᅡ ᄂ ᅵ
실감이	ᄉ ᅵ ᆯ ᄀ ᅡ ᄆ ᅵ
마치	ᄆ ᅡ ᄎ ᅵ
구름	ᄀ ᅮ ᄅ ᅳ ᆷ
위를	ᄋ ᅱ ᄅ ᅳ ᆯ
걷는	ᄀ ᅥ ᆫ ᄂ ᅳ ᆫ
기분이야	ᄀ ᅵ ᄇ ᅮ ᄂ ᅵ ᄋ ᅣ
학자금	ᄒ ᅡ ᆨ ᄍ ᅡ ᄀ ᅳ ᆷ
대출을	ᄃ ᅢ ᄎ ᅮ ᄅ ᅳ ᆯ
갚고	ᄀ ᅡ ᆸ ᄁ ᅩ
나니까	ᄂ ᅡ ᄂ ᅵ ᄁ ᅡ
홀가분해졌어	ᄒ ᅩ ᆯ ᄀ ᅡ ᄇ ᅮ ᆫ ᄒ ᅢ ᄌ ᅥ ᄊ ᅥ
소프라노의	ᄉ ᅩ ᄑ ᅳ ᄅ ᅡ ᄂ ᅩ ᄋ ᅴ
목소리가	ᄆ ᅩ ᆨ ᄊ ᅩ ᄅ ᅵ ᄀ ᅡ
어릴	ᄋ ᅥ ᄅ ᅵ ᆯ
때	ᄄ ᅢ
먹었던	ᄆ ᅥ ᄀ ᅥ ᆮ ᄄ ᅥ ᆫ
솜사탕처럼	ᄉ ᅩ ᆷ ᄉ ᅡ ᄐ ᅡ ᆼ ᄎ ᅥ ᄅ ᅥ ᆷ
감미롭다	ᄀ ᅡ ᆷ ᄆ ᅵ ᄅ ᅩ ᆸ ᄄ ᅡ
남자친구가	ᄂ ᅡ ᆷ ᄌ ᅡ ᄎ ᅵ ᆫ ᄀ ᅮ ᄀ ᅡ
몰래	ᄆ ᅩ ᆯ ᄅ ᅢ
깜짝	ᄁ ᅡ ᆷ ᄍ ᅡ ᆨ
생일	ᄉ ᅢ ᆼ ᄋ ᅵ ᆯ
파티에	ᄑ ᅡ ᄐ ᅵ ᄋ ᅦ
감동했어	ᄀ ᅡ ᆷ ᄃ ᅩ ᆼ ᄒ ᅢ ᄊ ᅥ
사람의	ᄉ ᅡ ᄅ ᅡ ᄆ ᅴ
호탕한	ᄒ ᅩ ᄐ ᅡ ᆼ ᄒ ᅡ ᆫ
웃음소리를	ᄋ ᅮ ᄉ ᅳ ᆷ ᄉ ᅩ ᄅ ᅵ ᄅ ᅳ ᆯ
듣고	ᄃ ᅳ ᆮ ᄁ ᅩ
있으면	ᄋ ᅵ ᄊ ᅳ ᄆ ᅧ ᆫ
나까지	ᄂ ᅡ ᄁ ᅡ ᄌ ᅵ
유쾌해져	ᄋ ᅲ ᄏ ᅫ ᄒ ᅢ ᄌ ᅥ
호텔	ᄒ ᅩ ᄐ ᅦ ᆯ
시설이	ᄉ ᅵ ᄉ ᅥ ᄅ ᅵ
예약	ᄋ ᅨ ᄋ ᅣ ᆨ
사이트에서	ᄉ ᅡ ᄋ ᅵ ᄐ ᅳ ᄋ ᅦ ᄉ ᅥ
것보다	ᄀ ᅥ ᆮ ᄈ ᅩ ᄃ ᅡ
깨끗하고	ᄁ ᅢ ᄁ ᅳ ᄐ ᅡ ᄀ ᅩ
쾌적해서	ᄏ ᅫ ᄌ ᅥ ᄏ ᅢ ᄉ ᅥ
만족스러워	ᄆ ᅡ ᆫ ᄌ ᅩ ᆨ ᄊ ᅳ ᄅ ᅥ ᄋ ᅯ
배고팠는데	ᄇ ᅢ ᄀ ᅩ ᄑ ᅡ ᆫ ᄂ ᅳ ᆫ ᄃ ᅦ
이제야	ᄋ ᅵ ᄌ ᅦ ᄋ ᅣ
살	ᄉ ᅡ ᆯ
일일	ᄋ ᅵ ᄅ ᅵ ᆯ
일	ᄋ ᅵ ᆯ
팩	ᄑ ᅢ ᆨ
실천하고	ᄉ ᅵ ᆯ ᄎ ᅥ ᆫ ᄒ ᅡ ᄀ ᅩ
있거든	ᄋ ᅵ ᆮ ᄁ ᅥ ᄃ ᅳ ᆫ
얼굴에서	ᄋ ᅥ ᆯ ᄀ ᅮ ᄅ ᅦ ᄉ ᅥ
빛이	ᄇ ᅵ ᄎ ᅵ
나지	ᄂ ᅡ ᄌ ᅵ
갑자기	ᄀ ᅡ ᆸ ᄍ ᅡ ᄀ ᅵ
쏟아지던	ᄊ ᅩ ᄃ ᅡ ᄌ ᅵ ᄃ ᅥ ᆫ
그치고	ᄀ ᅳ ᄎ ᅵ ᄀ ᅩ
나니	ᄂ ᅡ ᄂ ᅵ
날씨가	ᄂ ᅡ ᆯ ᄊ ᅵ ᄀ ᅡ
화창해졌어	ᄒ ᅪ ᄎ ᅡ ᆼ ᄒ ᅢ ᄌ ᅥ ᄊ ᅥ
주말에	ᄌ ᅮ ᄆ ᅡ ᄅ ᅦ
푹	ᄑ ᅮ ᆨ
쉬어서	ᄉ ᅱ ᄋ ᅥ ᄉ ᅥ
월요일	ᄋ ᅯ ᄅ ᅭ ᄋ ᅵ ᆯ
아침을	ᄋ ᅡ ᄎ ᅵ ᄆ ᅳ ᆯ
활기차게	ᄒ ᅪ ᆯ ᄀ ᅵ ᄎ ᅡ ᄀ ᅦ
성과가	ᄉ ᅥ ᆼ ᄀ ᅪ ᄀ ᅡ
나오기	ᄂ ᅡ ᄋ ᅩ ᄀ ᅵ
시작했어	ᄉ ᅵ ᄌ ᅡ ᄏ ᅢ ᄊ ᅥ
기다린	ᄀ ᅵ ᄃ ᅡ ᄅ ᅵ ᆫ
보람이	ᄇ ᅩ ᄅ ᅡ ᄆ ᅵ
다행이야	ᄃ ᅡ ᄒ ᅢ ᆼ ᄋ ᅵ ᄋ ᅣ
미숙아였던	ᄆ ᅵ ᄉ ᅮ ᄀ ᅡ ᄋ ᅧ ᆮ ᄄ ᅥ ᆫ
아들	ᄋ ᅡ ᄃ ᅳ ᆯ
녀석이	ᄂ ᅧ ᄉ ᅥ ᄀ ᅵ
씩씩하고	ᄊ ᅵ ᆨ ᄊ ᅵ ᄏ ᅡ ᄀ ᅩ
건강하게	ᄀ ᅥ ᆫ ᄀ ᅡ ᆼ ᄒ ᅡ ᄀ ᅦ
자라줘서	ᄌ ᅡ ᄅ ᅡ ᄌ ᅯ ᄉ ᅥ
대견해요	ᄃ ᅢ ᄀ ᅧ ᆫ ᄒ ᅢ ᄋ ᅭ
다행히	ᄃ ᅡ ᄒ ᅢ ᆼ ᄒ ᅵ
배	ᄇ ᅢ
속에	ᄉ ᅩ ᄀ ᅦ
크고	ᄏ ᅳ ᄀ ᅩ
있대요	ᄋ ᅵ ᆮ ᄄ ᅢ ᄋ ᅭ
연락이	ᄋ ᅧ ᆯ ᄅ ᅡ ᄀ ᅵ
끊겼던	ᄁ ᅳ ᆫ ᄏ ᅧ ᆮ ᄄ ᅥ ᆫ
친구의	ᄎ ᅵ ᆫ ᄀ ᅮ ᄋ ᅴ
알게	ᄋ ᅡ ᆯ ᄀ ᅦ
됐어요	ᄃ ᅫ ᄊ ᅥ ᄋ ᅭ
천진난만한	ᄎ ᅥ ᆫ ᄌ ᅵ ᆫ ᄂ ᅡ ᆫ ᄆ ᅡ ᆫ ᄒ ᅡ ᆫ
아이들의	ᄋ ᅡ ᄋ ᅵ ᄃ ᅳ ᄅ ᅴ
미소를	ᄆ ᅵ ᄉ ᅩ ᄅ ᅳ ᆯ
보니	ᄇ ᅩ ᄂ ᅵ
좋아지네요	ᄌ ᅩ ᄋ ᅡ ᄌ ᅵ ᄂ ᅦ ᄋ ᅭ
메리	ᄆ ᅦ ᄅ ᅵ
크리스마스	ᄏ ᅳ ᄅ ᅵ ᄉ ᅳ ᄆ ᅡ ᄉ ᅳ
즐거운	ᄌ ᅳ ᆯ ᄀ ᅥ ᄋ ᅮ ᆫ
성탄절	ᄉ ᅥ ᆼ ᄐ ᅡ ᆫ ᄌ ᅥ ᆯ
보내세요	ᄇ ᅩ ᄂ ᅢ ᄉ ᅦ ᄋ ᅭ
우리의	ᄋ ᅮ ᄅ ᅵ ᄋ ᅴ
만남을	ᄆ ᅡ ᆫ ᄂ ᅡ ᄆ ᅳ ᆯ
축복하듯	ᄎ ᅮ ᆨ ᄈ ᅩ ᄏ ᅡ ᄃ ᅳ ᆮ
하늘에서	ᄒ ᅡ ᄂ ᅳ ᄅ ᅦ ᄉ ᅥ
벚꽃이	ᄇ ᅥ ᆮ ᄁ ᅩ ᄎ ᅵ
흩날리네요	ᄒ ᅳ ᆫ ᄂ ᅡ ᆯ ᄅ ᅵ ᄂ ᅦ ᄋ ᅭ
좋게	ᄌ ᅩ ᄏ ᅦ
비행기	ᄇ ᅵ ᄒ ᅢ ᆼ ᄀ ᅵ
좌석을	ᄌ ᅪ ᄉ ᅥ ᄀ ᅳ ᆯ
업그레이드	ᄋ ᅥ ᆸ ᄁ ᅳ ᄅ ᅦ ᄋ ᅵ ᄃ ᅳ
받았어요	ᄇ ᅡ ᄃ ᅡ ᄊ ᅥ ᄋ ᅭ
연탄	ᄋ ᅧ ᆫ ᄐ ᅡ ᆫ
배달	ᄇ ᅢ ᄃ ᅡ ᆯ
봉사	ᄇ ᅩ ᆼ ᄉ ᅡ
활동을	ᄒ ᅪ ᆯ ᄃ ᅩ ᆼ ᄋ ᅳ ᆯ
했데	ᄒ ᅢ ᆮ ᄄ ᅦ
힘들었지만	ᄒ ᅵ ᆷ ᄃ ᅳ ᄅ ᅥ ᆮ ᄍ ᅵ ᄆ ᅡ ᆫ
나눔의	ᄂ ᅡ ᄂ ᅮ ᄆ ᅴ
기쁨이란	ᄀ ᅵ ᄈ ᅳ ᄆ ᅵ ᄅ ᅡ ᆫ
시험이	ᄉ ᅵ ᄒ ᅥ ᄆ ᅵ
끝났어	ᄁ ᅳ ᆫ ᄂ ᅡ ᄊ ᅥ
신나게	ᄉ ᅵ ᆫ ᄂ ᅡ ᄀ ᅦ
즐길	ᄌ ᅳ ᆯ ᄀ ᅵ ᆯ
제가	ᄌ ᅦ ᄀ ᅡ
유럽	ᄋ ᅲ ᄅ ᅥ ᆸ
여행에	ᄋ ᅧ ᄒ ᅢ ᆼ ᄋ ᅦ
당첨됐다고요	ᄃ ᅡ ᆼ ᄎ ᅥ ᆷ ᄃ ᅫ ᆮ ᄄ ᅡ ᄀ ᅩ ᄋ ᅭ
나의	ᄂ ᅡ ᄋ ᅴ
고백을	ᄀ ᅩ ᄇ ᅢ ᄀ ᅳ ᆯ
받아줘서	ᄇ ᅡ ᄃ ᅡ ᄌ ᅯ ᄉ ᅥ
세상을	ᄉ ᅦ ᄉ ᅡ ᆼ ᄋ ᅳ ᆯ
가진	ᄀ ᅡ ᄌ ᅵ ᆫ
것만	ᄀ ᅥ ᆫ ᄆ ᅡ ᆫ
같아요	ᄀ ᅡ ᄐ ᅡ ᄋ ᅭ
저에게	ᄌ ᅥ ᄋ ᅦ ᄀ ᅦ
올지는	ᄋ ᅩ ᆯ ᄌ ᅵ ᄂ ᅳ ᆫ
몰랐어요	ᄆ ᅩ ᆯ ᄅ ᅡ ᄊ ᅥ ᄋ ᅭ
이번에	ᄋ ᅵ ᄇ ᅥ ᄂ ᅦ
제대로	ᄌ ᅦ ᄃ ᅢ ᄅ ᅩ
횡재했어	ᄒ ᅬ ᆼ ᄌ ᅢ ᄒ ᅢ ᄊ ᅥ
가격도	ᄀ ᅡ ᄀ ᅧ ᆨ ᄄ ᅩ
가격이지만	ᄀ ᅡ ᄀ ᅧ ᄀ ᅵ ᄌ ᅵ ᄆ ᅡ ᆫ
원	ᄋ ᅯ ᆫ
플러스	ᄑ ᅳ ᆯ ᄅ ᅥ ᄉ ᅳ
원이지	ᄋ ᅯ ᄂ ᅵ ᄌ ᅵ
뭐야	ᄆ ᅯ ᄋ ᅣ
어떡해	ᄋ ᅥ ᄄ ᅥ ᄏ ᅢ
면접	ᄆ ᅧ ᆫ ᄌ ᅥ ᆸ
숨겨둔	ᄉ ᅮ ᆷ ᄀ ᅧ ᄃ ᅮ ᆫ
비상금도	ᄇ ᅵ ᄉ ᅡ ᆼ ᄀ ᅳ ᆷ ᄃ ᅩ
모른	ᄆ ᅩ ᄅ ᅳ ᆫ
척해주고	ᄎ ᅥ ᄏ ᅢ ᄌ ᅮ ᄀ ᅩ
마누라	ᄆ ᅡ ᄂ ᅮ ᄅ ᅡ
최고	ᄎ ᅬ ᄀ ᅩ
너한테	ᄂ ᅥ ᄒ ᅡ ᆫ ᄐ ᅦ
말을	ᄆ ᅡ ᄅ ᅳ ᆯ
들으니까	ᄃ ᅳ ᄅ ᅳ ᄂ ᅵ ᄁ ᅡ
아프다	ᄋ ᅡ ᄑ ᅳ ᄃ ᅡ
좋아했던	ᄌ ᅩ ᄋ ᅡ ᄒ ᅢ ᆮ ᄄ ᅥ ᆫ
배우였는데	ᄇ ᅢ ᄋ ᅮ ᄋ ᅧ ᆫ ᄂ ᅳ ᆫ ᄃ ᅦ
그런	ᄀ ᅳ ᄅ ᅥ ᆫ
사고를	ᄉ ᅡ ᄀ ᅩ ᄅ ᅳ ᆯ
당했다니	ᄃ ᅡ ᆼ ᄒ ᅢ ᆮ ᄄ ᅡ ᄂ ᅵ
속상해	ᄉ ᅩ ᆨ ᄊ ᅡ ᆼ ᄒ ᅢ
입영	ᄋ ᅵ ᄇ ᅧ ᆼ
통지서를	ᄐ ᅩ ᆼ ᄌ ᅵ ᄉ ᅥ ᄅ ᅳ ᆯ
받았거든	ᄇ ᅡ ᄃ ᅡ ᆮ ᄁ ᅥ ᄃ ᅳ ᆫ
우울해	ᄋ ᅮ ᄋ ᅮ ᆯ ᄒ ᅢ
어머니가	ᄋ ᅥ ᄆ ᅥ ᄂ ᅵ ᄀ ᅡ
장례식에	ᄌ ᅡ ᆼ ᄂ ᅨ ᄉ ᅵ ᄀ ᅦ
다녀온	ᄃ ᅡ ᄂ ᅧ ᄋ ᅩ ᆫ
후로	ᄒ ᅮ ᄅ ᅩ
계속	ᄀ ᅨ ᄉ ᅩ ᆨ
기운이	ᄀ ᅵ ᄋ ᅮ ᄂ ᅵ
없으셔서	ᄋ ᅥ ᆸ ᄊ ᅳ ᄉ ᅧ ᄉ ᅥ
걱정된다	ᄀ ᅥ ᆨ ᄍ ᅥ ᆼ ᄃ ᅬ ᆫ ᄃ ᅡ
선생님	ᄉ ᅥ ᆫ ᄉ ᅢ ᆼ ᄂ ᅵ ᆷ
애석한	ᄋ ᅢ ᄉ ᅥ ᄏ ᅡ ᆫ
금할	ᄀ ᅳ ᆷ ᄒ ᅡ ᆯ
길이	ᄀ ᅵ ᄅ ᅵ
너까지	ᄂ ᅥ ᄁ ᅡ ᄌ ᅵ
말할	ᄆ ᅡ ᆯ ᄒ ᅡ ᆯ
줄이야	ᄌ ᅮ ᄅ ᅵ ᄋ ᅣ
서럽다	ᄉ ᅥ ᄅ ᅥ ᆸ ᄄ ᅡ
위로가	ᄋ ᅱ ᄅ ᅩ ᄀ ᅡ
필요한데	ᄑ ᅵ ᄅ ᅭ ᄒ ᅡ ᆫ ᄃ ᅦ
아무도	ᄋ ᅡ ᄆ ᅮ ᄃ ᅩ
없으니	ᄋ ᅥ ᆸ ᄊ ᅳ ᄂ ᅵ
울적해	ᄋ ᅮ ᆯ ᄌ ᅥ ᄏ ᅢ
다시	ᄃ ᅡ ᄉ ᅵ
못	ᄆ ᅩ ᆮ
본다고	ᄇ ᅩ ᆫ ᄃ ᅡ ᄀ ᅩ
눈물만	ᄂ ᅮ ᆫ ᄆ ᅮ ᆯ ᄆ ᅡ ᆫ
고시원에서도	ᄀ ᅩ ᄉ ᅵ ᄋ ᅯ ᄂ ᅦ ᄉ ᅥ ᄃ ᅩ
쫓겨나고	ᄍ ᅩ ᆮ ᄁ ᅧ ᄂ ᅡ ᄀ ᅩ
처지가	ᄎ ᅥ ᄌ ᅵ ᄀ ᅡ
서글퍼서	ᄉ ᅥ ᄀ ᅳ ᆯ ᄑ ᅥ ᄉ ᅥ
싶어	ᄉ ᅵ ᄑ ᅥ
친구들	ᄎ ᅵ ᆫ ᄀ ᅮ ᄃ ᅳ ᆯ
집이나	ᄌ ᅵ ᄇ ᅵ ᄂ ᅡ
전전하는	ᄌ ᅥ ᆫ ᄌ ᅥ ᆫ ᄒ ᅡ ᄂ ᅳ ᆫ
신세가	ᄉ ᅵ ᆫ ᄉ ᅦ ᄀ ᅡ
처량하다	ᄎ ᅥ ᄅ ᅣ ᆼ ᄒ ᅡ ᄃ ᅡ
시골	ᄉ ᅵ ᄀ ᅩ ᆯ
부모님이	ᄇ ᅮ ᄆ ᅩ ᄂ ᅵ ᄆ ᅵ
보내주신	ᄇ ᅩ ᄂ ᅢ ᄌ ᅮ ᄉ ᅵ ᆫ
한약을	ᄒ ᅡ ᄂ ᅣ ᄀ ᅳ ᆯ
목이	ᄆ ᅩ ᄀ ᅵ
멘다	ᄆ ᅦ ᆫ ᄃ ᅡ
해준	ᄒ ᅢ ᄌ ᅮ ᆫ
얼만데	ᄋ ᅥ ᆯ ᄆ ᅡ ᆫ ᄃ ᅦ
섭섭하다	ᄉ ᅥ ᆸ ᄊ ᅥ ᄑ ᅡ ᄃ ᅡ
투병	ᄐ ᅮ ᄇ ᅧ ᆼ
중이시라는	ᄌ ᅮ ᆼ ᄋ ᅵ ᄉ ᅵ ᄅ ᅡ ᄂ ᅳ ᆫ
그분	ᄀ ᅳ ᄇ ᅮ ᆫ
부자는	ᄇ ᅮ ᄌ ᅡ ᄂ ᅳ ᆫ
망해도	ᄆ ᅡ ᆼ ᄒ ᅢ ᄃ ᅩ
삼대는	ᄉ ᅡ ᆷ ᄃ ᅢ ᄂ ᅳ ᆫ
간다던데	ᄀ ᅡ ᆫ ᄃ ᅡ ᄃ ᅥ ᆫ ᄃ ᅦ
사정이	ᄉ ᅡ ᄌ ᅥ ᆼ ᄋ ᅵ
딱하게	ᄄ ᅡ ᄏ ᅡ ᄀ ᅦ
됐어	ᄃ ᅫ ᄊ ᅥ
프로젝트가	ᄑ ᅳ ᄅ ᅩ ᄌ ᅦ ᆨ ᄐ ᅳ ᄀ ᅡ
무산됐다니	ᄆ ᅮ ᄉ ᅡ ᆫ ᄃ ᅫ ᆮ ᄄ ᅡ ᄂ ᅵ
다했는데	ᄃ ᅡ ᄒ ᅢ ᆫ ᄂ ᅳ ᆫ ᄃ ᅦ
안타깝다	ᄋ ᅡ ᆫ ᄐ ᅡ ᄁ ᅡ ᆸ ᄄ ᅡ
계약	ᄀ ᅨ ᄋ ᅣ ᆨ
종료인데	ᄌ ᅩ ᆼ ᄂ ᅭ ᄋ ᅵ ᆫ ᄃ ᅦ
열심히	ᄋ ᅧ ᆯ ᄉ ᅵ ᆷ ᄒ ᅵ
애쓰는	ᄋ ᅢ ᄊ ᅳ ᄂ ᅳ ᆫ
모습이	ᄆ ᅩ ᄉ ᅳ ᄇ ᅵ
안쓰러워	ᄋ ᅡ ᆫ ᄊ ᅳ ᄅ ᅥ ᄋ ᅯ
죽겠어	ᄌ ᅮ ᆨ ᄁ ᅦ ᄊ ᅥ
주인이	ᄌ ᅮ ᄋ ᅵ ᄂ ᅵ
교통사고라며	ᄀ ᅭ ᄐ ᅩ ᆼ ᄉ ᅡ ᄀ ᅩ ᄅ ᅡ ᄆ ᅧ
불쌍해서	ᄇ ᅮ ᆯ ᄊ ᅡ ᆼ ᄒ ᅢ ᄉ ᅥ
또	ᄄ ᅩ
불합격	ᄇ ᅮ ᆯ ᄒ ᅡ ᆸ ᄁ ᅧ ᆨ
괴로워서	ᄀ ᅬ ᄅ ᅩ ᄋ ᅯ ᄉ ᅥ
숨이	ᄉ ᅮ ᄆ ᅵ
쉬어져	ᄉ ᅱ ᄋ ᅥ ᄌ ᅥ
술에	ᄉ ᅮ ᄅ ᅦ
취한	ᄎ ᅱ ᄒ ᅡ ᆫ
아버지의	ᄋ ᅡ ᄇ ᅥ ᄌ ᅵ ᄋ ᅴ
노랫가락이	ᄂ ᅩ ᄅ ᅢ ᆮ ᄁ ᅡ ᄅ ᅡ ᄀ ᅵ
오늘따라	ᄋ ᅩ ᄂ ᅳ ᆯ ᄄ ᅡ ᄅ ᅡ
구슬프게	ᄀ ᅮ ᄉ ᅳ ᆯ ᄑ ᅳ ᄀ ᅦ
들리네	ᄃ ᅳ ᆯ ᄅ ᅵ ᄂ ᅦ
그녀가	ᄀ ᅳ ᄂ ᅧ ᄀ ᅡ
남자와	ᄂ ᅡ ᆷ ᄌ ᅡ ᄋ ᅪ
결혼을	ᄀ ᅧ ᆯ ᄒ ᅩ ᄂ ᅳ ᆯ
하다니	ᄒ ᅡ ᄃ ᅡ ᄂ ᅵ
무너지는	ᄆ ᅮ ᄂ ᅥ ᄌ ᅵ ᄂ ᅳ ᆫ
탓인가	ᄐ ᅡ ᄉ ᅵ ᆫ ᄀ ᅡ
이상하게	ᄋ ᅵ ᄉ ᅡ ᆼ ᄒ ᅡ ᄀ ᅦ
축축	ᄎ ᅮ ᆨ ᄎ ᅮ ᆨ
처져요	ᄎ ᅥ ᄌ ᅥ ᄋ ᅭ
그때	ᄀ ᅳ ᄄ ᅢ
사고로	ᄉ ᅡ ᄀ ᅩ ᄅ ᅩ
돌아가신	ᄃ ᅩ ᄅ ᅡ ᄀ ᅡ ᄉ ᅵ ᆫ
분들을	ᄇ ᅮ ᆫ ᄃ ᅳ ᄅ ᅳ ᆯ
생각하면	ᄉ ᅢ ᆼ ᄀ ᅡ ᄏ ᅡ ᄆ ᅧ ᆫ
애석할	ᄋ ᅢ ᄉ ᅥ ᄏ ᅡ ᆯ
따름이야	ᄄ ᅡ ᄅ ᅳ ᄆ ᅵ ᄋ ᅣ
날	ᄂ ᅡ ᆯ
좋으련만	ᄌ ᅩ ᄋ ᅳ ᄅ ᅧ ᆫ ᄆ ᅡ ᆫ
아쉽다	ᄋ ᅡ ᄉ ᅱ ᆸ ᄄ ᅡ
병석에	ᄇ ᅧ ᆼ ᄉ ᅥ ᄀ ᅦ
누워	ᄂ ᅮ ᄋ ᅯ
보고	ᄇ ᅩ ᄀ ᅩ
눈물이	ᄂ ᅮ ᆫ ᄆ ᅮ ᄅ ᅵ
이제	ᄋ ᅵ ᄌ ᅦ
화도	ᄒ ᅪ ᄃ ᅩ
다만	ᄃ ᅡ ᄆ ᅡ ᆫ
이렇게밖에	ᄋ ᅵ ᄅ ᅥ ᄏ ᅦ ᄇ ᅡ ᄁ ᅦ
못하는	ᄆ ᅩ ᄐ ᅡ ᄂ ᅳ ᆫ
자신에게	ᄌ ᅡ ᄉ ᅵ ᄂ ᅦ ᄀ ᅦ
실망스러울	ᄉ ᅵ ᆯ ᄆ ᅡ ᆼ ᄉ ᅳ ᄅ ᅥ ᄋ ᅮ ᆯ
뿐이야	ᄈ ᅮ ᄂ ᅵ ᄋ ᅣ
회색빛으로	ᄒ ᅬ ᄉ ᅢ ᆨ ᄈ ᅵ ᄎ ᅳ ᄅ ᅩ
가득한	ᄀ ᅡ ᄃ ᅳ ᄏ ᅡ ᆫ
마음처럼	ᄆ ᅡ ᄋ ᅳ ᆷ ᄎ ᅥ ᄅ ᅥ ᆷ
세상도	ᄉ ᅦ ᄉ ᅡ ᆼ ᄃ ᅩ
우중충해	ᄋ ᅮ ᄌ ᅮ ᆼ ᄎ ᅮ ᆼ ᄒ ᅢ
보인다	ᄇ ᅩ ᄋ ᅵ ᆫ ᄃ ᅡ
명절인데	ᄆ ᅧ ᆼ ᄌ ᅥ ᄅ ᅵ ᆫ ᄃ ᅦ
부모님을	ᄇ ᅮ ᄆ ᅩ ᄂ ᅵ ᄆ ᅳ ᆯ
뵐	ᄇ ᅬ ᆯ
면목도	ᄆ ᅧ ᆫ ᄆ ᅩ ᆨ ᄄ ᅩ
없고	ᄋ ᅥ ᆸ ᄁ ᅩ
마음만	ᄆ ᅡ ᄋ ᅳ ᆷ ᄆ ᅡ ᆫ
무거워진다	ᄆ ᅮ ᄀ ᅥ ᄋ ᅯ ᄌ ᅵ ᆫ ᄃ ᅡ
기일이	ᄀ ᅵ ᄋ ᅵ ᄅ ᅵ
다가오니	ᄃ ᅡ ᄀ ᅡ ᄋ ᅩ ᄂ ᅵ
할머님	ᄒ ᅡ ᆯ ᄆ ᅥ ᄂ ᅵ ᆷ
생각이	ᄉ ᅢ ᆼ ᄀ ᅡ ᄀ ᅵ
나는구나	ᄂ ᅡ ᄂ ᅳ ᆫ ᄀ ᅮ ᄂ ᅡ
혼자	ᄒ ᅩ ᆫ ᄌ ᅡ
있으려니	ᄋ ᅵ ᄊ ᅳ ᄅ ᅧ ᄂ ᅵ
쓸쓸하다	ᄊ ᅳ ᆯ ᄊ ᅳ ᆯ ᄒ ᅡ ᄃ ᅡ
차라리	ᄎ ᅡ ᄅ ᅡ ᄅ ᅵ
아팠으면	ᄋ ᅡ ᄑ ᅡ ᄊ ᅳ ᄆ ᅧ ᆫ
잘하고	ᄌ ᅡ ᆯ ᄒ ᅡ ᄀ ᅩ
싶은데	ᄉ ᅵ ᄑ ᅳ ᆫ ᄃ ᅦ
맘대로	ᄆ ᅡ ᆷ ᄃ ᅢ ᄅ ᅩ
되지	ᄃ ᅬ ᄌ ᅵ
않네	ᄋ ᅡ ᆫ ᄂ ᅦ
유리창	ᄋ ᅲ ᄅ ᅵ ᄎ ᅡ ᆼ
밖의	ᄇ ᅡ ᄁ ᅴ
사람들은	ᄉ ᅡ ᄅ ᅡ ᆷ ᄃ ᅳ ᄅ ᅳ ᆫ
저렇게	ᄌ ᅥ ᄅ ᅥ ᄏ ᅦ
행복할까	ᄒ ᅢ ᆼ ᄇ ᅩ ᄏ ᅡ ᆯ ᄁ ᅡ
가장의	ᄀ ᅡ ᄌ ᅡ ᆼ ᄋ ᅴ
무게에	ᄆ ᅮ ᄀ ᅦ ᄋ ᅦ
짓눌린	ᄌ ᅵ ᆫ ᄂ ᅮ ᆯ ᄅ ᅵ ᆫ
뒷모습이	ᄃ ᅱ ᆫ ᄆ ᅩ ᄉ ᅳ ᄇ ᅵ
애처로워	ᄋ ᅢ ᄎ ᅥ ᄅ ᅩ ᄋ ᅯ
보여	ᄇ ᅩ ᄋ ᅧ
민석이는	ᄆ ᅵ ᆫ ᄉ ᅥ ᄀ ᅵ ᄂ ᅳ ᆫ
이번에도	ᄋ ᅵ ᄇ ᅥ ᄂ ᅦ ᄃ ᅩ
서류	ᄉ ᅥ ᄅ ᅲ
심사에서	ᄉ ᅵ ᆷ ᄉ ᅡ ᄋ ᅦ ᄉ ᅥ
떨어졌대	ᄄ ᅥ ᄅ ᅥ ᄌ ᅥ ᆮ ᄄ ᅢ
축	ᄎ ᅮ ᆨ
처진	ᄎ ᅥ ᄌ ᅵ ᆫ
양	ᄋ ᅣ ᆼ
어깨를	ᄋ ᅥ ᄁ ᅢ ᄅ ᅳ ᆯ
그러고	ᄀ ᅳ ᄅ ᅥ ᄀ ᅩ
싶지	ᄉ ᅵ ᆸ ᄍ ᅵ
않은데	ᄋ ᅡ ᄂ ᅳ ᆫ ᄃ ᅦ
자꾸	ᄌ ᅡ ᄁ ᅮ
처지를	ᄎ ᅥ ᄌ ᅵ ᄅ ᅳ ᆯ
비관하게	ᄇ ᅵ ᄀ ᅪ ᆫ ᄒ ᅡ ᄀ ᅦ
팀원들	ᄐ ᅵ ᄆ ᅯ ᆫ ᄃ ᅳ ᆯ
기대했을	ᄀ ᅵ ᄃ ᅢ ᄒ ᅢ ᄊ ᅳ ᆯ
텐데	ᄐ ᅦ ᆫ ᄃ ᅦ
좋지	ᄌ ᅩ ᄎ ᅵ
않아	ᄋ ᅡ ᄂ ᅡ
무겁네요	ᄆ ᅮ ᄀ ᅥ ᆷ ᄂ ᅦ ᄋ ᅭ
와서	ᄋ ᅪ ᄉ ᅥ
해야	ᄒ ᅢ ᄋ ᅣ
했던	ᄒ ᅢ ᆮ ᄄ ᅥ ᆫ
건데	ᄀ ᅥ ᆫ ᄃ ᅦ
후회스러워	ᄒ ᅮ ᄒ ᅬ ᄉ ᅳ ᄅ ᅥ ᄋ ᅯ
낙담하지	ᄂ ᅡ ᆨ ᄄ ᅡ ᆷ ᄒ ᅡ ᄌ ᅵ
말라는	ᄆ ᅡ ᆯ ᄅ ᅡ ᄂ ᅳ ᆫ
들어도	ᄃ ᅳ ᄅ ᅥ ᄃ ᅩ
어쩔	ᄋ ᅥ ᄍ ᅥ ᆯ
없는	ᄋ ᅥ ᆷ ᄂ ᅳ ᆫ
사는	ᄉ ᅡ ᄂ ᅳ ᆫ
아니야	ᄋ ᅡ ᄂ ᅵ ᄋ ᅣ
진심	ᄌ ᅵ ᆫ ᄉ ᅵ ᆷ
죽고	ᄌ ᅮ ᆨ ᄁ ᅩ
아버지가	ᄋ ᅡ ᄇ ᅥ ᄌ ᅵ ᄀ ᅡ
모습을	ᄆ ᅩ ᄉ ᅳ ᄇ ᅳ ᆯ
보셨으면	ᄇ ᅩ ᄉ ᅧ ᄊ ᅳ ᄆ ᅧ ᆫ
얼마나	ᄋ ᅥ ᆯ ᄆ ᅡ ᄂ ᅡ
좋아하셨을까	ᄌ ᅩ ᄋ ᅡ ᄒ ᅡ ᄉ ᅧ ᄊ ᅳ ᆯ ᄁ ᅡ
병원에	ᄇ ᅧ ᆼ ᄋ ᅯ ᄂ ᅦ
계신	ᄀ ᅨ ᄉ ᅵ ᆫ
어머니를	ᄋ ᅥ ᄆ ᅥ ᄂ ᅵ ᄅ ᅳ ᆯ
떠올리면	ᄄ ᅥ ᄋ ᅩ ᆯ ᄅ ᅵ ᄆ ᅧ ᆫ
무너져	ᄆ ᅮ ᄂ ᅥ ᄌ ᅥ
내리는	ᄂ ᅢ ᄅ ᅵ ᄂ ᅳ ᆫ
할아버지는	ᄒ ᅡ ᄅ ᅡ ᄇ ᅥ ᄌ ᅵ ᄂ ᅳ ᆫ
언제쯤	ᄋ ᅥ ᆫ ᄌ ᅦ ᄍ ᅳ ᆷ
북녘의	ᄇ ᅮ ᆼ ᄂ ᅧ ᄏ ᅴ
고향	ᄀ ᅩ ᄒ ᅣ ᆼ
땅을	ᄄ ᅡ ᆼ ᄋ ᅳ ᆯ
밟아	ᄇ ᅡ ᄇ ᅡ
보실	ᄇ ᅩ ᄉ ᅵ ᆯ
있을까	ᄋ ᅵ ᄊ ᅳ ᆯ ᄁ ᅡ
힘들게	ᄒ ᅵ ᆷ ᄃ ᅳ ᆯ ᄀ ᅦ
공모전인데	ᄀ ᅩ ᆼ ᄆ ᅩ ᄌ ᅥ ᄂ ᅵ ᆫ ᄃ ᅦ
발표를	ᄇ ᅡ ᆯ ᄑ ᅭ ᄅ ᅳ ᆯ
연기한다니	ᄋ ᅧ ᆫ ᄀ ᅵ ᄒ ᅡ ᆫ ᄃ ᅡ ᄂ ᅵ
맥	ᄆ ᅢ ᆨ
빠진다	ᄈ ᅡ ᄌ ᅵ ᆫ ᄃ ᅡ
기다리는	ᄀ ᅵ ᄃ ᅡ ᄅ ᅵ ᄂ ᅳ ᆫ
지쳤어	ᄌ ᅵ ᄎ ᅥ ᄊ ᅥ
그만	ᄀ ᅳ ᄆ ᅡ ᆫ
돌아왔으면	ᄃ ᅩ ᄅ ᅡ ᄋ ᅪ ᄊ ᅳ ᄆ ᅧ ᆫ
좋겠어	ᄌ ᅩ ᄏ ᅦ ᄊ ᅥ
앞에서	ᄋ ᅡ ᄑ ᅦ ᄉ ᅥ
척하는	ᄎ ᅥ ᄏ ᅡ ᄂ ᅳ ᆫ
이젠	ᄋ ᅵ ᄌ ᅦ ᆫ
힘들다	ᄒ ᅵ ᆷ ᄃ ᅳ ᆯ ᄃ ᅡ
마음	ᄆ ᅡ ᄋ ᅳ ᆷ
한구석이	ᄒ ᅡ ᆫ ᄀ ᅮ ᄉ ᅥ ᄀ ᅵ
쓰라리고	ᄊ ᅳ ᄅ ᅡ ᄅ ᅵ ᄀ ᅩ
없이	ᄋ ᅥ ᆸ ᄊ ᅵ
끊지	ᄁ ᅳ ᆫ ᄎ ᅵ
인간관계	ᄋ ᅵ ᆫ ᄀ ᅡ ᆫ ᄀ ᅪ ᆫ ᄀ ᅨ
때문에	ᄄ ᅢ ᄆ ᅮ ᄂ ᅦ
진이	ᄌ ᅵ ᄂ ᅵ
혼자서	ᄒ ᅩ ᆫ ᄌ ᅡ ᄉ ᅥ
외로운	ᄋ ᅬ ᄅ ᅩ ᄋ ᅮ ᆫ
참을	ᄎ ᅡ ᄆ ᅳ ᆯ
있지만	ᄋ ᅵ ᆮ ᄍ ᅵ ᄆ ᅡ ᆫ
둘인데도	ᄃ ᅮ ᄅ ᅵ ᆫ ᄃ ᅦ ᄃ ᅩ
두	ᄃ ᅮ
사람	ᄉ ᅡ ᄅ ᅡ ᆷ
모두에게	ᄆ ᅩ ᄃ ᅮ ᄋ ᅦ ᄀ ᅦ
불행이야	ᄇ ᅮ ᆯ ᄒ ᅢ ᆼ ᄋ ᅵ ᄋ ᅣ
그동안	ᄀ ᅳ ᄃ ᅩ ᆼ ᄋ ᅡ ᆫ
미안했다	ᄆ ᅵ ᄋ ᅡ ᆫ ᄒ ᅢ ᆮ ᄄ ᅡ
놓아줄게	ᄂ ᅩ ᄋ ᅡ ᄌ ᅮ ᆯ ᄀ ᅦ
넘게	ᄂ ᅥ ᆷ ᄁ ᅦ
동고동락했던	ᄃ ᅩ ᆼ ᄀ ᅩ ᄃ ᅩ ᆼ ᄂ ᅡ ᄏ ᅢ ᆮ ᄄ ᅥ ᆫ
고양이가	ᄀ ᅩ ᄋ ᅣ ᆼ ᄋ ᅵ ᄀ ᅡ
집을	ᄌ ᅵ ᄇ ᅳ ᆯ
나가버렸어	ᄂ ᅡ ᄀ ᅡ ᄇ ᅥ ᄅ ᅧ ᄊ ᅥ
때부터	ᄄ ᅢ ᄇ ᅮ ᄐ ᅥ
자란	ᄌ ᅡ ᄅ ᅡ ᆫ
강아지가	ᄀ ᅡ ᆼ ᄋ ᅡ ᄌ ᅵ ᄀ ᅡ
아주	ᄋ ᅡ ᄌ ᅮ
아파	ᄋ ᅡ ᄑ ᅡ
병문안을	ᄇ ᅧ ᆼ ᄆ ᅮ ᄂ ᅡ ᄂ ᅳ ᆯ
갔었는데	ᄀ ᅡ ᄊ ᅥ ᆫ ᄂ ᅳ ᆫ ᄃ ᅦ
마음의	ᄆ ᅡ ᄋ ᅳ ᄆ ᅴ
준비를	ᄌ ᅮ ᆫ ᄇ ᅵ ᄅ ᅳ ᆯ
우시는	ᄋ ᅮ ᄉ ᅵ ᄂ ᅳ ᆫ
봤어	ᄇ ᅪ ᄊ ᅥ
할머니	ᄒ ᅡ ᆯ ᄆ ᅥ ᄂ ᅵ
수술이	ᄉ ᅮ ᄉ ᅮ ᄅ ᅵ
됐나	ᄃ ᅫ ᆫ ᄂ ᅡ
고인이	ᄀ ᅩ ᄋ ᅵ ᄂ ᅵ
곳에	ᄀ ᅩ ᄉ ᅦ
가시기를	ᄀ ᅡ ᄉ ᅵ ᄀ ᅵ ᄅ ᅳ ᆯ
기도하겠습니다	ᄀ ᅵ ᄃ ᅩ ᄒ ᅡ ᄀ ᅦ ᆮ ᄊ ᅳ ᆷ ᄂ ᅵ ᄃ ᅡ
추스르시고	ᄎ ᅮ ᄉ ᅳ ᄅ ᅳ ᄉ ᅵ ᄀ ᅩ
어서	ᄋ ᅥ ᄉ ᅥ
빨리	ᄈ ᅡ ᆯ ᄅ ᅵ
돌아오세요	ᄃ ᅩ ᄅ ᅡ ᄋ ᅩ ᄉ ᅦ ᄋ ᅭ
억울하게	ᄋ ᅥ ᄀ ᅮ ᆯ ᄒ ᅡ ᄀ ᅦ
희생당한	ᄒ ᅵ ᄉ ᅢ ᆼ ᄃ ᅡ ᆼ ᄒ ᅡ ᆫ
그분들을	ᄀ ᅳ ᄇ ᅮ ᆫ ᄃ ᅳ ᄅ ᅳ ᆯ
앞을	ᄋ ᅡ ᄑ ᅳ ᆯ
가린다	ᄀ ᅡ ᄅ ᅵ ᆫ ᄃ ᅡ
멈추지	ᄆ ᅥ ᆷ ᄎ ᅮ ᄌ ᅵ
눈물	ᄂ ᅮ ᆫ ᄆ ᅮ ᆯ
온	ᄋ ᅩ ᆫ
세상이	ᄉ ᅦ ᄉ ᅡ ᆼ ᄋ ᅵ
뿌옇게	ᄈ ᅮ ᄋ ᅧ ᄏ ᅦ
언제부터인가	ᄋ ᅥ ᆫ ᄌ ᅦ ᄇ ᅮ ᄐ ᅥ ᄋ ᅵ ᆫ ᄀ ᅡ
우울증이	ᄋ ᅮ ᄋ ᅮ ᆯ ᄌ ᅳ ᆼ ᄋ ᅵ
집어삼키는	ᄌ ᅵ ᄇ ᅥ ᄉ ᅡ ᆷ ᄏ ᅵ ᄂ ᅳ ᆫ
아직도	ᄋ ᅡ ᄌ ᅵ ᆨ ᄄ ᅩ
부모님께	ᄇ ᅮ ᄆ ᅩ ᄂ ᅵ ᆷ ᄁ ᅦ
용돈을	ᄋ ᅭ ᆼ ᄃ ᅩ ᄂ ᅳ ᆯ
받는다고	ᄇ ᅡ ᆫ ᄂ ᅳ ᆫ ᄃ ᅡ ᄀ ᅩ
사람들이	ᄉ ᅡ ᄅ ᅡ ᆷ ᄃ ᅳ ᄅ ᅵ
한심하게	ᄒ ᅡ ᆫ ᄉ ᅵ ᆷ ᄒ ᅡ ᄀ ᅦ
볼까	ᄇ ᅩ ᆯ ᄁ ᅡ
아픈	ᄋ ᅡ ᄑ ᅳ ᆫ
때문인	ᄄ ᅢ ᄆ ᅮ ᄂ ᅵ ᆫ
같아서	ᄀ ᅡ ᄐ ᅡ ᄉ ᅥ
미안해	ᄆ ᅵ ᄋ ᅡ ᆫ ᄒ ᅢ
탓이야	ᄐ ᅡ ᄉ ᅵ ᄋ ᅣ
네	ᄂ ᅦ
풀	ᄑ ᅮ ᆯ
죽은	ᄌ ᅮ ᄀ ᅳ ᆫ
모습	ᄆ ᅩ ᄉ ᅳ ᆸ
보겠다	ᄇ ᅩ ᄀ ᅦ ᆮ ᄄ ᅡ
우연히	ᄋ ᅮ ᄋ ᅧ ᆫ ᄒ ᅵ
첫사랑이었던	ᄎ ᅥ ᆮ ᄊ ᅡ ᄅ ᅡ ᆼ ᄋ ᅵ ᄋ ᅥ ᆮ ᄄ ᅥ ᆫ
그녀를	ᄀ ᅳ ᄂ ᅧ ᄅ ᅳ ᆯ
길에서	ᄀ ᅵ ᄅ ᅦ ᄉ ᅥ
산산이	ᄉ ᅡ ᆫ ᄉ ᅡ ᄂ ᅵ
조각나는	ᄌ ᅩ ᄀ ᅡ ᆼ ᄂ ᅡ ᄂ ᅳ ᆫ
보내는	ᄇ ᅩ ᄂ ᅢ ᄂ ᅳ ᆫ
아니었는데	ᄋ ᅡ ᄂ ᅵ ᄋ ᅥ ᆫ ᄂ ᅳ ᆫ ᄃ ᅦ
미어지는구나	ᄆ ᅵ ᄋ ᅥ ᄌ ᅵ ᄂ ᅳ ᆫ ᄀ ᅮ ᄂ ᅡ
변호인으로서	ᄇ ᅧ ᆫ ᄒ ᅩ ᄋ ᅵ ᄂ ᅳ ᄅ ᅩ ᄉ ᅥ
참담한	ᄎ ᅡ ᆷ ᄃ ᅡ ᆷ ᄒ ᅡ ᆫ
심정을	ᄉ ᅵ ᆷ ᄌ ᅥ ᆼ ᄋ ᅳ ᆯ
이루	ᄋ ᅵ ᄅ ᅮ
화재로	ᄒ ᅪ ᄌ ᅢ ᄅ ᅩ
가족을	ᄀ ᅡ ᄌ ᅩ ᄀ ᅳ ᆯ
잃은	ᄋ ᅵ ᄅ ᅳ ᆫ
피해자들을	ᄑ ᅵ ᄒ ᅢ ᄌ ᅡ ᄃ ᅳ ᄅ ᅳ ᆯ
참으로	ᄎ ᅡ ᄆ ᅳ ᄅ ᅩ
비통한	ᄇ ᅵ ᄐ ᅩ ᆼ ᄒ ᅡ ᆫ
마음뿐입니다	ᄆ ᅡ ᄋ ᅳ ᆷ ᄈ ᅮ ᄂ ᅵ ᆷ ᄂ ᅵ ᄃ ᅡ
준비도	ᄌ ᅮ ᆫ ᄇ ᅵ ᄃ ᅩ
사람을	ᄉ ᅡ ᄅ ᅡ ᄆ ᅳ ᆯ
보내고	ᄇ ᅩ ᄂ ᅢ ᄀ ᅩ
상실감이	ᄉ ᅡ ᆼ ᄉ ᅵ ᆯ ᄀ ᅡ ᄆ ᅵ
담임	ᄃ ᅡ ᄆ ᅵ ᆷ
선생님께서	ᄉ ᅥ ᆫ ᄉ ᅢ ᆼ ᄂ ᅵ ᆷ ᄁ ᅦ ᄉ ᅥ
편찮으시다고	ᄑ ᅧ ᆫ ᄎ ᅡ ᄂ ᅳ ᄉ ᅵ ᄃ ᅡ ᄀ ᅩ
들었습니다	ᄃ ᅳ ᄅ ᅥ ᆮ ᄊ ᅳ ᆷ ᄂ ᅵ ᄃ ᅡ
집안에	ᄌ ᅵ ᄇ ᅡ ᄂ ᅦ
우환이	ᄋ ᅮ ᄒ ᅪ ᄂ ᅵ
끊이지를	ᄁ ᅳ ᄂ ᅵ ᄌ ᅵ ᄅ ᅳ ᆯ
않아요	ᄋ ᅡ ᄂ ᅡ ᄋ ᅭ
머리가	ᄆ ᅥ ᄅ ᅵ ᄀ ᅡ
멍해졌어	ᄆ ᅥ ᆼ ᄒ ᅢ ᄌ ᅥ ᄊ ᅥ
동창회에서	ᄃ ᅩ ᆼ ᄎ ᅡ ᆼ ᄒ ᅬ ᄋ ᅦ ᄉ ᅥ
만난	ᄆ ᅡ ᆫ ᄂ ᅡ ᆫ
친구들을	ᄎ ᅵ ᆫ ᄀ ᅮ ᄃ ᅳ ᄅ ᅳ ᆯ
초라하고	ᄎ ᅩ ᄅ ᅡ ᄒ ᅡ ᄀ ᅩ
보잘것없었어	ᄇ ᅩ ᄌ ᅡ ᆯ ᄀ ᅥ ᄉ ᅥ ᆸ ᄊ ᅥ ᄊ ᅥ
한창	ᄒ ᅡ ᆫ ᄎ ᅡ ᆼ
나이에	ᄂ ᅡ ᄋ ᅵ ᄋ ᅦ
회사를	ᄒ ᅬ ᄉ ᅡ ᄅ ᅳ ᆯ
떠나는	ᄄ ᅥ ᄂ ᅡ ᄂ ᅳ ᆫ
선배를	ᄉ ᅥ ᆫ ᄇ ᅢ ᄅ ᅳ ᆯ
보면서	ᄇ ᅩ ᄆ ᅧ ᆫ ᄉ ᅥ
안쓰러웠어	ᄋ ᅡ ᆫ ᄊ ᅳ ᄅ ᅥ ᄋ ᅯ ᄊ ᅥ
사랑하지만	ᄉ ᅡ ᄅ ᅡ ᆼ ᄒ ᅡ ᄌ ᅵ ᄆ ᅡ ᆫ
보내줘야	ᄇ ᅩ ᄂ ᅢ ᄌ ᅯ ᄋ ᅣ
그녀	ᄀ ᅳ ᄂ ᅧ
나려는	ᄂ ᅡ ᄅ ᅧ ᄂ ᅳ ᆫ
몇	ᄆ ᅧ ᆮ
번이고	ᄇ ᅥ ᄂ ᅵ ᄀ ᅩ
참았어	ᄎ ᅡ ᄆ ᅡ ᄊ ᅥ
생활고로	ᄉ ᅢ ᆼ ᄒ ᅪ ᆯ ᄀ ᅩ ᄅ ᅩ
범죄자가	ᄇ ᅥ ᆷ ᄌ ᅬ ᄌ ᅡ ᄀ ᅡ
될	ᄃ ᅬ ᆯ
수밖에	ᄉ ᅮ ᄇ ᅡ ᄁ ᅦ
없었던	ᄋ ᅥ ᆸ ᄊ ᅥ ᆮ ᄄ ᅥ ᆫ
피의자를	ᄑ ᅵ ᄋ ᅴ ᄌ ᅡ ᄅ ᅳ ᆯ
측은해지더라	ᄎ ᅳ ᄀ ᅳ ᆫ ᄒ ᅢ ᄌ ᅵ ᄃ ᅥ ᄅ ᅡ
실험	ᄉ ᅵ ᆯ ᄒ ᅥ ᆷ
대상이	ᄃ ᅢ ᄉ ᅡ ᆼ ᄋ ᅵ
연구소에	ᄋ ᅧ ᆫ ᄀ ᅮ ᄉ ᅩ ᄋ ᅦ
갇혀	ᄀ ᅡ ᄐ ᅧ
동물들이	ᄃ ᅩ ᆼ ᄆ ᅮ ᆯ ᄃ ᅳ ᄅ ᅵ
불쌍해	ᄇ ᅮ ᆯ ᄊ ᅡ ᆼ ᄒ ᅢ
굶주림에	ᄀ ᅮ ᆷ ᄌ ᅮ ᄅ ᅵ ᄆ ᅦ
시달리는	ᄉ ᅵ ᄃ ᅡ ᆯ ᄅ ᅵ ᄂ ᅳ ᆫ
아프리카	ᄋ ᅡ ᄑ ᅳ ᄅ ᅵ ᄏ ᅡ
어린이들의	ᄋ ᅥ ᄅ ᅵ ᄂ ᅵ ᄃ ᅳ ᄅ ᅴ
처참했어	ᄎ ᅥ ᄎ ᅡ ᆷ ᄒ ᅢ ᄊ ᅥ
사고	ᄉ ᅡ ᄀ ᅩ
이후	ᄋ ᅵ ᄒ ᅮ
지금까지도	ᄌ ᅵ ᄀ ᅳ ᆷ ᄁ ᅡ ᄌ ᅵ ᄃ ᅩ
가족들	ᄀ ᅡ ᄌ ᅩ ᆨ ᄄ ᅳ ᆯ
슬픔에	ᄉ ᅳ ᆯ ᄑ ᅳ ᄆ ᅦ
잠겨	ᄌ ᅡ ᆷ ᄀ ᅧ
자식을	ᄌ ᅡ ᄉ ᅵ ᄀ ᅳ ᆯ
잃고	ᄋ ᅵ ᆯ ᄏ ᅩ
비탄에	ᄇ ᅵ ᄐ ᅡ ᄂ ᅦ
젖은	ᄌ ᅥ ᄌ ᅳ ᆫ
친구에게	ᄎ ᅵ ᆫ ᄀ ᅮ ᄋ ᅦ ᄀ ᅦ
어떤	ᄋ ᅥ ᄄ ᅥ ᆫ
위로를	ᄋ ᅱ ᄅ ᅩ ᄅ ᅳ ᆯ
해줘야	ᄒ ᅢ ᄌ ᅯ ᄋ ᅣ
할까	ᄒ ᅡ ᆯ ᄁ ᅡ
아이를	ᄋ ᅡ ᄋ ᅵ ᄅ ᅳ ᆯ
키우는	ᄏ ᅵ ᄋ ᅮ ᄂ ᅳ ᆫ
어찌나	ᄋ ᅥ ᄍ ᅵ ᄂ ᅡ
힘겨워	ᄒ ᅵ ᆷ ᄀ ᅧ ᄋ ᅯ
보이던지	ᄇ ᅩ ᄋ ᅵ ᄃ ᅥ ᆫ ᄌ ᅵ
생각을	ᄉ ᅢ ᆼ ᄀ ᅡ ᄀ ᅳ ᆯ
하니	ᄒ ᅡ ᄂ ᅵ
암담하다	ᄋ ᅡ ᆷ ᄃ ᅡ ᆷ ᄒ ᅡ ᄃ ᅡ
버림받은	ᄇ ᅥ ᄅ ᅵ ᆷ ᄇ ᅡ ᄃ ᅳ ᆫ
줄도	ᄌ ᅮ ᆯ ᄃ ᅩ
모르고	ᄆ ᅩ ᄅ ᅳ ᄀ ᅩ
주인을	ᄌ ᅮ ᄋ ᅵ ᄂ ᅳ ᆯ
강아지의	ᄀ ᅡ ᆼ ᄋ ᅡ ᄌ ᅵ ᄋ ᅴ
가엾더라	ᄀ ᅡ ᄋ ᅧ ᆸ ᄄ ᅥ ᄅ ᅡ
늙어가시는	ᄂ ᅳ ᆯ ᄀ ᅥ ᄀ ᅡ ᄉ ᅵ ᄂ ᅳ ᆫ
때마다	ᄄ ᅢ ᄆ ᅡ ᄃ ᅡ
서글퍼져	ᄉ ᅥ ᄀ ᅳ ᆯ ᄑ ᅥ ᄌ ᅥ
동생	ᄃ ᅩ ᆼ ᄉ ᅢ ᆼ
결혼식에서	ᄀ ᅧ ᆯ ᄒ ᅩ ᆫ ᄉ ᅵ ᄀ ᅦ ᄉ ᅥ
취급하던	ᄎ ᅱ ᄀ ᅳ ᄑ ᅡ ᄃ ᅥ ᆫ
서운했어	ᄉ ᅥ ᄋ ᅮ ᆫ ᄒ ᅢ ᄊ ᅥ
쌓아	ᄊ ᅡ ᄋ ᅡ
올린	ᄋ ᅩ ᆯ ᄅ ᅵ ᆫ
커리어보다	ᄏ ᅥ ᄅ ᅵ ᄋ ᅥ ᄇ ᅩ ᄃ ᅡ
결혼	ᄀ ᅧ ᆯ ᄒ ᅩ ᆫ
여부가	ᄋ ᅧ ᄇ ᅮ ᄀ ᅡ
인생의	ᄋ ᅵ ᆫ ᄉ ᅢ ᆼ ᄋ ᅴ
성공	ᄉ ᅥ ᆼ ᄀ ᅩ ᆼ
잣대라니	ᄌ ᅡ ᆮ ᄄ ᅢ ᄅ ᅡ ᄂ ᅵ
허탈하다	ᄒ ᅥ ᄐ ᅡ ᆯ ᄒ ᅡ ᄃ ᅡ
믿고	ᄆ ᅵ ᆮ ᄁ ᅩ
야근도	ᄋ ᅣ ᄀ ᅳ ᆫ ᄃ ᅩ
마다하지	ᄆ ᅡ ᄃ ᅡ ᄒ ᅡ ᄌ ᅵ
않던	ᄋ ᅡ ᆫ ᄐ ᅥ ᆫ
팀원들에게	ᄐ ᅵ ᄆ ᅯ ᆫ ᄃ ᅳ ᄅ ᅦ ᄀ ᅦ
면목이	ᄆ ᅧ ᆫ ᄆ ᅩ ᄀ ᅵ
없다	ᄋ ᅥ ᆸ ᄄ ᅡ
그냥	ᄀ ᅳ ᄂ ᅣ ᆼ
넘긴다면	ᄂ ᅥ ᆷ ᄀ ᅵ ᆫ ᄃ ᅡ ᄆ ᅧ ᆫ
자책하게	ᄌ ᅡ ᄎ ᅢ ᄏ ᅡ ᄀ ᅦ
좌절하고	ᄌ ᅪ ᄌ ᅥ ᆯ ᄒ ᅡ ᄀ ᅩ
않지만	ᄋ ᅡ ᆫ ᄎ ᅵ ᄆ ᅡ ᆫ
일어설	ᄋ ᅵ ᄅ ᅥ ᄉ ᅥ ᆯ
없어	ᄋ ᅥ ᆸ ᄊ ᅥ
유기견	ᄋ ᅲ ᄀ ᅵ ᄀ ᅧ ᆫ
센터에서	ᄉ ᅦ ᆫ ᄐ ᅥ ᄋ ᅦ ᄉ ᅥ
강아지들의	ᄀ ᅡ ᆼ ᄋ ᅡ ᄌ ᅵ ᄃ ᅳ ᄅ ᅴ
애처로웠어	ᄋ ᅢ ᄎ ᅥ ᄅ ᅩ ᄋ ᅯ ᄊ ᅥ
매년	ᄆ ᅢ ᄂ ᅧ ᆫ
이맘때가	ᄋ ᅵ ᄆ ᅡ ᆷ ᄄ ᅢ ᄀ ᅡ
되면	ᄃ ᅬ ᄆ ᅧ ᆫ
먼저	ᄆ ᅥ ᆫ ᄌ ᅥ
떠난	ᄄ ᅥ ᄂ ᅡ ᆫ
친구	ᄎ ᅵ ᆫ ᄀ ᅮ
생각에	ᄉ ᅢ ᆼ ᄀ ᅡ ᄀ ᅦ
코끝이	ᄏ ᅩ ᄁ ᅳ ᄉ ᅵ
시큰해져	ᄉ ᅵ ᄏ ᅳ ᆫ ᄒ ᅢ ᄌ ᅥ
손에서	ᄉ ᅩ ᄂ ᅦ ᄉ ᅥ
놓지	ᄂ ᅩ ᄎ ᅵ
부모님	ᄇ ᅮ ᄆ ᅩ ᄂ ᅵ ᆷ
먹먹해	ᄆ ᅥ ᆼ ᄆ ᅥ ᄏ ᅢ
우리는	ᄋ ᅮ ᄅ ᅵ ᄂ ᅳ ᆫ
그분의	ᄀ ᅳ ᄇ ᅮ ᄂ ᅴ
헌신에	ᄒ ᅥ ᆫ ᄉ ᅵ ᄂ ᅦ
감사하며	ᄀ ᅡ ᆷ ᄉ ᅡ ᄒ ᅡ ᄆ ᅧ
넋을	ᄂ ᅥ ᆨ ᄊ ᅳ ᆯ
위로하고자	ᄋ ᅱ ᄅ ᅩ ᄒ ᅡ ᄀ ᅩ ᄌ ᅡ
역사를	ᄋ ᅧ ᆨ ᄊ ᅡ ᄅ ᅳ ᆯ
잊은	ᄋ ᅵ ᄌ ᅳ ᆫ
민족에게	ᄆ ᅵ ᆫ ᄌ ᅩ ᄀ ᅦ ᄀ ᅦ
미래는	ᄆ ᅵ ᄅ ᅢ ᄂ ᅳ ᆫ
없다는	ᄋ ᅥ ᆸ ᄄ ᅡ ᄂ ᅳ ᆫ
말처럼	ᄆ ᅡ ᆯ ᄎ ᅥ ᄅ ᅥ ᆷ
지금의	ᄌ ᅵ ᄀ ᅳ ᄆ ᅴ
슬픔을	ᄉ ᅳ ᆯ ᄑ ᅳ ᄆ ᅳ ᆯ
기억합시다	ᄀ ᅵ ᄋ ᅥ ᄏ ᅡ ᆸ ᄊ ᅵ ᄃ ᅡ
눈시울이	ᄂ ᅮ ᆫ ᄉ ᅵ ᄋ ᅮ ᄅ ᅵ
붉어진	ᄇ ᅮ ᆯ ᄀ ᅥ ᄌ ᅵ ᆫ
동생은	ᄃ ᅩ ᆼ ᄉ ᅢ ᆼ ᄋ ᅳ ᆫ
어깨에	ᄋ ᅥ ᄁ ᅢ ᄋ ᅦ
기대어	ᄀ ᅵ ᄃ ᅢ ᄋ ᅥ
흐느껴	ᄒ ᅳ ᄂ ᅳ ᄁ ᅧ
울었다	ᄋ ᅮ ᄅ ᅥ ᆮ ᄄ ᅡ
숨죽여	ᄉ ᅮ ᆷ ᄌ ᅮ ᄀ ᅧ
있던	ᄋ ᅵ ᆮ ᄄ ᅥ ᆫ
남자의	ᄂ ᅡ ᆷ ᄌ ᅡ ᄋ ᅴ
어깨가	ᄋ ᅥ ᄁ ᅢ ᄀ ᅡ
들썩이는	ᄃ ᅳ ᆯ ᄊ ᅥ ᄀ ᅵ ᄂ ᅳ ᆫ
어머니는	ᄋ ᅥ ᄆ ᅥ ᄂ ᅵ ᄂ ᅳ ᆫ
할머니의	ᄒ ᅡ ᆯ ᄆ ᅥ ᄂ ᅵ ᄋ ᅴ
영정	ᄋ ᅧ ᆼ ᄌ ᅥ ᆼ
대성통곡을	ᄃ ᅢ ᄉ ᅥ ᆼ ᄐ ᅩ ᆼ ᄀ ᅩ ᄀ ᅳ ᆯ
하셨어	ᄒ ᅡ ᄉ ᅧ ᄊ ᅥ
음악을	ᄋ ᅳ ᄆ ᅡ ᄀ ᅳ ᆯ
들을	ᄃ ᅳ ᄅ ᅳ ᆯ
때면	ᄄ ᅢ ᄆ ᅧ ᆫ
체한	ᄎ ᅦ ᄒ ᅡ ᆫ
것처럼	ᄀ ᅥ ᆮ ᄎ ᅥ ᄅ ᅥ ᆷ
명치끝이	ᄆ ᅧ ᆼ ᄎ ᅵ ᄁ ᅳ ᄉ ᅵ
아려와	ᄋ ᅡ ᄅ ᅧ ᄋ ᅪ
점점	ᄌ ᅥ ᆷ ᄌ ᅥ ᆷ
나이	ᄂ ᅡ ᄋ ᅵ
먹으면서	ᄆ ᅥ ᄀ ᅳ ᄆ ᅧ ᆫ ᄉ ᅥ
눈물샘이	ᄂ ᅮ ᆫ ᄆ ᅮ ᆯ ᄉ ᅢ ᄆ ᅵ
마른	ᄆ ᅡ ᄅ ᅳ ᆫ
줄	ᄌ ᅮ ᆯ
알았는데	ᄋ ᅡ ᄅ ᅡ ᆫ ᄂ ᅳ ᆫ ᄃ ᅦ
아니었나	ᄋ ᅡ ᄂ ᅵ ᄋ ᅥ ᆫ ᄂ ᅡ
가수의	ᄀ ᅡ ᄉ ᅮ ᄋ ᅴ
노래를	ᄂ ᅩ ᄅ ᅢ ᄅ ᅳ ᆯ
절절하게	ᄌ ᅥ ᆯ ᄌ ᅥ ᆯ ᄒ ᅡ ᄀ ᅦ
파고들어	ᄑ ᅡ ᄀ ᅩ ᄃ ᅳ ᄅ ᅥ
가슴	ᄀ ᅡ ᄉ ᅳ ᆷ
시린	ᄉ ᅵ ᄅ ᅵ ᆫ
이별은	ᄋ ᅵ ᄇ ᅧ ᄅ ᅳ ᆫ
번으로	ᄇ ᅥ ᄂ ᅳ ᄅ ᅩ
족하다고	ᄌ ᅩ ᄏ ᅡ ᄃ ᅡ ᄀ ᅩ
생각했는데	ᄉ ᅢ ᆼ ᄀ ᅡ ᄏ ᅢ ᆫ ᄂ ᅳ ᆫ ᄃ ᅦ
아닌가	ᄋ ᅡ ᄂ ᅵ ᆫ ᄀ ᅡ
그리워	ᄀ ᅳ ᄅ ᅵ ᄋ ᅯ
아파요	ᄋ ᅡ ᄑ ᅡ ᄋ ᅭ
사람은	ᄉ ᅡ ᄅ ᅡ ᄆ ᅳ ᆫ
절	ᄌ ᅥ ᆯ
생각하지	ᄉ ᅢ ᆼ ᄀ ᅡ ᄏ ᅡ ᄌ ᅵ
않겠죠	ᄋ ᅡ ᆫ ᄏ ᅦ ᆮ ᄍ ᅭ
마지막이라는	ᄆ ᅡ ᄌ ᅵ ᄆ ᅡ ᄀ ᅵ ᄅ ᅡ ᄂ ᅳ ᆫ
말은	ᄆ ᅡ ᄅ ᅳ ᆫ
슬픈	ᄉ ᅳ ᆯ ᄑ ᅳ ᆫ
계속해서	ᄀ ᅨ ᄉ ᅩ ᄏ ᅢ ᄉ ᅥ
억지	ᄋ ᅥ ᆨ ᄍ ᅵ
주장을	ᄌ ᅮ ᄌ ᅡ ᆼ ᄋ ᅳ ᆯ
하고	ᄒ ᅡ ᄀ ᅩ
모양이지	ᄆ ᅩ ᄋ ᅣ ᆼ ᄋ ᅵ ᄌ ᅵ
코앞인데	ᄏ ᅩ ᄋ ᅡ ᄑ ᅵ ᆫ ᄃ ᅦ
공부는	ᄀ ᅩ ᆼ ᄇ ᅮ ᄂ ᅳ ᆫ
놀기만	ᄂ ᅩ ᆯ ᄀ ᅵ ᄆ ᅡ ᆫ
거니	ᄀ ᅥ ᄂ ᅵ
라디오	ᄅ ᅡ ᄃ ᅵ ᄋ ᅩ
소리	ᄉ ᅩ ᄅ ᅵ
좀	ᄌ ᅩ ᆷ
줄여달라는데	ᄌ ᅮ ᄅ ᅧ ᄃ ᅡ ᆯ ᄅ ᅡ ᄂ ᅳ ᆫ ᄃ ᅦ
그게	ᄀ ᅳ ᄀ ᅦ
어렵습니까	ᄋ ᅥ ᄅ ᅧ ᆸ ᄊ ᅳ ᆷ ᄂ ᅵ ᄁ ᅡ
결제	ᄀ ᅧ ᆯ ᄌ ᅦ
취소는	ᄎ ᅱ ᄉ ᅩ ᄂ ᅳ ᆫ
된다고	ᄃ ᅬ ᆫ ᄃ ᅡ ᄀ ᅩ
누누이	ᄂ ᅮ ᄂ ᅮ ᄋ ᅵ
말씀드렸을	ᄆ ᅡ ᆯ ᄊ ᅳ ᆷ ᄃ ᅳ ᄅ ᅧ ᄊ ᅳ ᆯ
텐데요	ᄐ ᅦ ᆫ ᄃ ᅦ ᄋ ᅭ
도대체	ᄃ ᅩ ᄃ ᅢ ᄎ ᅦ
번을	ᄇ ᅥ ᄂ ᅳ ᆯ
말씀드려야	ᄆ ᅡ ᆯ ᄊ ᅳ ᆷ ᄃ ᅳ ᄅ ᅧ ᄋ ᅣ
술을	ᄉ ᅮ ᄅ ᅳ ᆯ
끊으시겠습니까	ᄁ ᅳ ᄂ ᅳ ᄉ ᅵ ᄀ ᅦ ᆮ ᄊ ᅳ ᆷ ᄂ ᅵ ᄁ ᅡ
탈을	ᄐ ᅡ ᄅ ᅳ ᆯ
쓰고	ᄊ ᅳ ᄀ ᅩ
짓을	ᄌ ᅵ ᄉ ᅳ ᆯ
있니	ᄋ ᅵ ᆫ ᄂ ᅵ
지하철에선	ᄌ ᅵ ᄒ ᅡ ᄎ ᅥ ᄅ ᅦ ᄉ ᅥ ᆫ
큰	ᄏ ᅳ ᆫ
소리로	ᄉ ᅩ ᄅ ᅵ ᄅ ᅩ
통화하시면	ᄐ ᅩ ᆼ ᄒ ᅪ ᄒ ᅡ ᄉ ᅵ ᄆ ᅧ ᆫ
말씀드렸습니다	ᄆ ᅡ ᆯ ᄊ ᅳ ᆷ ᄃ ᅳ ᄅ ᅧ ᆮ ᄊ ᅳ ᆷ ᄂ ᅵ ᄃ ᅡ
아내가	ᄋ ᅡ ᄂ ᅢ ᄀ ᅡ
속을	ᄉ ᅩ ᄀ ᅳ ᆯ
긁는	ᄀ ᅳ ᆼ ᄂ ᅳ ᆫ
데	ᄃ ᅦ
있어야죠	ᄋ ᅵ ᄊ ᅥ ᄋ ᅣ ᄌ ᅭ
번만	ᄇ ᅥ ᆫ ᄆ ᅡ ᆫ
거짓말했다간	ᄀ ᅥ ᄌ ᅵ ᆫ ᄆ ᅡ ᆯ ᄒ ᅢ ᆮ ᄄ ᅡ ᄀ ᅡ ᆫ
그땐	ᄀ ᅳ ᄄ ᅢ ᆫ
혼날	ᄒ ᅩ ᆫ ᄂ ᅡ ᆯ
알아	ᄋ ᅡ ᄅ ᅡ
최소한	ᄎ ᅬ ᄉ ᅩ ᄒ ᅡ ᆫ
반성의	ᄇ ᅡ ᆫ ᄉ ᅥ ᆼ ᄋ ᅴ
기미는	ᄀ ᅵ ᄆ ᅵ ᄂ ᅳ ᆫ
보여야	ᄇ ᅩ ᄋ ᅧ ᄋ ᅣ
아닙니까	ᄋ ᅡ ᄂ ᅵ ᆷ ᄂ ᅵ ᄁ ᅡ
공금	ᄀ ᅩ ᆼ ᄀ ᅳ ᆷ
횡령에	ᄒ ᅬ ᆼ ᄂ ᅧ ᆼ ᄋ ᅦ
금품	ᄀ ᅳ ᆷ ᄑ ᅮ ᆷ
수수까지	ᄉ ᅮ ᄉ ᅮ ᄁ ᅡ ᄌ ᅵ
너무하네요	ᄂ ᅥ ᄆ ᅮ ᄒ ᅡ ᄂ ᅦ ᄋ ᅭ
보자	ᄇ ᅩ ᄌ ᅡ
싸우자는	ᄊ ᅡ ᄋ ᅮ ᄌ ᅡ ᄂ ᅳ ᆫ
거지	ᄀ ᅥ ᄌ ᅵ
좋으니까	ᄌ ᅩ ᄋ ᅳ ᄂ ᅵ ᄁ ᅡ
건드리지	ᄀ ᅥ ᆫ ᄃ ᅳ ᄅ ᅵ ᄌ ᅵ
마	ᄆ ᅡ
일만	ᄋ ᅵ ᆯ ᄆ ᅡ ᆫ
분통이	ᄇ ᅮ ᆫ ᄐ ᅩ ᆼ ᄋ ᅵ
터진다고요	ᄐ ᅥ ᄌ ᅵ ᆫ ᄃ ᅡ ᄀ ᅩ ᄋ ᅭ
화가	ᄒ ᅪ ᄀ ᅡ
나서	ᄂ ᅡ ᄉ ᅥ
가만히	ᄀ ᅡ ᄆ ᅡ ᆫ ᄒ ᅵ
어머니	ᄋ ᅥ ᄆ ᅥ ᄂ ᅵ
지긋지긋한	ᄌ ᅵ ᄀ ᅳ ᆮ ᄍ ᅵ ᄀ ᅳ ᄐ ᅡ ᆫ
잔소리	ᄌ ᅡ ᆫ ᄉ ᅩ ᄅ ᅵ
하세요	ᄒ ᅡ ᄉ ᅦ ᄋ ᅭ
저들의	ᄌ ᅥ ᄃ ᅳ ᄅ ᅴ
행태를	ᄒ ᅢ ᆼ ᄐ ᅢ ᄅ ᅳ ᆯ
보면	ᄇ ᅩ ᄆ ᅧ ᆫ
피가	ᄑ ᅵ ᄀ ᅡ
거꾸로	ᄀ ᅥ ᄁ ᅮ ᄅ ᅩ
솟아요	ᄉ ᅩ ᄉ ᅡ ᄋ ᅭ
배웠다는	ᄇ ᅢ ᄋ ᅯ ᆮ ᄄ ᅡ ᄂ ᅳ ᆫ
저러고	ᄌ ᅥ ᄅ ᅥ ᄀ ᅩ
한심합니다	ᄒ ᅡ ᆫ ᄉ ᅵ ᆷ ᄒ ᅡ ᆷ ᄂ ᅵ ᄃ ᅡ
미치지	ᄆ ᅵ ᄎ ᅵ ᄌ ᅵ
않고서야	ᄋ ᅡ ᆫ ᄏ ᅩ ᄉ ᅥ ᄋ ᅣ
인간이	ᄋ ᅵ ᆫ ᄀ ᅡ ᄂ ᅵ
그럴	ᄀ ᅳ ᄅ ᅥ ᆯ
겁니까	ᄀ ᅥ ᆷ ᄂ ᅵ ᄁ ᅡ
조언을	ᄌ ᅩ ᄋ ᅥ ᄂ ᅳ ᆯ
해줘도	ᄒ ᅢ ᄌ ᅯ ᄃ ᅩ
들은	ᄃ ᅳ ᄅ ᅳ ᆫ
척도	ᄎ ᅥ ᆨ ᄄ ᅩ
답답하다	ᄃ ᅡ ᆸ ᄄ ᅡ ᄑ ᅡ ᄃ ᅡ
무슨	ᄆ ᅮ ᄉ ᅳ ᆫ
생각으로	ᄉ ᅢ ᆼ ᄀ ᅡ ᄀ ᅳ ᄅ ᅩ
건지	ᄀ ᅥ ᆫ ᄌ ᅵ
한심하다	ᄒ ᅡ ᆫ ᄉ ᅵ ᆷ ᄒ ᅡ ᄃ ᅡ
한심해	ᄒ ᅡ ᆫ ᄉ ᅵ ᆷ ᄒ ᅢ
가증스러운	ᄀ ᅡ ᄌ ᅳ ᆼ ᄉ ᅳ ᄅ ᅥ ᄋ ᅮ ᆫ
미소가	ᄆ ᅵ ᄉ ᅩ ᄀ ᅡ
소름	ᄉ ᅩ ᄅ ᅳ ᆷ
끼치게	ᄁ ᅵ ᄎ ᅵ ᄀ ᅦ
싫어요	ᄉ ᅵ ᄅ ᅥ ᄋ ᅭ
말	ᄆ ᅡ ᆯ
한마디	ᄒ ᅡ ᆫ ᄆ ᅡ ᄃ ᅵ
꼴이	ᄁ ᅩ ᄅ ᅵ
우스워졌다고	ᄋ ᅮ ᄉ ᅳ ᄋ ᅯ ᄌ ᅥ ᆮ ᄄ ᅡ ᄀ ᅩ
알기나	ᄋ ᅡ ᆯ ᄀ ᅵ ᄂ ᅡ
공인이면	ᄀ ᅩ ᆼ ᄋ ᅵ ᄂ ᅵ ᄆ ᅧ ᆫ
공인답게	ᄀ ᅩ ᆼ ᄋ ᅵ ᆫ ᄃ ᅡ ᆸ ᄁ ᅦ
행동하셔야죠	ᄒ ᅢ ᆼ ᄃ ᅩ ᆼ ᄒ ᅡ ᄉ ᅧ ᄋ ᅣ ᄌ ᅭ
자기	ᄌ ᅡ ᄀ ᅵ
애를	ᄋ ᅢ ᄅ ᅳ ᆯ
때린다니	ᄄ ᅢ ᄅ ᅵ ᆫ ᄃ ᅡ ᄂ ᅵ
짐승만도	ᄌ ᅵ ᆷ ᄉ ᅳ ᆼ ᄆ ᅡ ᆫ ᄃ ᅩ
못한	ᄆ ᅩ ᄐ ᅡ ᆫ
사람들이네요	ᄉ ᅡ ᄅ ᅡ ᆷ ᄃ ᅳ ᄅ ᅵ ᄂ ᅦ ᄋ ᅭ
어쩜	ᄋ ᅥ ᄍ ᅥ ᆷ
뻔뻔한	ᄈ ᅥ ᆫ ᄈ ᅥ ᆫ ᄒ ᅡ ᆫ
태도로	ᄐ ᅢ ᄃ ᅩ ᄅ ᅩ
일관할	ᄋ ᅵ ᆯ ᄀ ᅪ ᆫ ᄒ ᅡ ᆯ
있죠	ᄋ ᅵ ᆮ ᄍ ᅭ
말해도	ᄆ ᅡ ᆯ ᄒ ᅢ ᄃ ᅩ
바뀌지	ᄇ ᅡ ᄁ ᅱ ᄌ ᅵ
않으니	ᄋ ᅡ ᄂ ᅳ ᄂ ᅵ
어떡해야	ᄋ ᅥ ᄄ ᅥ ᄏ ᅢ ᄋ ᅣ
합니까	ᄒ ᅡ ᆷ ᄂ ᅵ ᄁ ᅡ
사람에	ᄉ ᅡ ᄅ ᅡ ᄆ ᅦ
대한	ᄃ ᅢ ᄒ ᅡ ᆫ
얘기라면	ᄋ ᅤ ᄀ ᅵ ᄅ ᅡ ᄆ ᅧ ᆫ
별로	ᄇ ᅧ ᆯ ᄅ ᅩ
짜증	ᄍ ᅡ ᄌ ᅳ ᆼ
나게	ᄂ ᅡ ᄀ ᅦ
노트북이	ᄂ ᅩ ᄐ ᅳ ᄇ ᅮ ᄀ ᅵ
왜	ᄋ ᅫ
느리냐	ᄂ ᅳ ᄅ ᅵ ᄂ ᅣ
여기저기	ᄋ ᅧ ᄀ ᅵ ᄌ ᅥ ᄀ ᅵ
시비	ᄉ ᅵ ᄇ ᅵ
거는	ᄀ ᅥ ᄂ ᅳ ᆫ
놈들은	ᄂ ᅩ ᆷ ᄃ ᅳ ᄅ ᅳ ᆫ
아예	ᄋ ᅡ ᄋ ᅨ
상대하지	ᄉ ᅡ ᆼ ᄃ ᅢ ᄒ ᅡ ᄌ ᅵ
말아야	ᄆ ᅡ ᄅ ᅡ ᄋ ᅣ
해요	ᄒ ᅢ ᄋ ᅭ
동창회	ᄃ ᅩ ᆼ ᄎ ᅡ ᆼ ᄒ ᅬ
일은	ᄋ ᅵ ᄅ ᅳ ᆫ
생각할수록	ᄉ ᅢ ᆼ ᄀ ᅡ ᄏ ᅡ ᆯ ᄊ ᅮ ᄅ ᅩ ᆨ
신경질이	ᄉ ᅵ ᆫ ᄀ ᅧ ᆼ ᄌ ᅵ ᄅ ᅵ
너는	ᄂ ᅥ ᄂ ᅳ ᆫ
잘나서	ᄌ ᅡ ᆯ ᄅ ᅡ ᄉ ᅥ
멋대로야	ᄆ ᅥ ᆮ ᄄ ᅢ ᄅ ᅩ ᄋ ᅣ
한동안	ᄒ ᅡ ᆫ ᄃ ᅩ ᆼ ᄋ ᅡ ᆫ
자중하고	ᄌ ᅡ ᄌ ᅮ ᆼ ᄒ ᅡ ᄀ ᅩ
사나	ᄉ ᅡ ᄂ ᅡ
싶더니	ᄉ ᅵ ᆸ ᄄ ᅥ ᄂ ᅵ
또다시	ᄄ ᅩ ᄃ ᅡ ᄉ ᅵ
설치고	ᄉ ᅥ ᆯ ᄎ ᅵ ᄀ ᅩ
다니네	ᄃ ᅡ ᄂ ᅵ ᄂ ᅦ
남의	ᄂ ᅡ ᄆ ᅴ
영업장에서	ᄋ ᅧ ᆼ ᄋ ᅥ ᆸ ᄍ ᅡ ᆼ ᄋ ᅦ ᄉ ᅥ
뭐	ᄆ ᅯ
하시는	ᄒ ᅡ ᄉ ᅵ ᄂ ᅳ ᆫ
처리	ᄎ ᅥ ᄅ ᅵ
이딴	ᄋ ᅵ ᄄ ᅡ ᆫ
식으로	ᄉ ᅵ ᄀ ᅳ ᄅ ᅩ
거면	ᄀ ᅥ ᄆ ᅧ ᆫ
관두세요	ᄀ ᅪ ᆫ ᄃ ᅮ ᄉ ᅦ ᄋ ᅭ
방해하시면	ᄇ ᅡ ᆼ ᄒ ᅢ ᄒ ᅡ ᄉ ᅵ ᄆ ᅧ ᆫ
곤란합니다	ᄀ ᅩ ᆯ ᄅ ᅡ ᆫ ᄒ ᅡ ᆷ ᄂ ᅵ ᄃ ᅡ
이틀도	ᄋ ᅵ ᄐ ᅳ ᆯ ᄃ ᅩ
아니고	ᄋ ᅡ ᄂ ᅵ ᄀ ᅩ
상습범이네요	ᄉ ᅡ ᆼ ᄉ ᅳ ᆸ ᄈ ᅥ ᄆ ᅵ ᄂ ᅦ ᄋ ᅭ
폭언을	ᄑ ᅩ ᄀ ᅥ ᄂ ᅳ ᆯ
일삼는	ᄋ ᅵ ᆯ ᄉ ᅡ ᆷ ᄂ ᅳ ᆫ
당장	ᄃ ᅡ ᆼ ᄌ ᅡ ᆼ
잘라버려야	ᄌ ᅡ ᆯ ᄅ ᅡ ᄇ ᅥ ᄅ ᅧ ᄋ ᅣ
건물주의	ᄀ ᅥ ᆫ ᄆ ᅮ ᆯ ᄌ ᅮ ᄋ ᅴ
오만하고	ᄋ ᅩ ᄆ ᅡ ᆫ ᄒ ᅡ ᄀ ᅩ
태도에	ᄐ ᅢ ᄃ ᅩ ᄋ ᅦ
기가	ᄀ ᅵ ᄀ ᅡ
찹니다	ᄎ ᅡ ᆷ ᄂ ᅵ ᄃ ᅡ
말이	ᄆ ᅡ ᄅ ᅵ
사실이라면	ᄉ ᅡ ᄉ ᅵ ᄅ ᅵ ᄅ ᅡ ᄆ ᅧ ᆫ
가만	ᄀ ᅡ ᄆ ᅡ ᆫ
있지	ᄋ ᅵ ᆮ ᄍ ᅵ
않을	ᄋ ᅡ ᄂ ᅳ ᆯ
겁니다	ᄀ ᅥ ᆷ ᄂ ᅵ ᄃ ᅡ
정치인들을	ᄌ ᅥ ᆼ ᄎ ᅵ ᄋ ᅵ ᆫ ᄃ ᅳ ᄅ ᅳ ᆯ
다들	ᄃ ᅡ ᄃ ᅳ ᆯ
잘났다고	ᄌ ᅡ ᆯ ᄅ ᅡ ᆮ ᄄ ᅡ ᄀ ᅩ
저러고들	ᄌ ᅥ ᄅ ᅥ ᄀ ᅩ ᄃ ᅳ ᆯ
답이	ᄃ ᅡ ᄇ ᅵ
없네	ᄋ ᅥ ᆷ ᄂ ᅦ
층간	ᄎ ᅳ ᆼ ᄀ ᅡ ᆫ
소음	ᄉ ᅩ ᄋ ᅳ ᆷ
열불이	ᄋ ᅧ ᆯ ᄇ ᅮ ᄅ ᅵ
도저히	ᄃ ᅩ ᄌ ᅥ ᄒ ᅵ
더는	ᄃ ᅥ ᄂ ᅳ ᆫ
참겠어요	ᄎ ᅡ ᆷ ᄁ ᅦ ᄊ ᅥ ᄋ ᅭ
지난	ᄌ ᅵ ᄂ ᅡ ᆫ
여름	ᄋ ᅧ ᄅ ᅳ ᆷ
민박집에서	ᄆ ᅵ ᆫ ᄇ ᅡ ᆨ ᄍ ᅵ ᄇ ᅦ ᄉ ᅥ
바가지	ᄇ ᅡ ᄀ ᅡ ᄌ ᅵ
쓴	ᄊ ᅳ ᆫ
지금도	ᄌ ᅵ ᄀ ᅳ ᆷ ᄃ ᅩ
음주운전은	ᄋ ᅳ ᆷ ᄌ ᅮ ᄋ ᅮ ᆫ ᄌ ᅥ ᄂ ᅳ ᆫ
본인뿐	ᄇ ᅩ ᄂ ᅵ ᆫ ᄈ ᅮ ᆫ
타인에게까지	ᄐ ᅡ ᄋ ᅵ ᄂ ᅦ ᄀ ᅦ ᄁ ᅡ ᄌ ᅵ
피해를	ᄑ ᅵ ᄒ ᅢ ᄅ ᅳ ᆯ
주는	ᄌ ᅮ ᄂ ᅳ ᆫ
강력범죄야	ᄀ ᅡ ᆼ ᄂ ᅧ ᆨ ᄈ ᅥ ᆷ ᄌ ᅬ ᄋ ᅣ
클럽에	ᄏ ᅳ ᆯ ᄅ ᅥ ᄇ ᅦ
갔다는	ᄀ ᅡ ᆮ ᄄ ᅡ ᄂ ᅳ ᆫ
배신감을	ᄇ ᅢ ᄉ ᅵ ᆫ ᄀ ᅡ ᄆ ᅳ ᆯ
느꼈어	ᄂ ᅳ ᄁ ᅧ ᄊ ᅥ
옷	ᄋ ᅩ ᆮ
가게에	ᄀ ᅡ ᄀ ᅦ ᄋ ᅦ
갔는데	ᄀ ᅡ ᆫ ᄂ ᅳ ᆫ ᄃ ᅦ
육육	ᄋ ᅲ ᄀ ᅲ ᆨ
이상은	ᄋ ᅵ ᄉ ᅡ ᆼ ᄋ ᅳ ᆫ
없다고	ᄋ ᅥ ᆸ ᄄ ᅡ ᄀ ᅩ
해서	ᄒ ᅢ ᄉ ᅥ
상했어	ᄉ ᅡ ᆼ ᄒ ᅢ ᄊ ᅥ
외모지상주의에	ᄋ ᅬ ᄆ ᅩ ᄌ ᅵ ᄉ ᅡ ᆼ ᄌ ᅮ ᄋ ᅴ ᄋ ᅦ
빠진	ᄈ ᅡ ᄌ ᅵ ᆫ
현대사회의	ᄒ ᅧ ᆫ ᄃ ᅢ ᄉ ᅡ ᄒ ᅬ ᄋ ᅴ
병폐를	ᄇ ᅧ ᆼ ᄑ ᅨ ᄅ ᅳ ᆯ
강력히	ᄀ ᅡ ᆼ ᄂ ᅧ ᄏ ᅵ
규탄한다	ᄀ ᅲ ᄐ ᅡ ᆫ ᄒ ᅡ ᆫ ᄃ ᅡ
쓰레기	ᄊ ᅳ ᄅ ᅦ ᄀ ᅵ
분리	ᄇ ᅮ ᆯ ᄅ ᅵ
수거를	ᄉ ᅮ ᄀ ᅥ ᄅ ᅳ ᆯ
하지	ᄒ ᅡ ᄌ ᅵ
않는	ᄋ ᅡ ᆫ ᄂ ᅳ ᆫ
이웃들	ᄋ ᅵ ᄋ ᅮ ᆮ ᄄ ᅳ ᆯ
아동학대	ᄋ ᅡ ᄃ ᅩ ᆼ ᄒ ᅡ ᆨ ᄄ ᅢ
뉴스를	ᄂ ᅲ ᄉ ᅳ ᄅ ᅳ ᆯ
분노가	ᄇ ᅮ ᆫ ᄂ ᅩ ᄀ ᅡ
끓어오른다니까	ᄁ ᅳ ᄅ ᅥ ᄋ ᅩ ᄅ ᅳ ᆫ ᄃ ᅡ ᄂ ᅵ ᄁ ᅡ
기념일을	ᄀ ᅵ ᄂ ᅧ ᄆ ᅵ ᄅ ᅳ ᆯ
잊어버린	ᄋ ᅵ ᄌ ᅥ ᄇ ᅥ ᄅ ᅵ ᆫ
남자친구의	ᄂ ᅡ ᆷ ᄌ ᅡ ᄎ ᅵ ᆫ ᄀ ᅮ ᄋ ᅴ
괘씸죄를	ᄀ ᅫ ᄊ ᅵ ᆷ ᄌ ᅬ ᄅ ᅳ ᆯ
뉴스에서	ᄂ ᅲ ᄉ ᅳ ᄋ ᅦ ᄉ ᅥ
센터에	ᄉ ᅦ ᆫ ᄐ ᅥ ᄋ ᅦ
버려진	ᄇ ᅥ ᄅ ᅧ ᄌ ᅵ ᆫ
개들을	ᄀ ᅢ ᄃ ᅳ ᄅ ᅳ ᆯ
봤는데	ᄇ ᅪ ᆫ ᄂ ᅳ ᆫ ᄃ ᅦ
보기	ᄇ ᅩ ᄀ ᅵ
불편하더라	ᄇ ᅮ ᆯ ᄑ ᅧ ᆫ ᄒ ᅡ ᄃ ᅥ ᄅ ᅡ
공원에	ᄀ ᅩ ᆼ ᄋ ᅯ ᄂ ᅦ
목줄도	ᄆ ᅩ ᆨ ᄍ ᅮ ᆯ ᄃ ᅩ
않은	ᄋ ᅡ ᄂ ᅳ ᆫ
개들이	ᄀ ᅢ ᄃ ᅳ ᄅ ᅵ
돌아다니는	ᄃ ᅩ ᄅ ᅡ ᄃ ᅡ ᄂ ᅵ ᄂ ᅳ ᆫ
불쾌해	ᄇ ᅮ ᆯ ᄏ ᅫ ᄒ ᅢ
편의점에서	ᄑ ᅧ ᄂ ᅴ ᄌ ᅥ ᄆ ᅦ ᄉ ᅥ
교대	ᄀ ᅭ ᄃ ᅢ
시간마다	ᄉ ᅵ ᄀ ᅡ ᆫ ᄆ ᅡ ᄃ ᅡ
늦는	ᄂ ᅳ ᆫ ᄂ ᅳ ᆫ
동료에게	ᄃ ᅩ ᆼ ᄂ ᅭ ᄋ ᅦ ᄀ ᅦ
따끔하게	ᄄ ᅡ ᄁ ᅳ ᆷ ᄒ ᅡ ᄀ ᅦ
했어	ᄒ ᅢ ᄊ ᅥ
블로그에	ᄇ ᅳ ᆯ ᄅ ᅩ ᄀ ᅳ ᄋ ᅦ
나온	ᄂ ᅡ ᄋ ᅩ ᆫ
식당에	ᄉ ᅵ ᆨ ᄄ ᅡ ᆼ ᄋ ᅦ
갔다가	ᄀ ᅡ ᆮ ᄄ ᅡ ᄀ ᅡ
터무니없는	ᄐ ᅥ ᄆ ᅮ ᄂ ᅵ ᄋ ᅥ ᆷ ᄂ ᅳ ᆫ
비싼	ᄇ ᅵ ᄊ ᅡ ᆫ
가격을	ᄀ ᅡ ᄀ ᅧ ᄀ ᅳ ᆯ
어처구니가	ᄋ ᅥ ᄎ ᅥ ᄀ ᅮ ᄂ ᅵ ᄀ ᅡ
없었어	ᄋ ᅥ ᆸ ᄊ ᅥ ᄊ ᅥ
퇴근	ᄐ ᅬ ᄀ ᅳ ᆫ
후에도	ᄒ ᅮ ᄋ ᅦ ᄃ ᅩ
카톡으로	ᄏ ᅡ ᄐ ᅩ ᄀ ᅳ ᄅ ᅩ
업무지시를	ᄋ ᅥ ᆷ ᄆ ᅮ ᄌ ᅵ ᄉ ᅵ ᄅ ᅳ ᆯ
부장님	ᄇ ᅮ ᄌ ᅡ ᆼ ᄂ ᅵ ᆷ
폭발	ᄑ ᅩ ᆨ ᄈ ᅡ ᆯ
직전이야	ᄌ ᅵ ᆨ ᄍ ᅥ ᄂ ᅵ ᄋ ᅣ
소리를	ᄉ ᅩ ᄅ ᅵ ᄅ ᅳ ᆯ
얼마	ᄋ ᅥ ᆯ ᄆ ᅡ
전	ᄌ ᅥ ᆫ
소개팅에서	ᄉ ᅩ ᄀ ᅢ ᄐ ᅵ ᆼ ᄋ ᅦ ᄉ ᅥ
남자에게	ᄂ ᅡ ᆷ ᄌ ᅡ ᄋ ᅦ ᄀ ᅦ
거절	ᄀ ᅥ ᄌ ᅥ ᆯ
의사를	ᄋ ᅴ ᄉ ᅡ ᄅ ᅳ ᆯ
밝혔는데도	ᄇ ᅡ ᆯ ᄏ ᅧ ᆫ ᄂ ᅳ ᆫ ᄃ ᅦ ᄃ ᅩ
귀찮아	ᄀ ᅱ ᄎ ᅡ ᄂ ᅡ
극장에서	ᄀ ᅳ ᆨ ᄍ ᅡ ᆼ ᄋ ᅦ ᄉ ᅥ
영화를	ᄋ ᅧ ᆼ ᄒ ᅪ ᄅ ᅳ ᆯ
보는데	ᄇ ᅩ ᄂ ᅳ ᆫ ᄃ ᅦ
뒷좌석에서	ᄃ ᅱ ᆮ ᄍ ᅪ ᄉ ᅥ ᄀ ᅦ ᄉ ᅥ
다리를	ᄃ ᅡ ᄅ ᅵ ᄅ ᅳ ᆯ
떠는	ᄄ ᅥ ᄂ ᅳ ᆫ
바람에	ᄇ ᅡ ᄅ ᅡ ᄆ ᅦ
집중을	ᄌ ᅵ ᆸ ᄍ ᅮ ᆼ ᄋ ᅳ ᆯ
사촌	ᄉ ᅡ ᄎ ᅩ ᆫ
결혼식에	ᄀ ᅧ ᆯ ᄒ ᅩ ᆫ ᄉ ᅵ ᄀ ᅦ
친척들의	ᄎ ᅵ ᆫ ᄎ ᅥ ᆨ ᄄ ᅳ ᄅ ᅴ
성화에	ᄉ ᅥ ᆼ ᄒ ᅪ ᄋ ᅦ
비참했어	ᄇ ᅵ ᄎ ᅡ ᆷ ᄒ ᅢ ᄊ ᅥ
불금이면	ᄇ ᅮ ᆯ ᄀ ᅳ ᄆ ᅵ ᄆ ᅧ ᆫ
뭐하냐고	ᄆ ᅯ ᄒ ᅡ ᄂ ᅣ ᄀ ᅩ
오늘도	ᄋ ᅩ ᄂ ᅳ ᆯ ᄃ ᅩ
야근이라	ᄋ ᅣ ᄀ ᅳ ᄂ ᅵ ᄅ ᅡ
언제	ᄋ ᅥ ᆫ ᄌ ᅦ
집에	ᄌ ᅵ ᄇ ᅦ
있을지도	ᄋ ᅵ ᄊ ᅳ ᆯ ᄌ ᅵ ᄃ ᅩ
모르는데	ᄆ ᅩ ᄅ ᅳ ᄂ ᅳ ᆫ ᄃ ᅦ
술만	ᄉ ᅮ ᆯ ᄆ ᅡ ᆫ
끊기는	ᄁ ᅳ ᆫ ᄏ ᅵ ᄂ ᅳ ᆫ
남자친구에게	ᄂ ᅡ ᆷ ᄌ ᅡ ᄎ ᅵ ᆫ ᄀ ᅮ ᄋ ᅦ ᄀ ᅦ
최후	ᄎ ᅬ ᄒ ᅮ
통첩했어	ᄐ ᅩ ᆼ ᄎ ᅥ ᄑ ᅢ ᄊ ᅥ
고구마	ᄀ ᅩ ᄀ ᅮ ᄆ ᅡ
전개에	ᄌ ᅥ ᆫ ᄀ ᅢ ᄋ ᅦ
답답해	ᄃ ᅡ ᆸ ᄄ ᅡ ᄑ ᅢ
죽는	ᄌ ᅮ ᆼ ᄂ ᅳ ᆫ
알았다니까	ᄋ ᅡ ᄅ ᅡ ᆮ ᄄ ᅡ ᄂ ᅵ ᄁ ᅡ
다닐	ᄃ ᅡ ᄂ ᅵ ᆯ
나보다	ᄂ ᅡ ᄇ ᅩ ᄃ ᅡ
공부도	ᄀ ᅩ ᆼ ᄇ ᅮ ᄃ ᅩ
못했던	ᄆ ᅩ ᄐ ᅢ ᆮ ᄄ ᅥ ᆫ
친구가	ᄎ ᅵ ᆫ ᄀ ᅮ ᄀ ᅡ
대기업에	ᄃ ᅢ ᄀ ᅵ ᄋ ᅥ ᄇ ᅦ
다닌다는	ᄃ ᅡ ᄂ ᅵ ᆫ ᄃ ᅡ ᄂ ᅳ ᆫ
솔직히	ᄉ ᅩ ᆯ ᄌ ᅵ ᄏ ᅵ
아팠어	ᄋ ᅡ ᄑ ᅡ ᄊ ᅥ
헤어진	ᄒ ᅦ ᄋ ᅥ ᄌ ᅵ ᆫ
연락해서	ᄋ ᅧ ᆯ ᄅ ᅡ ᄏ ᅢ ᄉ ᅥ
짜증나	ᄍ ᅡ ᄌ ᅳ ᆼ ᄂ ᅡ
아파트	ᄋ ᅡ ᄑ ᅡ ᄐ ᅳ
베란다에서	ᄇ ᅦ ᄅ ᅡ ᆫ ᄃ ᅡ ᄋ ᅦ ᄉ ᅥ
담배	ᄃ ᅡ ᆷ ᄇ ᅢ
냄새가	ᄂ ᅢ ᆷ ᄉ ᅢ ᄀ ᅡ
올라오는	ᄋ ᅩ ᆯ ᄅ ᅡ ᄋ ᅩ ᄂ ᅳ ᆫ
신경이	ᄉ ᅵ ᆫ ᄀ ᅧ ᆼ ᄋ ᅵ
날카로워	ᄂ ᅡ ᆯ ᄏ ᅡ ᄅ ᅩ ᄋ ᅯ
후에	ᄒ ᅮ ᄋ ᅦ
연락도	ᄋ ᅧ ᆯ ᄅ ᅡ ᆨ ᄄ ᅩ
없던	ᄋ ᅥ ᆸ ᄄ ᅥ ᆫ
청첩장을	ᄎ ᅥ ᆼ ᄎ ᅥ ᆸ ᄍ ᅡ ᆼ ᄋ ᅳ ᆯ
보낸	ᄇ ᅩ ᄂ ᅢ ᆫ
얄밉던지	ᄋ ᅣ ᆯ ᄆ ᅵ ᆸ ᄄ ᅥ ᆫ ᄌ ᅵ
세상에서	ᄉ ᅦ ᄉ ᅡ ᆼ ᄋ ᅦ ᄉ ᅥ
갑질하는	ᄀ ᅡ ᆸ ᄍ ᅵ ᆯ ᄒ ᅡ ᄂ ᅳ ᆫ
싫어	ᄉ ᅵ ᄅ ᅥ
기분에	ᄀ ᅵ ᄇ ᅮ ᄂ ᅦ
따라	ᄄ ᅡ ᄅ ᅡ
부하직원들을	ᄇ ᅮ ᄒ ᅡ ᄌ ᅵ ᄀ ᅯ ᆫ ᄃ ᅳ ᄅ ᅳ ᆯ
평가하는	ᄑ ᅧ ᆼ ᄀ ᅡ ᄒ ᅡ ᄂ ᅳ ᆫ
상사랑	ᄉ ᅡ ᆼ ᄉ ᅡ ᄅ ᅡ ᆼ
일하는	ᄋ ᅵ ᆯ ᄒ ᅡ ᄂ ᅳ ᆫ
고역이야	ᄀ ᅩ ᄋ ᅧ ᄀ ᅵ ᄋ ᅣ
나랑	ᄂ ᅡ ᄅ ᅡ ᆼ
헤어지고	ᄒ ᅦ ᄋ ᅥ ᄌ ᅵ ᄀ ᅩ
달도	ᄃ ᅡ ᆯ ᄃ ᅩ
돼서	ᄃ ᅫ ᄉ ᅥ
여자랑	ᄋ ᅧ ᄌ ᅡ ᄅ ᅡ ᆼ
결혼이라니	ᄀ ᅧ ᆯ ᄒ ᅩ ᄂ ᅵ ᄅ ᅡ ᄂ ᅵ
복수할	ᄇ ᅩ ᆨ ᄊ ᅮ ᄒ ᅡ ᆯ
적반하장도	ᄌ ᅥ ᆨ ᄈ ᅡ ᆫ ᄒ ᅡ ᄌ ᅡ ᆼ ᄃ ᅩ
유분수지	ᄋ ᅲ ᄇ ᅮ ᆫ ᄉ ᅮ ᄌ ᅵ
불난	ᄇ ᅮ ᆯ ᄅ ᅡ ᆫ
부채질하냐	ᄇ ᅮ ᄎ ᅢ ᄌ ᅵ ᆯ ᄒ ᅡ ᄂ ᅣ
신입사원들한테	ᄉ ᅵ ᄂ ᅵ ᆸ ᄊ ᅡ ᄋ ᅯ ᆫ ᄃ ᅳ ᆯ ᄒ ᅡ ᆫ ᄐ ᅦ
잘해줬더니	ᄌ ᅡ ᆯ ᄒ ᅢ ᄌ ᅯ ᆮ ᄄ ᅥ ᄂ ᅵ
봤는지	ᄇ ᅪ ᆫ ᄂ ᅳ ᆫ ᄌ ᅵ
기어올라서	ᄀ ᅵ ᄋ ᅥ ᄋ ᅩ ᆯ ᄅ ᅡ ᄉ ᅥ
받아	ᄇ ᅡ ᄃ ᅡ
다이어트만	ᄃ ᅡ ᄋ ᅵ ᄋ ᅥ ᄐ ᅳ ᄆ ᅡ ᆫ
시작하면	ᄉ ᅵ ᄌ ᅡ ᄏ ᅡ ᄆ ᅧ ᆫ
야식을	ᄋ ᅣ ᄉ ᅵ ᄀ ᅳ ᆯ
시켜	ᄉ ᅵ ᄏ ᅧ
먹는다니까	ᄆ ᅥ ᆼ ᄂ ᅳ ᆫ ᄃ ᅡ ᄂ ᅵ ᄁ ᅡ
왠수가	ᄋ ᅫ ᆫ ᄉ ᅮ ᄀ ᅡ
신은	ᄉ ᅵ ᄂ ᅳ ᆫ
불공평해	ᄇ ᅮ ᆯ ᄀ ᅩ ᆼ ᄑ ᅧ ᆼ ᄒ ᅢ
물만	ᄆ ᅮ ᆯ ᄆ ᅡ ᆫ
먹어도	ᄆ ᅥ ᄀ ᅥ ᄃ ᅩ
살이	ᄉ ᅡ ᄅ ᅵ
찌는	ᄍ ᅵ ᄂ ᅳ ᆫ
소개팅남	ᄉ ᅩ ᄀ ᅢ ᄐ ᅵ ᆼ ᄂ ᅡ ᆷ
트림한	ᄐ ᅳ ᄅ ᅵ ᆷ ᄒ ᅡ ᆫ
창피하고	ᄎ ᅡ ᆼ ᄑ ᅵ ᄒ ᅡ ᄀ ᅩ
신경질	ᄉ ᅵ ᆫ ᄀ ᅧ ᆼ ᄌ ᅵ ᆯ
독박	ᄃ ᅩ ᆨ ᄈ ᅡ ᆨ
육아로	ᄋ ᅲ ᄀ ᅡ ᄅ ᅩ
힘들어하는	ᄒ ᅵ ᆷ ᄃ ᅳ ᄅ ᅥ ᄒ ᅡ ᄂ ᅳ ᆫ
보니까	ᄇ ᅩ ᄂ ᅵ ᄁ ᅡ
남	ᄂ ᅡ ᆷ
같지	ᄀ ᅡ ᆮ ᄍ ᅵ
선배라고	ᄉ ᅥ ᆫ ᄇ ᅢ ᄅ ᅡ ᄀ ᅩ
무조건	ᄆ ᅮ ᄌ ᅩ ᄀ ᅥ ᆫ
후배들에게	ᄒ ᅮ ᄇ ᅢ ᄃ ᅳ ᄅ ᅦ ᄀ ᅦ
밥	ᄇ ᅡ ᆸ
사주고	ᄉ ᅡ ᄌ ᅮ ᄀ ᅩ
술	ᄉ ᅮ ᆯ
사주는	ᄉ ᅡ ᄌ ᅮ ᄂ ᅳ ᆫ
아니라고	ᄋ ᅡ ᄂ ᅵ ᄅ ᅡ ᄀ ᅩ
화장실에서	ᄒ ᅪ ᄌ ᅡ ᆼ ᄉ ᅵ ᄅ ᅦ ᄉ ᅥ
뒷말	ᄃ ᅱ ᆫ ᄆ ᅡ ᆯ
들었어	ᄃ ᅳ ᄅ ᅥ ᄊ ᅥ
잡히면	ᄌ ᅡ ᄑ ᅵ ᄆ ᅧ ᆫ
가만두지	ᄀ ᅡ ᄆ ᅡ ᆫ ᄃ ᅮ ᄌ ᅵ
애지중지	ᄋ ᅢ ᄌ ᅵ ᄌ ᅮ ᆼ ᄌ ᅵ
모아온	ᄆ ᅩ ᄋ ᅡ ᄋ ᅩ ᆫ
피겨를	ᄑ ᅵ ᄀ ᅧ ᄅ ᅳ ᆯ
엄마가	ᄋ ᅥ ᆷ ᄆ ᅡ ᄀ ᅡ
조카에게	ᄌ ᅩ ᄏ ᅡ ᄋ ᅦ ᄀ ᅦ
줘버렸어	ᄌ ᅯ ᄇ ᅥ ᄅ ᅧ ᄊ ᅥ
회식	ᄒ ᅬ ᄉ ᅵ ᆨ
자리에서	ᄌ ᅡ ᄅ ᅵ ᄋ ᅦ ᄉ ᅥ
먹는	ᄆ ᅥ ᆼ ᄂ ᅳ ᆫ
억지로	ᄋ ᅥ ᆨ ᄍ ᅵ ᄅ ᅩ
권하는	ᄀ ᅯ ᆫ ᄒ ᅡ ᄂ ᅳ ᆫ
상사들은	ᄉ ᅡ ᆼ ᄉ ᅡ ᄃ ᅳ ᄅ ᅳ ᆫ
선거철만	ᄉ ᅥ ᆫ ᄀ ᅥ ᄎ ᅥ ᆯ ᄆ ᅡ ᆫ
간이고	ᄀ ᅡ ᄂ ᅵ ᄀ ᅩ
쓸개고	ᄊ ᅳ ᆯ ᄀ ᅢ ᄀ ᅩ
내줄	ᄂ ᅢ ᄌ ᅮ ᆯ
구는	ᄀ ᅮ ᄂ ᅳ ᆫ
꼴불견이야	ᄁ ᅩ ᆯ ᄇ ᅮ ᆯ ᄀ ᅧ ᄂ ᅵ ᄋ ᅣ
운전하는	ᄋ ᅮ ᆫ ᄌ ᅥ ᆫ ᄒ ᅡ ᄂ ᅳ ᆫ
무단횡단하는	ᄆ ᅮ ᄃ ᅡ ᆫ ᄒ ᅬ ᆼ ᄃ ᅡ ᆫ ᄒ ᅡ ᄂ ᅳ ᆫ
몰상식한	ᄆ ᅩ ᆯ ᄊ ᅡ ᆼ ᄉ ᅵ ᄏ ᅡ ᆫ
사람들	ᄉ ᅡ ᄅ ᅡ ᆷ ᄃ ᅳ ᆯ
감수했다니까	ᄀ ᅡ ᆷ ᄉ ᅮ ᄒ ᅢ ᆮ ᄄ ᅡ ᄂ ᅵ ᄁ ᅡ
초보	ᄎ ᅩ ᄇ ᅩ
운전자에	ᄋ ᅮ ᆫ ᄌ ᅥ ᆫ ᄌ ᅡ ᄋ ᅦ
배려는커녕	ᄇ ᅢ ᄅ ᅧ ᄂ ᅳ ᆫ ᄏ ᅥ ᄂ ᅧ ᆼ
난폭	ᄂ ᅡ ᆫ ᄑ ᅩ ᆨ
운전자들	ᄋ ᅮ ᆫ ᄌ ᅥ ᆫ ᄌ ᅡ ᄃ ᅳ ᆯ
운전대만	ᄋ ᅮ ᆫ ᄌ ᅥ ᆫ ᄃ ᅢ ᄆ ᅡ ᆫ
잡으면	ᄌ ᅡ ᄇ ᅳ ᄆ ᅧ ᆫ
흥분돼	ᄒ ᅳ ᆼ ᄇ ᅮ ᆫ ᄃ ᅫ
정규직이	ᄌ ᅥ ᆼ ᄀ ᅲ ᄌ ᅵ ᄀ ᅵ
못된	ᄆ ᅩ ᆮ ᄄ ᅬ ᆫ
미래를	ᄆ ᅵ ᄅ ᅢ ᄅ ᅳ ᆯ
고작	ᄀ ᅩ ᄌ ᅡ ᆨ
연봉을	ᄋ ᅧ ᆫ ᄇ ᅩ ᆼ ᄋ ᅳ ᆯ
받으려고	ᄇ ᅡ ᄃ ᅳ ᄅ ᅧ ᄀ ᅩ
고생했었나	ᄀ ᅩ ᄉ ᅢ ᆼ ᄒ ᅢ ᄊ ᅥ ᆫ ᄂ ᅡ
억울하고	ᄋ ᅥ ᄀ ᅮ ᆯ ᄒ ᅡ ᄀ ᅩ
메뉴를	ᄆ ᅦ ᄂ ᅲ ᄅ ᅳ ᆯ
본인	ᄇ ᅩ ᄂ ᅵ ᆫ
마음대로	ᄆ ᅡ ᄋ ᅳ ᆷ ᄃ ᅢ ᄅ ᅩ
결정하는	ᄀ ᅧ ᆯ ᄌ ᅥ ᆼ ᄒ ᅡ ᄂ ᅳ ᆫ
상사를	ᄉ ᅡ ᆼ ᄉ ᅡ ᄅ ᅳ ᆯ
못마땅해	ᄆ ᅩ ᆫ ᄆ ᅡ ᄄ ᅡ ᆼ ᄒ ᅢ
단골집이	ᄃ ᅡ ᆫ ᄀ ᅩ ᆯ ᄌ ᅵ ᄇ ᅵ
뉴스에	ᄂ ᅲ ᄉ ᅳ ᄋ ᅦ
불결한	ᄇ ᅮ ᆯ ᄀ ᅧ ᆯ ᄒ ᅡ ᆫ
식당이었다니	ᄉ ᅵ ᆨ ᄄ ᅡ ᆼ ᄋ ᅵ ᄋ ᅥ ᆮ ᄄ ᅡ ᄂ ᅵ
해도	ᄒ ᅢ ᄃ ᅩ
끼쳐	ᄁ ᅵ ᄎ ᅥ
바쁜	ᄇ ᅡ ᄈ ᅳ ᆫ
시간에	ᄉ ᅵ ᄀ ᅡ ᄂ ᅦ
보험	ᄇ ᅩ ᄒ ᅥ ᆷ
판매	ᄑ ᅡ ᆫ ᄆ ᅢ
전화가	ᄌ ᅥ ᆫ ᄒ ᅪ ᄀ ᅡ
구내식당은	ᄀ ᅮ ᄂ ᅢ ᄉ ᅵ ᆨ ᄄ ᅡ ᆼ ᄋ ᅳ ᆫ
저렴하고	ᄌ ᅥ ᄅ ᅧ ᆷ ᄒ ᅡ ᄀ ᅩ
깨끗해서	ᄁ ᅢ ᄁ ᅳ ᄐ ᅢ ᄉ ᅥ
좋지만	ᄌ ᅩ ᄎ ᅵ ᄆ ᅡ ᆫ
메뉴가	ᄆ ᅦ ᄂ ᅲ ᄀ ᅡ
한결같아서	ᄒ ᅡ ᆫ ᄀ ᅧ ᆯ ᄀ ᅡ ᄐ ᅡ ᄉ ᅥ
지겨워	ᄌ ᅵ ᄀ ᅧ ᄋ ᅯ
시간인데도	ᄉ ᅵ ᄀ ᅡ ᄂ ᅵ ᆫ ᄃ ᅦ ᄃ ᅩ
자리만	ᄌ ᅡ ᄅ ᅵ ᄆ ᅡ ᆫ
지키고	ᄌ ᅵ ᄏ ᅵ ᄀ ᅩ
부장님이	ᄇ ᅮ ᄌ ᅡ ᆼ ᄂ ᅵ ᄆ ᅵ
야속해	ᄋ ᅣ ᄉ ᅩ ᄏ ᅢ
동생이	ᄃ ᅩ ᆼ ᄉ ᅢ ᆼ ᄋ ᅵ
구두	ᄀ ᅮ ᄃ ᅮ
신었다고	ᄉ ᅵ ᄂ ᅥ ᆮ ᄄ ᅡ ᄀ ᅩ
난리를	ᄂ ᅡ ᆯ ᄅ ᅵ ᄅ ᅳ ᆯ
치는	ᄎ ᅵ ᄂ ᅳ ᆫ
얄밉더라	ᄋ ᅣ ᆯ ᄆ ᅵ ᆸ ᄄ ᅥ ᄅ ᅡ
이건	ᄋ ᅵ ᄀ ᅥ ᆫ
명백한	ᄆ ᅧ ᆼ ᄇ ᅢ ᄏ ᅡ ᆫ
살인	ᄉ ᅡ ᄅ ᅵ ᆫ
미수인데	ᄆ ᅵ ᄉ ᅮ ᄋ ᅵ ᆫ ᄃ ᅦ
처벌이	ᄎ ᅥ ᄇ ᅥ ᄅ ᅵ
약한	ᄋ ᅣ ᄏ ᅡ ᆫ
얘기만	ᄋ ᅤ ᄀ ᅵ ᄆ ᅡ ᆫ
나오면	ᄂ ᅡ ᄋ ᅩ ᄆ ᅧ ᆫ
꽁무니를	ᄁ ᅩ ᆼ ᄆ ᅮ ᄂ ᅵ ᄅ ᅳ ᆯ
빼는	ᄈ ᅢ ᄂ ᅳ ᆫ
남자친구	ᄂ ᅡ ᆷ ᄌ ᅡ ᄎ ᅵ ᆫ ᄀ ᅮ
미치겠어	ᄆ ᅵ ᄎ ᅵ ᄀ ᅦ ᄊ ᅥ
한정판	ᄒ ᅡ ᆫ ᄌ ᅥ ᆼ ᄑ ᅡ ᆫ
가방을	ᄀ ᅡ ᄇ ᅡ ᆼ ᄋ ᅳ ᆯ
샀다고	ᄉ ᅡ ᆮ ᄄ ᅡ ᄀ ᅩ
여자친구가	ᄋ ᅧ ᄌ ᅡ ᄎ ᅵ ᆫ ᄀ ᅮ ᄀ ᅡ
헤어지자고	ᄒ ᅦ ᄋ ᅥ ᄌ ᅵ ᄌ ᅡ ᄀ ᅩ
넘어	ᄂ ᅥ ᄆ ᅥ
산이라더니	ᄉ ᅡ ᄂ ᅵ ᄅ ᅡ ᄃ ᅥ ᄂ ᅵ
대출	ᄃ ᅢ ᄎ ᅮ ᆯ
끝나고	ᄁ ᅳ ᆫ ᄂ ᅡ ᄀ ᅩ
결혼자금이	ᄀ ᅧ ᆯ ᄒ ᅩ ᆫ ᄌ ᅡ ᄀ ᅳ ᄆ ᅵ
써온	ᄊ ᅥ ᄋ ᅩ ᆫ
이력서만	ᄋ ᅵ ᄅ ᅧ ᆨ ᄊ ᅥ ᄆ ᅡ ᆫ
백장이	ᄇ ᅢ ᆨ ᄍ ᅡ ᆼ ᄋ ᅵ
넘는다구	ᄂ ᅥ ᆷ ᄂ ᅳ ᆫ ᄃ ᅡ ᄀ ᅮ
동창회에	ᄃ ᅩ ᆼ ᄎ ᅡ ᆼ ᄒ ᅬ ᄋ ᅦ
나밖에	ᄂ ᅡ ᄇ ᅡ ᄁ ᅦ
없더라구	ᄋ ᅥ ᆸ ᄄ ᅥ ᄅ ᅡ ᄀ ᅮ
젊어서	ᄌ ᅥ ᆯ ᄆ ᅥ ᄉ ᅥ
고생은	ᄀ ᅩ ᄉ ᅢ ᆼ ᄋ ᅳ ᆫ
사서도	ᄉ ᅡ ᄉ ᅥ ᄃ ᅩ
한다고	ᄒ ᅡ ᆫ ᄃ ᅡ ᄀ ᅩ
고생	ᄀ ᅩ ᄉ ᅢ ᆼ
끝이냐고	ᄁ ᅳ ᄉ ᅵ ᄂ ᅣ ᄀ ᅩ
만나서	ᄆ ᅡ ᆫ ᄂ ᅡ ᄉ ᅥ
묻고	ᄆ ᅮ ᆮ ᄁ ᅩ
형편	ᄒ ᅧ ᆼ ᄑ ᅧ ᆫ
알면서	ᄋ ᅡ ᆯ ᄆ ᅧ ᆫ ᄉ ᅥ
신혼살림을	ᄉ ᅵ ᆫ ᄒ ᅩ ᆫ ᄉ ᅡ ᆯ ᄅ ᅵ ᄆ ᅳ ᆯ
아파트에서	ᄋ ᅡ ᄑ ᅡ ᄐ ᅳ ᄋ ᅦ ᄉ ᅥ
시작해야	ᄉ ᅵ ᄌ ᅡ ᄏ ᅢ ᄋ ᅣ
고집을	ᄀ ᅩ ᄌ ᅵ ᄇ ᅳ ᆯ
피우는	ᄑ ᅵ ᄋ ᅮ ᄂ ᅳ ᆫ
호감을	ᄒ ᅩ ᄀ ᅡ ᄆ ᅳ ᆯ
느끼고	ᄂ ᅳ ᄁ ᅵ ᄀ ᅩ
만나는	ᄆ ᅡ ᆫ ᄂ ᅡ ᄂ ᅳ ᆫ
직장	ᄌ ᅵ ᆨ ᄍ ᅡ ᆼ
동료가	ᄃ ᅩ ᆼ ᄂ ᅭ ᄀ ᅡ
있는데	ᄋ ᅵ ᆫ ᄂ ᅳ ᆫ ᄃ ᅦ
진심을	ᄌ ᅵ ᆫ ᄉ ᅵ ᄆ ᅳ ᆯ
모르겠어	ᄆ ᅩ ᄅ ᅳ ᄀ ᅦ ᄊ ᅥ
겉모습만	ᄀ ᅥ ᆫ ᄆ ᅩ ᄉ ᅳ ᆷ ᄆ ᅡ ᆫ
번지르르하면	ᄇ ᅥ ᆫ ᄌ ᅵ ᄅ ᅳ ᄅ ᅳ ᄒ ᅡ ᄆ ᅧ ᆫ
공중	ᄀ ᅩ ᆼ ᄌ ᅮ ᆼ
도덕도	ᄃ ᅩ ᄃ ᅥ ᆨ ᄄ ᅩ
지키는데	ᄌ ᅵ ᄏ ᅵ ᄂ ᅳ ᆫ ᄃ ᅦ
회의에	ᄒ ᅬ ᄋ ᅴ ᄋ ᅦ
이번엔	ᄋ ᅵ ᄇ ᅥ ᄂ ᅦ ᆫ
플러쓰	ᄑ ᅳ ᆯ ᄅ ᅥ ᄊ ᅳ
족하다구	ᄌ ᅩ ᄏ ᅡ ᄃ ᅡ ᄀ ᅮ
아니구	ᄋ ᅡ ᄂ ᅵ ᄀ ᅮ
끝이냐구	ᄁ ᅳ ᄉ ᅵ ᄂ ᅣ ᄀ ᅮ
뵙지요	ᄇ ᅬ ᆸ ᄍ ᅵ ᄋ ᅭ
연락주세요	ᄋ ᅧ ᆯ ᄅ ᅡ ᆨ ᄍ ᅮ ᄉ ᅦ ᄋ ᅭ
들릴	ᄃ ᅳ ᆯ ᄅ ᅵ ᆯ
포식자라고	ᄑ ᅩ ᄉ ᅵ ᆨ ᄍ ᅡ ᄅ ᅡ ᄀ ᅩ
일곱에서	ᄋ ᅵ ᆯ ᄀ ᅩ ᄇ ᅦ ᄉ ᅥ
경치도	ᄀ ᅧ ᆼ ᄎ ᅵ ᄃ ᅩ
누굴	ᄂ ᅮ ᄀ ᅮ ᆯ
재미있게	ᄌ ᅢ ᄆ ᅵ ᄋ ᅵ ᆮ ᄁ ᅦ
찬	ᄎ ᅡ ᆫ
먹먹해져	ᄆ ᅥ ᆼ ᄆ ᅥ ᄏ ᅢ ᄌ ᅥ
나이를	ᄂ ᅡ ᄋ ᅵ ᄅ ᅳ ᆯ
그리워하는	ᄀ ᅳ ᄅ ᅵ ᄋ ᅯ ᄒ ᅡ ᄂ ᅳ ᆫ
가증스런	ᄀ ᅡ ᄌ ᅳ ᆼ ᄉ ᅳ ᄅ ᅥ ᆫ
있을지	ᄋ ᅵ ᄊ ᅳ ᆯ ᄌ ᅵ
했는데	ᄒ ᅢ ᆫ ᄂ ᅳ ᆫ ᄃ ᅦ
정치인들	ᄌ ᅥ ᆼ ᄎ ᅵ ᄋ ᅵ ᆫ ᄃ ᅳ ᆯ
넘는다고	ᄂ ᅥ ᆷ ᄂ ᅳ ᆫ ᄃ ᅡ ᄀ ᅩ
없더라고	ᄋ ᅥ ᆸ ᄄ ᅥ ᄅ ᅡ ᄀ ᅩ
손님은	ᄉ ᅩ ᆫ ᄂ ᅵ ᄆ ᅳ ᆫ
들었다구요	ᄃ ᅳ ᄅ ᅥ ᆮ ᄄ ᅡ ᄀ ᅮ ᄋ ᅭ
당첨됐다구요	ᄃ ᅡ ᆼ ᄎ ᅥ ᆷ ᄃ ᅫ ᆮ ᄄ ᅡ ᄀ ᅮ ᄋ ᅭ
아버님의	ᄋ ᅡ ᄇ ᅥ ᄂ ᅵ ᄆ ᅴ
것두	ᄀ ᅥ ᆮ ᄄ ᅮ
싶지만	ᄉ ᅵ ᆸ ᄍ ᅵ ᄆ ᅡ ᆫ
시간에서	ᄉ ᅵ ᄀ ᅡ ᄂ ᅦ ᄉ ᅥ
죽구	ᄌ ᅮ ᆨ ᄁ ᅮ
사주구	ᄉ ᅡ ᄌ ᅮ ᄀ ᅮ
니	ᄂ ᅵ
낼	ᄂ ᅢ ᆯ
아기가	ᄋ ᅡ ᄀ ᅵ ᄀ ᅡ
풀죽은	ᄑ ᅮ ᆯ ᄌ ᅮ ᄀ ᅳ ᆫ
마디	ᄆ ᅡ ᄃ ᅵ
하실	ᄒ ᅡ ᄉ ᅵ ᆯ
중에	ᄌ ᅮ ᆼ ᄋ ᅦ
울구	ᄋ ᅮ ᆯ ᄀ ᅮ
무너진	ᄆ ᅮ ᄂ ᅥ ᄌ ᅵ ᆫ
아버지	ᄋ ᅡ ᄇ ᅥ ᄌ ᅵ
알구	ᄋ ᅡ ᆯ ᄀ ᅮ
비닐봉지	ᄇ ᅵ ᄂ ᅵ ᆯ ᄇ ᅩ ᆼ ᄌ ᅵ
건강검진이	ᄀ ᅥ ᆫ ᄀ ᅡ ᆼ ᄀ ᅥ ᆷ ᄌ ᅵ ᄂ ᅵ
증명서를	ᄌ ᅳ ᆼ ᄆ ᅧ ᆼ ᄉ ᅥ ᄅ ᅳ ᆯ
주시구	ᄌ ᅮ ᄉ ᅵ ᄀ ᅮ
몰라두	ᄆ ᅩ ᆯ ᄅ ᅡ ᄃ ᅮ
쥐구멍에	ᄌ ᅱ ᄀ ᅮ ᄆ ᅥ ᆼ ᄋ ᅦ
그치구	ᄀ ᅳ ᄎ ᅵ ᄀ ᅮ
정신이	ᄌ ᅥ ᆼ ᄉ ᅵ ᄂ ᅵ
지하철에서	ᄌ ᅵ ᄒ ᅡ ᄎ ᅥ ᄅ ᅦ ᄉ ᅥ
터진다구요	ᄐ ᅥ ᄌ ᅵ ᆫ ᄃ ᅡ ᄀ ᅮ ᄋ ᅭ
설치구	ᄉ ᅥ ᆯ ᄎ ᅵ ᄀ ᅮ
헤어지구	ᄒ ᅦ ᄋ ᅥ ᄌ ᅵ ᄀ ᅮ
적반하장	ᄌ ᅥ ᆨ ᄈ ᅡ ᆫ ᄒ ᅡ ᄌ ᅡ ᆼ
같지가	ᄀ ᅡ ᆮ ᄍ ᅵ ᄀ ᅡ
신었다구	ᄉ ᅵ ᄂ ᅥ ᆮ ᄄ ᅡ ᄀ ᅮ
해두	ᄒ ᅢ ᄃ ᅮ
오월	ᄋ ᅩ ᄋ ᅯ ᆯ
십칠일	ᄉ ᅵ ᆸ ᄎ ᅵ ᄅ ᅵ ᆯ
기준	ᄀ ᅵ ᄌ ᅮ ᆫ
홍수로	ᄒ ᅩ ᆼ ᄉ ᅮ ᄅ ᅩ
최소	ᄎ ᅬ ᄉ ᅩ
이십	ᄋ ᅵ ᄉ ᅵ ᆸ
명이	ᄆ ᅧ ᆼ ᄋ ᅵ
사망했고	ᄉ ᅡ ᄆ ᅡ ᆼ ᄒ ᅢ ᆮ ᄁ ᅩ
만육천	ᄆ ᅡ ᄂ ᅲ ᆨ ᄎ ᅥ ᆫ
명	ᄆ ᅧ ᆼ
이상이	ᄋ ᅵ ᄉ ᅡ ᆼ ᄋ ᅵ
대피하였습니다	ᄃ ᅢ ᄑ ᅵ ᄒ ᅡ ᄋ ᅧ ᆮ ᄊ ᅳ ᆷ ᄂ ᅵ ᄃ ᅡ
또한	ᄄ ᅩ ᄒ ᅡ ᆫ
경찰은	ᄀ ᅧ ᆼ ᄎ ᅡ ᄅ ᅳ ᆫ
테러	ᄐ ᅦ ᄅ ᅥ
과정에서	ᄀ ᅪ ᄌ ᅥ ᆼ ᄋ ᅦ ᄉ ᅥ
두건	ᄃ ᅮ ᄀ ᅥ ᆫ
이상의	ᄋ ᅵ ᄉ ᅡ ᆼ ᄋ ᅴ
자살	ᄌ ᅡ ᄉ ᅡ ᆯ
폭탄	ᄑ ᅩ ᆨ ᄐ ᅡ ᆫ
테러가	ᄐ ᅦ ᄅ ᅥ ᄀ ᅡ
밝혔습니다	ᄇ ᅡ ᆯ ᄏ ᅧ ᆮ ᄊ ᅳ ᆷ ᄂ ᅵ ᄃ ᅡ
값이	ᄀ ᅡ ᆸ ᄊ ᅵ
실제	ᄉ ᅵ ᆯ ᄌ ᅦ
질량이라고	ᄌ ᅵ ᆯ ᄅ ᅣ ᆼ ᄋ ᅵ ᄅ ᅡ ᄀ ᅩ
가정하면	ᄀ ᅡ ᄌ ᅥ ᆼ ᄒ ᅡ ᄆ ᅧ ᆫ
토성보다도	ᄐ ᅩ ᄉ ᅥ ᆼ ᄇ ᅩ ᄃ ᅡ ᄃ ᅩ
가볍습니다	ᄀ ᅡ ᄇ ᅧ ᆸ ᄊ ᅳ ᆷ ᄂ ᅵ ᄃ ᅡ
오닉스	ᄋ ᅩ ᄂ ᅵ ᆨ ᄊ ᅳ
스톤과	ᄉ ᅳ ᄐ ᅩ ᆫ ᄀ ᅪ
호텔이	ᄒ ᅩ ᄐ ᅦ ᄅ ᅵ
혼합된	ᄒ ᅩ ᆫ ᄒ ᅡ ᆸ ᄄ ᅬ ᆫ
개념에서	ᄀ ᅢ ᄂ ᅧ ᄆ ᅦ ᄉ ᅥ
영감을	ᄋ ᅧ ᆼ ᄀ ᅡ ᄆ ᅳ ᆯ
얻어	ᄋ ᅥ ᄃ ᅥ
지었다	ᄌ ᅵ ᄋ ᅥ ᆮ ᄄ ᅡ
골드	ᄀ ᅩ ᆯ ᄃ ᅳ
바는	ᄇ ᅡ ᄂ ᅳ ᆫ
보통	ᄇ ᅩ ᄐ ᅩ ᆼ
막대	ᄆ ᅡ ᆨ ᄄ ᅢ
모양의	ᄆ ᅩ ᄋ ᅣ ᆼ ᄋ ᅴ
금괴를	ᄀ ᅳ ᆷ ᄀ ᅬ ᄅ ᅳ ᆯ
말하며	ᄆ ᅡ ᆯ ᄒ ᅡ ᄆ ᅧ
종류	ᄌ ᅩ ᆼ ᄂ ᅲ
무게	ᄆ ᅮ ᄀ ᅦ
모양	ᄆ ᅩ ᄋ ᅣ ᆼ
순도	ᄉ ᅮ ᆫ ᄃ ᅩ
등	ᄃ ᅳ ᆼ
다양하다	ᄃ ᅡ ᄋ ᅣ ᆼ ᄒ ᅡ ᄃ ᅡ
국제	ᄀ ᅮ ᆨ ᄍ ᅦ
연맹은	ᄋ ᅧ ᆫ ᄆ ᅢ ᆼ ᄋ ᅳ ᆫ
수학의	ᄉ ᅮ ᄒ ᅡ ᄀ ᅴ
발전을	ᄇ ᅡ ᆯ ᄍ ᅥ ᄂ ᅳ ᆯ
만들어진	ᄆ ᅡ ᆫ ᄃ ᅳ ᄅ ᅥ ᄌ ᅵ ᆫ
비정부	ᄇ ᅵ ᄌ ᅥ ᆼ ᄇ ᅮ
협력	ᄒ ᅧ ᆷ ᄂ ᅧ ᆨ
단체이다	ᄃ ᅡ ᆫ ᄎ ᅦ ᄋ ᅵ ᄃ ᅡ
인간	ᄋ ᅵ ᆫ ᄀ ᅡ ᆫ
연대의	ᄋ ᅧ ᆫ ᄃ ᅢ ᄋ ᅴ
날은	ᄂ ᅡ ᄅ ᅳ ᆫ
중요성을	ᄌ ᅮ ᆼ ᄋ ᅭ ᄉ ᅥ ᆼ ᄋ ᅳ ᆯ
인식하기	ᄋ ᅵ ᆫ ᄉ ᅵ ᄏ ᅡ ᄀ ᅵ
유엔에서	ᄋ ᅲ ᄋ ᅦ ᄂ ᅦ ᄉ ᅥ
제정하였습니다	ᄌ ᅦ ᄌ ᅥ ᆼ ᄒ ᅡ ᄋ ᅧ ᆮ ᄊ ᅳ ᆷ ᄂ ᅵ ᄃ ᅡ
이사금은	ᄋ ᅵ ᄉ ᅡ ᄀ ᅳ ᄆ ᅳ ᆫ
밤에	ᄇ ᅡ ᄆ ᅦ
서쪽	ᄉ ᅥ ᄍ ᅩ ᆨ
계림의	ᄀ ᅨ ᄅ ᅵ ᄆ ᅴ
숲에서	ᄉ ᅮ ᄑ ᅦ ᄉ ᅥ
닭	ᄃ ᅡ ᆨ
우는	ᄋ ᅮ ᄂ ᅳ ᆫ
들었다	ᄃ ᅳ ᄅ ᅥ ᆮ ᄄ ᅡ
이때부터	ᄋ ᅵ ᄄ ᅢ ᄇ ᅮ ᄐ ᅥ
그는	ᄀ ᅳ ᄂ ᅳ ᆫ
직접	ᄌ ᅵ ᆨ ᄍ ᅥ ᆸ
관찰한	ᄀ ᅪ ᆫ ᄎ ᅡ ᆯ ᄒ ᅡ ᆫ
바탕으로	ᄇ ᅡ ᄐ ᅡ ᆼ ᄋ ᅳ ᄅ ᅩ
이론을	ᄋ ᅵ ᄅ ᅩ ᄂ ᅳ ᆯ
수립하였다	ᄉ ᅮ ᄅ ᅵ ᄑ ᅡ ᄋ ᅧ ᆮ ᄄ ᅡ
대전차	ᄃ ᅢ ᄌ ᅥ ᆫ ᄎ ᅡ
방호벽은	ᄇ ᅡ ᆼ ᄒ ᅩ ᄇ ᅧ ᄀ ᅳ ᆫ
콘크리트	ᄏ ᅩ ᆫ ᄏ ᅳ ᄅ ᅵ ᄐ ᅳ
구조물로	ᄀ ᅮ ᄌ ᅩ ᄆ ᅮ ᆯ ᄅ ᅩ
있으며	ᄋ ᅵ ᄊ ᅳ ᄆ ᅧ
여러	ᄋ ᅧ ᄅ ᅥ
가지	ᄀ ᅡ ᄌ ᅵ
모양이	ᄆ ᅩ ᄋ ᅣ ᆼ ᄋ ᅵ
초기에는	ᄎ ᅩ ᄀ ᅵ ᄋ ᅦ ᄂ ᅳ ᆫ
도화원이라	ᄃ ᅩ ᄒ ᅪ ᄋ ᅯ ᄂ ᅵ ᄅ ᅡ
하였으나	ᄒ ᅡ ᄋ ᅧ ᄊ ᅳ ᄂ ᅡ
그림	ᄀ ᅳ ᄅ ᅵ ᆷ
그리는	ᄀ ᅳ ᄅ ᅵ ᄂ ᅳ ᆫ
일의	ᄋ ᅵ ᄅ ᅴ
격을	ᄀ ᅧ ᄀ ᅳ ᆯ
낮추어	ᄂ ᅡ ᆮ ᄎ ᅮ ᄋ ᅥ
도화서로	ᄃ ᅩ ᄒ ᅪ ᄉ ᅥ ᄅ ᅩ
개칭하였다	ᄀ ᅢ ᄎ ᅵ ᆼ ᄒ ᅡ ᄋ ᅧ ᆮ ᄄ ᅡ
청설모는	ᄎ ᅥ ᆼ ᄉ ᅥ ᆯ ᄆ ᅩ ᄂ ᅳ ᆫ
도시	ᄃ ᅩ ᄉ ᅵ
환경에서도	ᄒ ᅪ ᆫ ᄀ ᅧ ᆼ ᄋ ᅦ ᄉ ᅥ ᄃ ᅩ
적응했기	ᄌ ᅥ ᄀ ᅳ ᆼ ᄒ ᅢ ᆮ ᄁ ᅵ
미국이나	ᄆ ᅵ ᄀ ᅮ ᄀ ᅵ ᄂ ᅡ
캐나다의	ᄏ ᅢ ᄂ ᅡ ᄃ ᅡ ᄋ ᅴ
공원에서	ᄀ ᅩ ᆼ ᄋ ᅯ ᄂ ᅦ ᄉ ᅥ
흔히	ᄒ ᅳ ᆫ ᄒ ᅵ
있다	ᄋ ᅵ ᆮ ᄄ ᅡ
대구의	ᄃ ᅢ ᄀ ᅮ ᄋ ᅴ
랜드마크로	ᄅ ᅢ ᆫ ᄃ ᅳ ᄆ ᅡ ᄏ ᅳ ᄅ ᅩ
전국에	ᄌ ᅥ ᆫ ᄀ ᅮ ᄀ ᅦ
위치한	ᄋ ᅱ ᄎ ᅵ ᄒ ᅡ ᆫ
위브	ᄋ ᅱ ᄇ ᅳ
착공하였으며	ᄎ ᅡ ᆨ ᄁ ᅩ ᆼ ᄒ ᅡ ᄋ ᅧ ᄊ ᅳ ᄆ ᅧ
완공되었다	ᄋ ᅪ ᆫ ᄀ ᅩ ᆼ ᄃ ᅬ ᄋ ᅥ ᆮ ᄄ ᅡ
예를	ᄋ ᅨ ᄅ ᅳ ᆯ
딴	ᄄ ᅡ ᆫ
손잡이는	ᄉ ᅩ ᆫ ᄌ ᅡ ᄇ ᅵ ᄂ ᅳ ᆫ
오른손으로	ᄋ ᅩ ᄅ ᅳ ᆫ ᄉ ᅩ ᄂ ᅳ ᄅ ᅩ
글씨를	ᄀ ᅳ ᆯ ᄊ ᅵ ᄅ ᅳ ᆯ
왼손으로	ᄋ ᅬ ᆫ ᄉ ᅩ ᄂ ᅳ ᄅ ᅩ
그림을	ᄀ ᅳ ᄅ ᅵ ᄆ ᅳ ᆯ
그립니다	ᄀ ᅳ ᄅ ᅵ ᆷ ᄂ ᅵ ᄃ ᅡ
라이거는	ᄅ ᅡ ᄋ ᅵ ᄀ ᅥ ᄂ ᅳ ᆫ
호랑이의	ᄒ ᅩ ᄅ ᅡ ᆼ ᄋ ᅵ ᄋ ᅴ
특징을	ᄐ ᅳ ᆨ ᄍ ᅵ ᆼ ᄋ ᅳ ᆯ
닮아	ᄃ ᅡ ᆯ ᄆ ᅡ
헤엄을	ᄒ ᅦ ᄋ ᅥ ᄆ ᅳ ᆯ
즐기며	ᄌ ᅳ ᆯ ᄀ ᅵ ᄆ ᅧ
사자처럼	ᄉ ᅡ ᄌ ᅡ ᄎ ᅥ ᄅ ᅥ ᆷ
너울	ᄂ ᅥ ᄋ ᅮ ᆯ
가지가	ᄀ ᅡ ᄌ ᅵ ᄀ ᅡ
매우	ᄆ ᅢ ᄋ ᅮ
좋다	ᄌ ᅩ ᄐ ᅡ
루터는	ᄅ ᅮ ᄐ ᅥ ᄂ ᅳ ᆫ
이단으로	ᄋ ᅵ ᄃ ᅡ ᄂ ᅳ ᄅ ᅩ
낙인찍히면서	ᄂ ᅡ ᄀ ᅵ ᆫ ᄍ ᅵ ᄏ ᅵ ᄆ ᅧ ᆫ ᄉ ᅥ
루터	ᄅ ᅮ ᄐ ᅥ
종교개혁의	ᄌ ᅩ ᆼ ᄀ ᅭ ᄀ ᅢ ᄒ ᅧ ᄀ ᅴ
도화선이	ᄃ ᅩ ᄒ ᅪ ᄉ ᅥ ᄂ ᅵ
되었다	ᄃ ᅬ ᄋ ᅥ ᆮ ᄄ ᅡ
팝업	ᄑ ᅡ ᄇ ᅥ ᆸ
전조	ᄌ ᅥ ᆫ ᄌ ᅩ
등이	ᄃ ᅳ ᆼ ᄋ ᅵ
구비된	ᄀ ᅮ ᄇ ᅵ ᄃ ᅬ ᆫ
차량은	ᄎ ᅡ ᄅ ᅣ ᆼ ᄋ ᅳ ᆫ
일세대이며	ᄋ ᅵ ᆯ ᄉ ᅦ ᄃ ᅢ ᄋ ᅵ ᄆ ᅧ
개방형	ᄀ ᅢ ᄇ ᅡ ᆼ ᄒ ᅧ ᆼ
세대입니다	ᄉ ᅦ ᄃ ᅢ ᄋ ᅵ ᆷ ᄂ ᅵ ᄃ ᅡ
레아는	ᄅ ᅦ ᄋ ᅡ ᄂ ᅳ ᆫ
그리스	ᄀ ᅳ ᄅ ᅵ ᄉ ᅳ
신화에	ᄉ ᅵ ᆫ ᄒ ᅪ ᄋ ᅦ
나오는	ᄂ ᅡ ᄋ ᅩ ᄂ ᅳ ᆫ
거인족	ᄀ ᅥ ᄋ ᅵ ᆫ ᄌ ᅩ ᆨ
티탄인	ᄐ ᅵ ᄐ ᅡ ᄂ ᅵ ᆫ
레아에서	ᄅ ᅦ ᄋ ᅡ ᄋ ᅦ ᄉ ᅥ
유래했으며	ᄋ ᅲ ᄅ ᅢ ᄒ ᅢ ᄊ ᅳ ᄆ ᅧ
태양계의	ᄐ ᅢ ᄋ ᅣ ᆼ ᄀ ᅨ ᄋ ᅴ
위성	ᄋ ᅱ ᄉ ᅥ ᆼ
번째로	ᄇ ᅥ ᆫ ᄍ ᅢ ᄅ ᅩ
큽니다	ᄏ ᅳ ᆷ ᄂ ᅵ ᄃ ᅡ
집시는	ᄌ ᅵ ᆸ ᄊ ᅵ ᄂ ᅳ ᆫ
나치	ᄂ ᅡ ᄎ ᅵ
독일의	ᄃ ᅩ ᄀ ᅵ ᄅ ᅴ
홀로코스트와	ᄒ ᅩ ᆯ ᄅ ᅩ ᄏ ᅩ ᄉ ᅳ ᄐ ᅳ ᄋ ᅪ
강제	ᄀ ᅡ ᆼ ᄌ ᅦ
노역으로	ᄂ ᅩ ᄋ ᅧ ᄀ ᅳ ᄅ ᅩ
팔십만	ᄑ ᅡ ᆯ ᄉ ᅵ ᆷ ᄆ ᅡ ᆫ
비극의	ᄇ ᅵ ᄀ ᅳ ᄀ ᅴ
갖고	ᄀ ᅡ ᆮ ᄁ ᅩ
무덤이	ᄆ ᅮ ᄃ ᅥ ᄆ ᅵ
일기만	ᄋ ᅵ ᆯ ᄀ ᅵ ᄆ ᅡ ᆫ
있다면	ᄋ ᅵ ᆮ ᄄ ᅡ ᄆ ᅧ ᆫ
묘지와	ᄆ ᅭ ᄌ ᅵ ᄋ ᅪ
묘역은	ᄆ ᅭ ᄋ ᅧ ᄀ ᅳ ᆫ
동일한	ᄃ ᅩ ᆼ ᄋ ᅵ ᆯ ᄒ ᅡ ᆫ
영역을	ᄋ ᅧ ᆼ ᄋ ᅧ ᄀ ᅳ ᆯ
나타낸다	ᄂ ᅡ ᄐ ᅡ ᄂ ᅢ ᆫ ᄃ ᅡ
교황청의	ᄀ ᅭ ᄒ ᅪ ᆼ ᄎ ᅥ ᆼ ᄋ ᅴ
보안	ᄇ ᅩ ᄋ ᅡ ᆫ
문제를	ᄆ ᅮ ᆫ ᄌ ᅦ ᄅ ᅳ ᆯ
책임지고	ᄎ ᅢ ᄀ ᅵ ᆷ ᄌ ᅵ ᄀ ᅩ
기타	ᄀ ᅵ ᄐ ᅡ
바티칸	ᄇ ᅡ ᄐ ᅵ ᄏ ᅡ ᆫ
시국에서의	ᄉ ᅵ ᄀ ᅮ ᄀ ᅦ ᄉ ᅥ ᄋ ᅴ
일상적인	ᄋ ᅵ ᆯ ᄉ ᅡ ᆼ ᄌ ᅥ ᄀ ᅵ ᆫ
경찰	ᄀ ᅧ ᆼ ᄎ ᅡ ᆯ
임무를	ᄋ ᅵ ᆷ ᄆ ᅮ ᄅ ᅳ ᆯ
맡고	ᄆ ᅡ ᆮ ᄁ ᅩ
봄에	ᄇ ᅩ ᄆ ᅦ
종업식	ᄌ ᅩ ᆼ ᄋ ᅥ ᆸ ᄊ ᅵ ᆨ
대략	ᄃ ᅢ ᄅ ᅣ ᆨ
주일간	ᄌ ᅮ ᄋ ᅵ ᆯ ᄀ ᅡ ᆫ
학년	ᄒ ᅡ ᆼ ᄂ ᅧ ᆫ
방학을	ᄇ ᅡ ᆼ ᄒ ᅡ ᄀ ᅳ ᆯ
한다	ᄒ ᅡ ᆫ ᄃ ᅡ
브래지어는	ᄇ ᅳ ᄅ ᅢ ᄌ ᅵ ᄋ ᅥ ᄂ ᅳ ᆫ
브라라고	ᄇ ᅳ ᄅ ᅡ ᄅ ᅡ ᄀ ᅩ
일컬으며	ᄋ ᅵ ᆯ ᄏ ᅥ ᄅ ᅳ ᄆ ᅧ
유방을	ᄋ ᅲ ᄇ ᅡ ᆼ ᄋ ᅳ ᆯ
가리고	ᄀ ᅡ ᄅ ᅵ ᄀ ᅩ
지탱해	ᄌ ᅵ ᄐ ᅢ ᆼ ᄒ ᅢ
옷의	ᄋ ᅩ ᄉ ᅴ
형태이다	ᄒ ᅧ ᆼ ᄐ ᅢ ᄋ ᅵ ᄃ ᅡ
환자의	ᄒ ᅪ ᆫ ᄌ ᅡ ᄋ ᅴ
수면	ᄉ ᅮ ᄆ ᅧ ᆫ
발생하는	ᄇ ᅡ ᆯ ᄉ ᅢ ᆼ ᄒ ᅡ ᄂ ᅳ ᆫ
질환의	ᄌ ᅵ ᆯ ᄒ ᅪ ᄂ ᅴ
원인을	ᄋ ᅯ ᄂ ᅵ ᄂ ᅳ ᆯ
알아내기	ᄋ ᅡ ᄅ ᅡ ᄂ ᅢ ᄀ ᅵ
다원	ᄃ ᅡ ᄋ ᅯ ᆫ
검사를	ᄀ ᅥ ᆷ ᄉ ᅡ ᄅ ᅳ ᆯ
진행했다	ᄌ ᅵ ᆫ ᄒ ᅢ ᆼ ᄒ ᅢ ᆮ ᄄ ᅡ
상자들과	ᄉ ᅡ ᆼ ᄌ ᅡ ᄃ ᅳ ᆯ ᄀ ᅪ
조작의	ᄌ ᅩ ᄌ ᅡ ᄀ ᅴ
흐름을	ᄒ ᅳ ᄅ ᅳ ᄆ ᅳ ᆯ
나타내는	ᄂ ᅡ ᄐ ᅡ ᄂ ᅢ ᄂ ᅳ ᆫ
화살표	ᄒ ᅪ ᄉ ᅡ ᆯ ᄑ ᅭ
연결로	ᄋ ᅧ ᆫ ᄀ ᅧ ᆯ ᄅ ᅩ
프로세스	ᄑ ᅳ ᄅ ᅩ ᄉ ᅦ ᄉ ᅳ
작용을	ᄌ ᅡ ᄀ ᅭ ᆼ ᄋ ᅳ ᆯ
나타냈다	ᄂ ᅡ ᄐ ᅡ ᄂ ᅢ ᆮ ᄄ ᅡ
개인용	ᄀ ᅢ ᄋ ᅵ ᄂ ᅭ ᆼ
컴퓨터	ᄏ ᅥ ᆷ ᄑ ᅲ ᄐ ᅥ
애호가들이	ᄋ ᅢ ᄒ ᅩ ᄀ ᅡ ᄃ ᅳ ᄅ ᅵ
그들의	ᄀ ᅳ ᄃ ᅳ ᄅ ᅴ
성능을	ᄉ ᅥ ᆼ ᄂ ᅳ ᆼ ᄋ ᅳ ᆯ
높이기	ᄂ ᅩ ᄑ ᅵ ᄀ ᅵ
주로	ᄌ ᅮ ᄅ ᅩ
클럭을	ᄏ ᅳ ᆯ ᄅ ᅥ ᄀ ᅳ ᆯ
높이기도	ᄂ ᅩ ᄑ ᅵ ᄀ ᅵ ᄃ ᅩ
음악	ᄋ ᅳ ᄆ ᅡ ᆨ
치료사들은	ᄎ ᅵ ᄅ ᅭ ᄉ ᅡ ᄃ ᅳ ᄅ ᅳ ᆫ
치매	ᄎ ᅵ ᄆ ᅢ
환자나	ᄒ ᅪ ᆫ ᄌ ᅡ ᄂ ᅡ
어린아이들의	ᄋ ᅥ ᄅ ᅵ ᄂ ᅡ ᄋ ᅵ ᄃ ᅳ ᄅ ᅴ
몸과	ᄆ ᅩ ᆷ ᄀ ᅪ
치료하는	ᄎ ᅵ ᄅ ᅭ ᄒ ᅡ ᄂ ᅳ ᆫ
차	ᄎ ᅡ
세계대전	ᄉ ᅦ ᄀ ᅨ ᄃ ᅢ ᄌ ᅥ ᆫ
직후인	ᄌ ᅵ ᄏ ᅮ ᄋ ᅵ ᆫ
천구백십구년에	ᄎ ᅥ ᆫ ᄀ ᅮ ᄇ ᅢ ᆨ ᄊ ᅵ ᆸ ᄁ ᅮ ᄂ ᅧ ᄂ ᅦ
폴란드	ᄑ ᅩ ᆯ ᄅ ᅡ ᆫ ᄃ ᅳ
공화국의	ᄀ ᅩ ᆼ ᄒ ᅪ ᄀ ᅮ ᄀ ᅴ
탄생과	ᄐ ᅡ ᆫ ᄉ ᅢ ᆼ ᄀ ᅪ
동시에	ᄃ ᅩ ᆼ ᄉ ᅵ ᄋ ᅦ
초대	ᄎ ᅩ ᄃ ᅢ
수상이	ᄉ ᅮ ᄉ ᅡ ᆼ ᄋ ᅵ
호수에서	ᄒ ᅩ ᄉ ᅮ ᄋ ᅦ ᄉ ᅥ
물고기를	ᄆ ᅮ ᆯ ᄀ ᅩ ᄀ ᅵ ᄅ ᅳ ᆯ
잡거나	ᄌ ᅡ ᆸ ᄁ ᅥ ᄂ ᅡ
수경	ᄉ ᅮ ᄀ ᅧ ᆼ
재배로	ᄌ ᅢ ᄇ ᅢ ᄅ ᅩ
야채나	ᄋ ᅣ ᄎ ᅢ ᄂ ᅡ
방울토마토를	ᄇ ᅡ ᆼ ᄋ ᅮ ᆯ ᄐ ᅩ ᄆ ᅡ ᄐ ᅩ ᄅ ᅳ ᆯ
생산합니다	ᄉ ᅢ ᆼ ᄉ ᅡ ᆫ ᄒ ᅡ ᆷ ᄂ ᅵ ᄃ ᅡ
말해서	ᄆ ᅡ ᆯ ᄒ ᅢ ᄉ ᅥ
결과값이	ᄀ ᅧ ᆯ ᄀ ᅪ ᄀ ᅡ ᆸ ᄊ ᅵ
주어졌을	ᄌ ᅮ ᄋ ᅥ ᄌ ᅥ ᄊ ᅳ ᆯ
입력값을	ᄋ ᅵ ᆷ ᄂ ᅧ ᆨ ᄁ ᅡ ᆸ ᄊ ᅳ ᆯ
구하는	ᄀ ᅮ ᄒ ᅡ ᄂ ᅳ ᆫ
것이	ᄀ ᅥ ᄉ ᅵ
어려운	ᄋ ᅥ ᄅ ᅧ ᄋ ᅮ ᆫ
함수이다	ᄒ ᅡ ᆷ ᄉ ᅮ ᄋ ᅵ ᄃ ᅡ
열매가	ᄋ ᅧ ᆯ ᄆ ᅢ ᄀ ᅡ
익으면	ᄋ ᅵ ᄀ ᅳ ᄆ ᅧ ᆫ
사이의	ᄉ ᅡ ᄋ ᅵ ᄋ ᅴ
양쪽에	ᄋ ᅣ ᆼ ᄍ ᅩ ᄀ ᅦ
주름이	ᄌ ᅮ ᄅ ᅳ ᄆ ᅵ
생기며	ᄉ ᅢ ᆼ ᄀ ᅵ ᄆ ᅧ
각	ᄀ ᅡ ᆨ
마디에	ᄆ ᅡ ᄃ ᅵ ᄋ ᅦ
개의	ᄀ ᅢ ᄋ ᅴ
종자가	ᄌ ᅩ ᆼ ᄌ ᅡ ᄀ ᅡ
나온다	ᄂ ᅡ ᄋ ᅩ ᆫ ᄃ ᅡ
신축성이	ᄉ ᅵ ᆫ ᄎ ᅮ ᆨ ᄊ ᅥ ᆼ ᄋ ᅵ
강하고	ᄀ ᅡ ᆼ ᄒ ᅡ ᄀ ᅩ
긴	ᄀ ᅵ ᆫ
장대를	ᄌ ᅡ ᆼ ᄃ ᅢ ᄅ ᅳ ᆯ
쥐고	ᄌ ᅱ ᄀ ᅩ
도움닫기를	ᄃ ᅩ ᄋ ᅮ ᆷ ᄃ ᅡ ᆮ ᄁ ᅵ ᄅ ᅳ ᆯ
하여	ᄒ ᅡ ᄋ ᅧ
가로대를	ᄀ ᅡ ᄅ ᅩ ᄃ ᅢ ᄅ ᅳ ᆯ
넘는	ᄂ ᅥ ᆷ ᄂ ᅳ ᆫ
종목이	ᄌ ᅩ ᆼ ᄆ ᅩ ᄀ ᅵ
체중이	ᄎ ᅦ ᄌ ᅮ ᆼ ᄋ ᅵ
적어	ᄌ ᅥ ᄀ ᅥ
건강한	ᄀ ᅥ ᆫ ᄀ ᅡ ᆼ ᄒ ᅡ ᆫ
표준	ᄑ ᅭ ᄌ ᅮ ᆫ
체중보다	ᄎ ᅦ ᄌ ᅮ ᆼ ᄇ ᅩ ᄃ ᅡ
적은	ᄌ ᅥ ᄀ ᅳ ᆫ
상태를	ᄉ ᅡ ᆼ ᄐ ᅢ ᄅ ᅳ ᆯ
말한다	ᄆ ᅡ ᆯ ᄒ ᅡ ᆫ ᄃ ᅡ
보통은	ᄇ ᅩ ᄐ ᅩ ᆼ ᄋ ᅳ ᆫ
법원이나	ᄇ ᅥ ᄇ ᅯ ᄂ ᅵ ᄂ ᅡ
정부	ᄌ ᅥ ᆼ ᄇ ᅮ
기관에서	ᄀ ᅵ ᄀ ᅪ ᄂ ᅦ ᄉ ᅥ
정지	ᄌ ᅥ ᆼ ᄌ ᅵ
명령을	ᄆ ᅧ ᆼ ᄂ ᅧ ᆼ ᄋ ᅳ ᆯ
내릴	ᄂ ᅢ ᄅ ᅵ ᆯ
특수한	ᄐ ᅳ ᆨ ᄊ ᅮ ᄒ ᅡ ᆫ
개인도	ᄀ ᅢ ᄋ ᅵ ᆫ ᄃ ᅩ
생후	ᄉ ᅢ ᆼ ᄒ ᅮ
오일	ᄋ ᅩ ᄋ ᅵ ᆯ
만에	ᄆ ᅡ ᄂ ᅦ
사망하여	ᄉ ᅡ ᄆ ᅡ ᆼ ᄒ ᅡ ᄋ ᅧ
생전에	ᄉ ᅢ ᆼ ᄌ ᅥ ᄂ ᅦ
친왕	ᄎ ᅵ ᄂ ᅪ ᆼ
등의	ᄃ ᅳ ᆼ ᄋ ᅴ
작위를	ᄌ ᅡ ᄀ ᅱ ᄅ ᅳ ᆯ
봉작	ᄇ ᅩ ᆼ ᄌ ᅡ ᆨ
받지	ᄇ ᅡ ᆮ ᄍ ᅵ
못했다	ᄆ ᅩ ᄐ ᅢ ᆮ ᄄ ᅡ
중성미자의	ᄌ ᅮ ᆼ ᄉ ᅥ ᆼ ᄆ ᅵ ᄌ ᅡ ᄋ ᅴ
맛깔이	ᄆ ᅡ ᆮ ᄁ ᅡ ᄅ ᅵ
흐름에	ᄒ ᅳ ᄅ ᅳ ᄆ ᅦ
변하는	ᄇ ᅧ ᆫ ᄒ ᅡ ᄂ ᅳ ᆫ
양자	ᄋ ᅣ ᆼ ᄌ ᅡ
역학	ᄋ ᅧ ᄏ ᅡ ᆨ
현상이	ᄒ ᅧ ᆫ ᄉ ᅡ ᆼ ᄋ ᅵ
모습은	ᄆ ᅩ ᄉ ᅳ ᄇ ᅳ ᆫ
일반	ᄋ ᅵ ᆯ ᄇ ᅡ ᆫ
용과	ᄋ ᅭ ᆼ ᄀ ᅪ
다를	ᄃ ᅡ ᄅ ᅳ ᆯ
하나도	ᄒ ᅡ ᄂ ᅡ ᄃ ᅩ
없지만	ᄋ ᅥ ᆸ ᄍ ᅵ ᄆ ᅡ ᆫ
이름	ᄋ ᅵ ᄅ ᅳ ᆷ
그대로	ᄀ ᅳ ᄃ ᅢ ᄅ ᅩ
푸른색을	ᄑ ᅮ ᄅ ᅳ ᆫ ᄉ ᅢ ᄀ ᅳ ᆯ
띠고	ᄄ ᅵ ᄀ ᅩ
과정이	ᄀ ᅪ ᄌ ᅥ ᆼ ᄋ ᅵ
심화되면	ᄉ ᅵ ᆷ ᄒ ᅪ ᄃ ᅬ ᄆ ᅧ ᆫ
소행성이	ᄉ ᅩ ᄒ ᅢ ᆼ ᄉ ᅥ ᆼ ᄋ ᅵ
되며	ᄃ ᅬ ᄆ ᅧ
진화를	ᄌ ᅵ ᆫ ᄒ ᅪ ᄅ ᅳ ᆯ
겪으면	ᄀ ᅧ ᄁ ᅳ ᄆ ᅧ ᆫ
행성으로	ᄒ ᅢ ᆼ ᄉ ᅥ ᆼ ᄋ ᅳ ᄅ ᅩ
자라나게	ᄌ ᅡ ᄅ ᅡ ᄂ ᅡ ᄀ ᅦ
된다	ᄃ ᅬ ᆫ ᄃ ᅡ
판의	ᄑ ᅡ ᄂ ᅴ
경계에서는	ᄀ ᅧ ᆼ ᄀ ᅨ ᄋ ᅦ ᄉ ᅥ ᄂ ᅳ ᆫ
지진과	ᄌ ᅵ ᄌ ᅵ ᆫ ᄀ ᅪ
화산활동이	ᄒ ᅪ ᄉ ᅡ ᆫ ᄒ ᅪ ᆯ ᄃ ᅩ ᆼ ᄋ ᅵ
잦으며	ᄌ ᅡ ᄌ ᅳ ᄆ ᅧ
대부분의	ᄃ ᅢ ᄇ ᅮ ᄇ ᅮ ᄂ ᅴ
화산은	ᄒ ᅪ ᄉ ᅡ ᄂ ᅳ ᆫ
경계에	ᄀ ᅧ ᆼ ᄀ ᅨ ᄋ ᅦ
항공기	ᄒ ᅡ ᆼ ᄀ ᅩ ᆼ ᄀ ᅵ
날개에	ᄂ ᅡ ᆯ ᄀ ᅢ ᄋ ᅦ
걸리는	ᄀ ᅥ ᆯ ᄅ ᅵ ᄂ ᅳ ᆫ
하중의	ᄒ ᅡ ᄌ ᅮ ᆼ ᄋ ᅴ
크기를	ᄏ ᅳ ᄀ ᅵ ᄅ ᅳ ᆯ
기본하중으로	ᄀ ᅵ ᄇ ᅩ ᆫ ᄒ ᅡ ᄌ ᅮ ᆼ ᄋ ᅳ ᄅ ᅩ
나눈다	ᄂ ᅡ ᄂ ᅮ ᆫ ᄃ ᅡ
오른쪽	ᄋ ᅩ ᄅ ᅳ ᆫ ᄍ ᅩ ᆨ
눈은	ᄂ ᅮ ᄂ ᅳ ᆫ
라의	ᄅ ᅡ ᄋ ᅴ
눈으로	ᄂ ᅮ ᄂ ᅳ ᄅ ᅩ
태양을	ᄐ ᅢ ᄋ ᅣ ᆼ ᄋ ᅳ ᆯ
상징하고	ᄉ ᅡ ᆼ ᄌ ᅵ ᆼ ᄒ ᅡ ᄀ ᅩ
왼쪽	ᄋ ᅬ ᆫ ᄍ ᅩ ᆨ
토트의	ᄐ ᅩ ᄐ ᅳ ᄋ ᅴ
달을	ᄃ ᅡ ᄅ ᅳ ᆯ
상징한다	ᄉ ᅡ ᆼ ᄌ ᅵ ᆼ ᄒ ᅡ ᆫ ᄃ ᅡ
암컷은	ᄋ ᅡ ᆷ ᄏ ᅥ ᄉ ᅳ ᆫ
눈썹	ᄂ ᅮ ᆫ ᄊ ᅥ ᆸ
선도	ᄉ ᅥ ᆫ ᄃ ᅩ
배는	ᄇ ᅢ ᄂ ᅳ ᆫ
대체로	ᄃ ᅢ ᄎ ᅦ ᄅ ᅩ
흰색을	ᄒ ᅵ ᆫ ᄉ ᅢ ᄀ ᅳ ᆯ
띠며	ᄄ ᅵ ᄆ ᅧ
위는	ᄋ ᅱ ᄂ ᅳ ᆫ
갈색을	ᄀ ᅡ ᆯ ᄉ ᅢ ᄀ ᅳ ᆯ
띤다	ᄄ ᅵ ᆫ ᄃ ᅡ
특히	ᄐ ᅳ ᄏ ᅵ
빛의	ᄇ ᅵ ᄎ ᅴ
수면에	ᄉ ᅮ ᄆ ᅧ ᄂ ᅦ
빼놓을	ᄈ ᅢ ᄂ ᅩ ᄋ ᅳ ᆯ
중요한	ᄌ ᅮ ᆼ ᄋ ᅭ ᄒ ᅡ ᆫ
역할을	ᄋ ᅧ ᄏ ᅡ ᄅ ᅳ ᆯ
오징어나	ᄋ ᅩ ᄌ ᅵ ᆼ ᄋ ᅥ ᄂ ᅡ
노가리를	ᄂ ᅩ ᄀ ᅡ ᄅ ᅵ ᄅ ᅳ ᆯ
불에	ᄇ ᅮ ᄅ ᅦ
구워서	ᄀ ᅮ ᄋ ᅯ ᄉ ᅥ
고추장이나	ᄀ ᅩ ᄎ ᅮ ᄌ ᅡ ᆼ ᄋ ᅵ ᄂ ᅡ
마요네즈에	ᄆ ᅡ ᄋ ᅭ ᄂ ᅦ ᄌ ᅳ ᄋ ᅦ
찍어	ᄍ ᅵ ᄀ ᅥ
먹는다	ᄆ ᅥ ᆼ ᄂ ᅳ ᆫ ᄃ ᅡ
담근	ᄃ ᅡ ᆷ ᄀ ᅳ ᆫ
된	ᄃ ᅬ ᆫ
사용하면	ᄉ ᅡ ᄋ ᅭ ᆼ ᄒ ᅡ ᄆ ᅧ ᆫ
특유의	ᄐ ᅳ ᄀ ᅲ ᄋ ᅴ
않기	ᄋ ᅡ ᆫ ᄏ ᅵ
때문입니다	ᄄ ᅢ ᄆ ᅮ ᄂ ᅵ ᆷ ᄂ ᅵ ᄃ ᅡ
질량에	ᄌ ᅵ ᆯ ᄅ ᅣ ᆼ ᄋ ᅦ
근거하여	ᄀ ᅳ ᆫ ᄀ ᅥ ᄒ ᅡ ᄋ ᅧ
행성은	ᄒ ᅢ ᆼ ᄉ ᅥ ᆼ ᄋ ᅳ ᆫ
딱딱한	ᄄ ᅡ ᆨ ᄄ ᅡ ᄏ ᅡ ᆫ
표면이	ᄑ ᅭ ᄆ ᅧ ᄂ ᅵ
가스	ᄀ ᅡ ᄉ ᅳ
행성일	ᄒ ᅢ ᆼ ᄉ ᅥ ᆼ ᄋ ᅵ ᆯ
것으로	ᄀ ᅥ ᄉ ᅳ ᄅ ᅩ
추측되고	ᄎ ᅮ ᄎ ᅳ ᆨ ᄄ ᅬ ᄀ ᅩ
앨범은	ᄋ ᅢ ᆯ ᄇ ᅥ ᄆ ᅳ ᆫ
대중적이라기보다는	ᄃ ᅢ ᄌ ᅮ ᆼ ᄌ ᅥ ᄀ ᅵ ᄅ ᅡ ᄀ ᅵ ᄇ ᅩ ᄃ ᅡ ᄂ ᅳ ᆫ
예술적인	ᄋ ᅨ ᄉ ᅮ ᆯ ᄌ ᅥ ᄀ ᅵ ᆫ
측면이	ᄎ ᅳ ᆼ ᄆ ᅧ ᄂ ᅵ
강함을	ᄀ ᅡ ᆼ ᄒ ᅡ ᄆ ᅳ ᆯ
느낄	ᄂ ᅳ ᄁ ᅵ ᆯ
풍뎅이와	ᄑ ᅮ ᆼ ᄃ ᅦ ᆼ ᄋ ᅵ ᄋ ᅪ
달리	ᄃ ᅡ ᆯ ᄅ ᅵ
앞날개를	ᄋ ᅡ ᆷ ᄂ ᅡ ᆯ ᄀ ᅢ ᄅ ᅳ ᆯ
살짝	ᄉ ᅡ ᆯ ᄍ ᅡ ᆨ
뒤	ᄃ ᅱ
뒷날개만	ᄃ ᅱ ᆫ ᄂ ᅡ ᆯ ᄀ ᅢ ᄆ ᅡ ᆫ
완전히	ᄋ ᅪ ᆫ ᄌ ᅥ ᆫ ᄒ ᅵ
펴서	ᄑ ᅧ ᄉ ᅥ
비행한다	ᄇ ᅵ ᄒ ᅢ ᆼ ᄒ ᅡ ᆫ ᄃ ᅡ
지방마다	ᄌ ᅵ ᄇ ᅡ ᆼ ᄆ ᅡ ᄃ ᅡ
상황에	ᄉ ᅡ ᆼ ᄒ ᅪ ᆼ ᄋ ᅦ
요리의	ᄋ ᅭ ᄅ ᅵ ᄋ ᅴ
특성이	ᄐ ᅳ ᆨ ᄊ ᅥ ᆼ ᄋ ᅵ
두드러지게	ᄃ ᅮ ᄃ ᅳ ᄅ ᅥ ᄌ ᅵ ᄀ ᅦ
나타난다	ᄂ ᅡ ᄐ ᅡ ᄂ ᅡ ᆫ ᄃ ᅡ
보이는	ᄇ ᅩ ᄋ ᅵ ᄂ ᅳ ᆫ
손님들이	ᄉ ᅩ ᆫ ᄂ ᅵ ᆷ ᄃ ᅳ ᄅ ᅵ
도착할	ᄃ ᅩ ᄎ ᅡ ᄏ ᅡ ᆯ
맞이하며	ᄆ ᅡ ᄌ ᅵ ᄒ ᅡ ᄆ ᅧ
문이나	ᄆ ᅮ ᄂ ᅵ ᄂ ᅡ
열어	ᄋ ᅧ ᄅ ᅥ
준다	ᄌ ᅮ ᆫ ᄃ ᅡ
세계적으로	ᄉ ᅦ ᄀ ᅨ ᄌ ᅥ ᄀ ᅳ ᄅ ᅩ
대중적인	ᄃ ᅢ ᄌ ᅮ ᆼ ᄌ ᅥ ᄀ ᅵ ᆫ
인기를	ᄋ ᅵ ᆫ ᄀ ᅵ ᄅ ᅳ ᆯ
얻게	ᄋ ᅥ ᆮ ᄁ ᅦ
계기는	ᄀ ᅨ ᄀ ᅵ ᄂ ᅳ ᆫ
칠십년대	ᄎ ᅵ ᆯ ᄉ ᅵ ᆷ ᄂ ᅧ ᆫ ᄃ ᅢ
후반	ᄒ ᅮ ᄇ ᅡ ᆫ
뉴욕의	ᄂ ᅲ ᄋ ᅭ ᄀ ᅴ
디스코	ᄃ ᅵ ᄉ ᅳ ᄏ ᅩ
열풍이	ᄋ ᅧ ᆯ ᄑ ᅮ ᆼ ᄋ ᅵ
불면서였다	ᄇ ᅮ ᆯ ᄆ ᅧ ᆫ ᄉ ᅥ ᄋ ᅧ ᆮ ᄄ ᅡ
승패가	ᄉ ᅳ ᆼ ᄑ ᅢ ᄀ ᅡ
결정되면	ᄀ ᅧ ᆯ ᄌ ᅥ ᆼ ᄃ ᅬ ᄆ ᅧ ᆫ
결과에	ᄀ ᅧ ᆯ ᄀ ᅪ ᄋ ᅦ
상관없이	ᄉ ᅡ ᆼ ᄀ ᅪ ᄂ ᅥ ᆸ ᄊ ᅵ
인정을	ᄋ ᅵ ᆫ ᄌ ᅥ ᆼ ᄋ ᅳ ᆯ
베풀어	ᄇ ᅦ ᄑ ᅮ ᄅ ᅥ
화합하며	ᄒ ᅪ ᄒ ᅡ ᄑ ᅡ ᄆ ᅧ
즐겼다	ᄌ ᅳ ᆯ ᄀ ᅧ ᆮ ᄄ ᅡ
올림픽	ᄋ ᅩ ᆯ ᄅ ᅵ ᆷ ᄑ ᅵ ᆨ
대회에서	ᄃ ᅢ ᄒ ᅬ ᄋ ᅦ ᄉ ᅥ
금메달	ᄀ ᅳ ᆷ ᄆ ᅦ ᄃ ᅡ ᆯ
세	ᄉ ᅦ
개를	ᄀ ᅢ ᄅ ᅳ ᆯ
유일한	ᄋ ᅲ ᄋ ᅵ ᆯ ᄒ ᅡ ᆫ
스키점프	ᄉ ᅳ ᄏ ᅵ ᄌ ᅥ ᆷ ᄑ ᅳ
선수이다	ᄉ ᅥ ᆫ ᄉ ᅮ ᄋ ᅵ ᄃ ᅡ
효과로	ᄒ ᅭ ᄀ ᅪ ᄅ ᅩ
천문학	ᄎ ᅥ ᆫ ᄆ ᅮ ᆫ ᄒ ᅡ ᆨ
역사상	ᄋ ᅧ ᆨ ᄊ ᅡ ᄉ ᅡ ᆼ
많은	ᄆ ᅡ ᄂ ᅳ ᆫ
발견들이	ᄇ ᅡ ᆯ ᄀ ᅧ ᆫ ᄃ ᅳ ᄅ ᅵ
사실	ᄉ ᅡ ᄉ ᅵ ᆯ
잘못된	ᄌ ᅡ ᆯ ᄆ ᅩ ᆮ ᄄ ᅬ ᆫ
것이었음이	ᄀ ᅥ ᄉ ᅵ ᄋ ᅥ ᄊ ᅳ ᄆ ᅵ
밝혀졌다	ᄇ ᅡ ᆯ ᄏ ᅧ ᄌ ᅥ ᆮ ᄄ ᅡ
모낭	ᄆ ᅩ ᄂ ᅡ ᆼ
내에	ᄂ ᅢ ᄋ ᅦ
각질이	ᄀ ᅡ ᆨ ᄍ ᅵ ᄅ ᅵ
채워져	ᄎ ᅢ ᄋ ᅯ ᄌ ᅥ
있기	ᄋ ᅵ ᆮ ᄁ ᅵ
털은	ᄐ ᅥ ᄅ ᅳ ᆫ
각질	ᄀ ᅡ ᆨ ᄍ ᅵ ᆯ
박혀	ᄇ ᅡ ᄏ ᅧ
기름이	ᄀ ᅵ ᄅ ᅳ ᄆ ᅵ
적으면	ᄌ ᅥ ᄀ ᅳ ᄆ ᅧ ᆫ
재료가	ᄌ ᅢ ᄅ ᅭ ᄀ ᅡ
타기	ᄐ ᅡ ᄀ ᅵ
쉽고	ᄉ ᅱ ᆸ ᄁ ᅩ
많으면	ᄆ ᅡ ᄂ ᅳ ᄆ ᅧ ᆫ
음식이	ᄋ ᅳ ᆷ ᄉ ᅵ ᄀ ᅵ
깔끔하지	ᄁ ᅡ ᆯ ᄁ ᅳ ᆷ ᄒ ᅡ ᄌ ᅵ
주의해야	ᄌ ᅮ ᄋ ᅴ ᄒ ᅢ ᄋ ᅣ
물체를	ᄆ ᅮ ᆯ ᄎ ᅦ ᄅ ᅳ ᆯ
액체	ᄋ ᅢ ᆨ ᄎ ᅦ
넣으면	ᄂ ᅥ ᄋ ᅳ ᄆ ᅧ ᆫ
중력	ᄌ ᅮ ᆼ ᄂ ᅧ ᆨ
위로	ᄋ ᅱ ᄅ ᅩ
밀어	ᄆ ᅵ ᄅ ᅥ
올려	ᄋ ᅩ ᆯ ᄅ ᅧ
떠오르게	ᄄ ᅥ ᄋ ᅩ ᄅ ᅳ ᄀ ᅦ
평탄한	ᄑ ᅧ ᆼ ᄐ ᅡ ᆫ ᄒ ᅡ ᆫ
지형	ᄌ ᅵ ᄒ ᅧ ᆼ
갑문이	ᄀ ᅡ ᆷ ᄆ ᅮ ᄂ ᅵ
없으며	ᄋ ᅥ ᆸ ᄊ ᅳ ᄆ ᅧ
운하	ᄋ ᅮ ᆫ ᄒ ᅡ
끝의	ᄁ ᅳ ᄉ ᅴ
바닷물이	ᄇ ᅡ ᄃ ᅡ ᆫ ᄆ ᅮ ᄅ ᅵ
자유로이	ᄌ ᅡ ᄋ ᅲ ᄅ ᅩ ᄋ ᅵ
흘러들어	ᄒ ᅳ ᆯ ᄅ ᅥ ᄃ ᅳ ᄅ ᅥ
온다	ᄋ ᅩ ᆫ ᄃ ᅡ
밥솥	ᄇ ᅡ ᆸ ᄊ ᅩ ᆮ
바닥에	ᄇ ᅡ ᄃ ᅡ ᄀ ᅦ
눌어붙은	ᄂ ᅮ ᄅ ᅥ ᄇ ᅮ ᄐ ᅳ ᆫ
누룽지에	ᄂ ᅮ ᄅ ᅮ ᆼ ᄌ ᅵ ᄋ ᅦ
붓고	ᄇ ᅮ ᆮ ᄁ ᅩ
한소끔	ᄒ ᅡ ᆫ ᄉ ᅩ ᄁ ᅳ ᆷ
끓여	ᄁ ᅳ ᄅ ᅧ
내놓았다	ᄂ ᅢ ᄂ ᅩ ᄋ ᅡ ᆮ ᄄ ᅡ
액체와	ᄋ ᅢ ᆨ ᄎ ᅦ ᄋ ᅪ
고체가	ᄀ ᅩ ᄎ ᅦ ᄀ ᅡ
물질을	ᄆ ᅮ ᆯ ᄍ ᅵ ᄅ ᅳ ᆯ
입자의	ᄋ ᅵ ᆸ ᄍ ᅡ ᄋ ᅴ
크기	ᄏ ᅳ ᄀ ᅵ
차이를	ᄎ ᅡ ᄋ ᅵ ᄅ ᅳ ᆯ
이용해	ᄋ ᅵ ᄋ ᅭ ᆼ ᄒ ᅢ
분리한다	ᄇ ᅮ ᆯ ᄅ ᅵ ᄒ ᅡ ᆫ ᄃ ᅡ
피사체에	ᄑ ᅵ ᄉ ᅡ ᄎ ᅦ ᄋ ᅦ
초점을	ᄎ ᅩ ᄌ ᅥ ᄆ ᅳ ᆯ
자동으로	ᄌ ᅡ ᄃ ᅩ ᆼ ᄋ ᅳ ᄅ ᅩ
맞추는	ᄆ ᅡ ᆮ ᄎ ᅮ ᄂ ᅳ ᆫ
광학	ᄀ ᅪ ᆼ ᄒ ᅡ ᆨ
시스템의	ᄉ ᅵ ᄉ ᅳ ᄐ ᅦ ᄆ ᅴ
기능도	ᄀ ᅵ ᄂ ᅳ ᆼ ᄃ ᅩ
타인이	ᄐ ᅡ ᄋ ᅵ ᄂ ᅵ
잃어버린	ᄋ ᅵ ᄅ ᅥ ᄇ ᅥ ᄅ ᅵ ᆫ
돈을	ᄃ ᅩ ᄂ ᅳ ᆯ
주워서	ᄌ ᅮ ᄋ ᅯ ᄉ ᅥ
임의로	ᄋ ᅵ ᄆ ᅴ ᄅ ᅩ
처분했다면	ᄎ ᅥ ᄇ ᅮ ᆫ ᄒ ᅢ ᆮ ᄄ ᅡ ᄆ ᅧ ᆫ
범죄가	ᄇ ᅥ ᆷ ᄌ ᅬ ᄀ ᅡ
천구백사십사년	ᄎ ᅥ ᆫ ᄀ ᅮ ᄇ ᅢ ᆨ ᄊ ᅡ ᄉ ᅵ ᆸ ᄊ ᅡ ᄂ ᅧ ᆫ
여름까지	ᄋ ᅧ ᄅ ᅳ ᆷ ᄁ ᅡ ᄌ ᅵ
영국에서	ᄋ ᅧ ᆼ ᄀ ᅮ ᄀ ᅦ ᄉ ᅥ
받았으며	ᄇ ᅡ ᄃ ᅡ ᄊ ᅳ ᄆ ᅧ
병력은	ᄇ ᅧ ᆼ ᄂ ᅧ ᄀ ᅳ ᆫ
약	ᄋ ᅣ ᆨ
사천	ᄉ ᅡ ᄎ ᅥ ᆫ
명까지	ᄆ ᅧ ᆼ ᄁ ᅡ ᄌ ᅵ
늘어났다	ᄂ ᅳ ᄅ ᅥ ᄂ ᅡ ᆮ ᄄ ᅡ
메기는	ᄆ ᅦ ᄀ ᅵ ᄂ ᅳ ᆫ
움직이지	ᄋ ᅮ ᆷ ᄌ ᅵ ᄀ ᅵ ᄌ ᅵ
생활하는	ᄉ ᅢ ᆼ ᄒ ᅪ ᆯ ᄒ ᅡ ᄂ ᅳ ᆫ
흔치	ᄒ ᅳ ᆫ ᄎ ᅵ
어류입니다	ᄋ ᅥ ᄅ ᅲ ᄋ ᅵ ᆷ ᄂ ᅵ ᄃ ᅡ
그곳의	ᄀ ᅳ ᄀ ᅩ ᄉ ᅴ
아이들은	ᄋ ᅡ ᄋ ᅵ ᄃ ᅳ ᄅ ᅳ ᆫ
비석	ᄇ ᅵ ᄉ ᅥ ᆨ
돌을	ᄃ ᅩ ᄅ ᅳ ᆯ
세워	ᄉ ᅦ ᄋ ᅯ
놓고	ᄂ ᅩ ᄏ ᅩ
맞혀	ᄆ ᅡ ᄎ ᅧ
쓰러뜨리면서	ᄊ ᅳ ᄅ ᅥ ᄄ ᅳ ᄅ ᅵ ᄆ ᅧ ᆫ ᄉ ᅥ
놀고	ᄂ ᅩ ᆯ ᄀ ᅩ
있었다	ᄋ ᅵ ᄊ ᅥ ᆮ ᄄ ᅡ
마그마	ᄆ ᅡ ᄀ ᅳ ᄆ ᅡ
물질이	ᄆ ᅮ ᆯ ᄍ ᅵ ᄅ ᅵ
행성	ᄒ ᅢ ᆼ ᄉ ᅥ ᆼ
표면을	ᄑ ᅭ ᄆ ᅧ ᄂ ᅳ ᆯ
뚫고	ᄄ ᅮ ᆯ ᄏ ᅩ
분출하여	ᄇ ᅮ ᆫ ᄎ ᅮ ᆯ ᄒ ᅡ ᄋ ᅧ
꿀이나	ᄁ ᅮ ᄅ ᅵ ᄂ ᅡ
설탕에	ᄉ ᅥ ᆯ ᄐ ᅡ ᆼ ᄋ ᅦ
재운	ᄌ ᅢ ᄋ ᅮ ᆫ
오미자	ᄋ ᅩ ᄆ ᅵ ᄌ ᅡ
청과	ᄎ ᅥ ᆼ ᄀ ᅪ
과일	ᄀ ᅪ ᄋ ᅵ ᆯ
꽃잎이나	ᄁ ᅩ ᆫ ᄂ ᅵ ᄇ ᅵ ᄂ ᅡ
실백을	ᄉ ᅵ ᆯ ᄇ ᅢ ᄀ ᅳ ᆯ
띄워	ᄄ ᅵ ᄋ ᅯ
곁들여	ᄀ ᅧ ᆮ ᄄ ᅳ ᄅ ᅧ
마시는	ᄆ ᅡ ᄉ ᅵ ᄂ ᅳ ᆫ
추천합니다	ᄎ ᅮ ᄎ ᅥ ᆫ ᄒ ᅡ ᆷ ᄂ ᅵ ᄃ ᅡ
스트레스를	ᄉ ᅳ ᄐ ᅳ ᄅ ᅦ ᄉ ᅳ ᄅ ᅳ ᆯ
그때그때	ᄀ ᅳ ᄄ ᅢ ᄀ ᅳ ᄄ ᅢ
불쾌감	ᄇ ᅮ ᆯ ᄏ ᅫ ᄀ ᅡ ᆷ
짜증이	ᄍ ᅡ ᄌ ᅳ ᆼ ᄋ ᅵ
생기면서	ᄉ ᅢ ᆼ ᄀ ᅵ ᄆ ᅧ ᆫ ᄉ ᅥ
긍정적인	ᄀ ᅳ ᆼ ᄌ ᅥ ᆼ ᄌ ᅥ ᄀ ᅵ ᆫ
하기	ᄒ ᅡ ᄀ ᅵ
어려워진다	ᄋ ᅥ ᄅ ᅧ ᄋ ᅯ ᄌ ᅵ ᆫ ᄃ ᅡ
화폐가	ᄒ ᅪ ᄑ ᅨ ᄀ ᅡ
각자	ᄀ ᅡ ᆨ ᄍ ᅡ
가지고	ᄀ ᅡ ᄌ ᅵ ᄀ ᅩ
서로	ᄉ ᅥ ᄅ ᅩ
교환하여	ᄀ ᅭ ᄒ ᅪ ᆫ ᄒ ᅡ ᄋ ᅧ
거래하였다	ᄀ ᅥ ᄅ ᅢ ᄒ ᅡ ᄋ ᅧ ᆮ ᄄ ᅡ
야생화는	ᄋ ᅣ ᄉ ᅢ ᆼ ᄒ ᅪ ᄂ ᅳ ᆫ
호주가	ᄒ ᅩ ᄌ ᅮ ᄀ ᅡ
원산이며	ᄋ ᅯ ᆫ ᄉ ᅡ ᄂ ᅵ ᄆ ᅧ
특이한	ᄐ ᅳ ᄀ ᅵ ᄒ ᅡ ᆫ
꽃과	ᄁ ᅩ ᆮ ᄁ ᅪ
열매	ᄋ ᅧ ᆯ ᄆ ᅢ
원예	ᄋ ᅯ ᄂ ᅨ
식물로	ᄉ ᅵ ᆼ ᄆ ᅮ ᆯ ᄅ ᅩ
인기가	ᄋ ᅵ ᆫ ᄀ ᅵ ᄀ ᅡ
많습니다	ᄆ ᅡ ᆫ ᄊ ᅳ ᆷ ᄂ ᅵ ᄃ ᅡ
물이	ᄆ ᅮ ᄅ ᅵ
서식하며	ᄉ ᅥ ᄉ ᅵ ᄏ ᅡ ᄆ ᅧ
밤에는	ᄇ ᅡ ᄆ ᅦ ᄂ ᅳ ᆫ
물고기나	ᄆ ᅮ ᆯ ᄀ ᅩ ᄀ ᅵ ᄂ ᅡ
수생곤충	ᄉ ᅮ ᄉ ᅢ ᆼ ᄀ ᅩ ᆫ ᄎ ᅮ ᆼ
등을	ᄃ ᅳ ᆼ ᄋ ᅳ ᆯ
잡아먹습니다	ᄌ ᅡ ᄇ ᅡ ᄆ ᅥ ᆨ ᄊ ᅳ ᆷ ᄂ ᅵ ᄃ ᅡ
무거운	ᄆ ᅮ ᄀ ᅥ ᄋ ᅮ ᆫ
화물을	ᄒ ᅪ ᄆ ᅮ ᄅ ᅳ ᆯ
궤도로	ᄀ ᅰ ᄃ ᅩ ᄅ ᅩ
올리는	ᄋ ᅩ ᆯ ᄅ ᅵ ᄂ ᅳ ᆫ
것은	ᄀ ᅥ ᄉ ᅳ ᆫ
어렵고	ᄋ ᅥ ᄅ ᅧ ᆸ ᄁ ᅩ
비용이	ᄇ ᅵ ᄋ ᅭ ᆼ ᄋ ᅵ
듭니다	ᄃ ᅳ ᆷ ᄂ ᅵ ᄃ ᅡ
선발	ᄉ ᅥ ᆫ ᄇ ᅡ ᆯ
투수가	ᄐ ᅮ ᄉ ᅮ ᄀ ᅡ
승리투수가	ᄉ ᅳ ᆼ ᄂ ᅵ ᄐ ᅮ ᄉ ᅮ ᄀ ᅡ
되는	ᄃ ᅬ ᄂ ᅳ ᆫ
요건은	ᄋ ᅭ ᄀ ᅥ ᄂ ᅳ ᆫ
오이닝	ᄋ ᅩ ᄋ ᅵ ᄂ ᅵ ᆼ
이상	ᄋ ᅵ ᄉ ᅡ ᆼ
투구해야	ᄐ ᅮ ᄀ ᅮ ᄒ ᅢ ᄋ ᅣ
구매자가	ᄀ ᅮ ᄆ ᅢ ᄌ ᅡ ᄀ ᅡ
장물임을	ᄌ ᅡ ᆼ ᄆ ᅮ ᄅ ᅵ ᄆ ᅳ ᆯ
샀을	ᄉ ᅡ ᄊ ᅳ ᆯ
경우에는	ᄀ ᅧ ᆼ ᄋ ᅮ ᄋ ᅦ ᄂ ᅳ ᆫ
적용되며	ᄌ ᅥ ᄀ ᅭ ᆼ ᄃ ᅬ ᄆ ᅧ
물건은	ᄆ ᅮ ᆯ ᄀ ᅥ ᄂ ᅳ ᆫ
원소유자에게	ᄋ ᅯ ᆫ ᄉ ᅩ ᄋ ᅲ ᄌ ᅡ ᄋ ᅦ ᄀ ᅦ
귀속된다	ᄀ ᅱ ᄉ ᅩ ᆨ ᄄ ᅬ ᆫ ᄃ ᅡ
관이	ᄀ ᅪ ᄂ ᅵ
달려	ᄃ ᅡ ᆯ ᄅ ᅧ
있고	ᄋ ᅵ ᆮ ᄁ ᅩ
바람을	ᄇ ᅡ ᄅ ᅡ ᄆ ᅳ ᆯ
넣을	ᄂ ᅥ ᄋ ᅳ ᆯ
있도록	ᄋ ᅵ ᆮ ᄄ ᅩ ᄅ ᅩ ᆨ
풀무가	ᄑ ᅮ ᆯ ᄆ ᅮ ᄀ ᅡ
정보를	ᄌ ᅥ ᆼ ᄇ ᅩ ᄅ ᅳ ᆯ
주지	ᄌ ᅮ ᄌ ᅵ
않으려는	ᄋ ᅡ ᄂ ᅳ ᄅ ᅧ ᄂ ᅳ ᆫ
러시아와	ᄅ ᅥ ᄉ ᅵ ᄋ ᅡ ᄋ ᅪ
입수하려는	ᄋ ᅵ ᆸ ᄊ ᅮ ᄒ ᅡ ᄅ ᅧ ᄂ ᅳ ᆫ
한국의	ᄒ ᅡ ᆫ ᄀ ᅮ ᄀ ᅴ
치열한	ᄎ ᅵ ᄋ ᅧ ᆯ ᄒ ᅡ ᆫ
기	ᄀ ᅵ
싸움이	ᄊ ᅡ ᄋ ᅮ ᄆ ᅵ
벌어졌다	ᄇ ᅥ ᄅ ᅥ ᄌ ᅥ ᆮ ᄄ ᅡ
일반적으로	ᄋ ᅵ ᆯ ᄇ ᅡ ᆫ ᄌ ᅥ ᄀ ᅳ ᄅ ᅩ
색온도가	ᄉ ᅢ ᄀ ᅩ ᆫ ᄃ ᅩ ᄀ ᅡ
높을수록	ᄂ ᅩ ᄑ ᅳ ᆯ ᄊ ᅮ ᄅ ᅩ ᆨ
집중력이	ᄌ ᅵ ᆸ ᄍ ᅮ ᆼ ᄂ ᅧ ᄀ ᅵ
상승하며	ᄉ ᅡ ᆼ ᄉ ᅳ ᆼ ᄒ ᅡ ᄆ ᅧ
낮을수록	ᄂ ᅡ ᄌ ᅳ ᆯ ᄊ ᅮ ᄅ ᅩ ᆨ
피로도가	ᄑ ᅵ ᄅ ᅩ ᄃ ᅩ ᄀ ᅡ
감소한다	ᄀ ᅡ ᆷ ᄉ ᅩ ᄒ ᅡ ᆫ ᄃ ᅡ
두꺼운	ᄃ ᅮ ᄁ ᅥ ᄋ ᅮ ᆫ
유리로	ᄋ ᅲ ᄅ ᅵ ᄅ ᅩ
세균을	ᄉ ᅦ ᄀ ᅲ ᄂ ᅳ ᆯ
배양하여	ᄇ ᅢ ᄋ ᅣ ᆼ ᄒ ᅡ ᄋ ᅧ
관찰하는	ᄀ ᅪ ᆫ ᄎ ᅡ ᆯ ᄒ ᅡ ᄂ ᅳ ᆫ
사용됩니다	ᄉ ᅡ ᄋ ᅭ ᆼ ᄃ ᅬ ᆷ ᄂ ᅵ ᄃ ᅡ
젊은	ᄌ ᅥ ᆯ ᄆ ᅳ ᆫ
여성을	ᄋ ᅧ ᄉ ᅥ ᆼ ᄋ ᅳ ᆯ
골라	ᄀ ᅩ ᆯ ᄅ ᅡ
하얀색	ᄒ ᅡ ᄋ ᅣ ᆫ ᄉ ᅢ ᆨ
옷을	ᄋ ᅩ ᄉ ᅳ ᆯ
입히고	ᄋ ᅵ ᄑ ᅵ ᄀ ᅩ
피를	ᄑ ᅵ ᄅ ᅳ ᆯ
붉은	ᄇ ᅮ ᆯ ᄀ ᅳ ᆫ
허리띠를	ᄒ ᅥ ᄅ ᅵ ᄄ ᅵ ᄅ ᅳ ᆯ
두르게	ᄃ ᅮ ᄅ ᅳ ᄀ ᅦ
하였다	ᄒ ᅡ ᄋ ᅧ ᆮ ᄄ ᅡ
성능만이	ᄉ ᅥ ᆼ ᄂ ᅳ ᆼ ᄆ ᅡ ᄂ ᅵ
슈퍼카라	ᄉ ᅲ ᄑ ᅥ ᄏ ᅡ ᄅ ᅡ
부를	ᄇ ᅮ ᄅ ᅳ ᆯ
차의	ᄎ ᅡ ᄋ ᅴ
인지도라든지	ᄋ ᅵ ᆫ ᄌ ᅵ ᄃ ᅩ ᄅ ᅡ ᄃ ᅳ ᆫ ᄌ ᅵ
브랜드	ᄇ ᅳ ᄅ ᅢ ᆫ ᄃ ᅳ
가치를	ᄀ ᅡ ᄎ ᅵ ᄅ ᅳ ᆯ
중요시	ᄌ ᅮ ᆼ ᄋ ᅭ ᄉ ᅵ
윈도	ᄋ ᅱ ᆫ ᄃ ᅩ
비스타부터	ᄇ ᅵ ᄉ ᅳ ᄐ ᅡ ᄇ ᅮ ᄐ ᅥ
화려한	ᄒ ᅪ ᄅ ᅧ ᄒ ᅡ ᆫ
그래픽	ᄀ ᅳ ᄅ ᅢ ᄑ ᅵ ᆨ
효과가	ᄒ ᅭ ᄀ ᅪ ᄀ ᅡ
추가되어	ᄎ ᅮ ᄀ ᅡ ᄃ ᅬ ᄋ ᅥ
화려하게	ᄒ ᅪ ᄅ ᅧ ᄒ ᅡ ᄀ ᅦ
이슬람의	ᄋ ᅵ ᄉ ᅳ ᆯ ᄅ ᅡ ᄆ ᅴ
숙원사업을	ᄉ ᅮ ᄀ ᅯ ᆫ ᄉ ᅡ ᄋ ᅥ ᄇ ᅳ ᆯ
재빠르게	ᄌ ᅢ ᄈ ᅡ ᄅ ᅳ ᄀ ᅦ
자신의	ᄌ ᅡ ᄉ ᅵ ᄂ ᅴ
이룩하고	ᄋ ᅵ ᄅ ᅮ ᄏ ᅡ ᄀ ᅩ
싶었기	ᄉ ᅵ ᄑ ᅥ ᆮ ᄁ ᅵ
욕실에서	ᄋ ᅭ ᆨ ᄊ ᅵ ᄅ ᅦ ᄉ ᅥ
미끄러져	ᄆ ᅵ ᄁ ᅳ ᄅ ᅥ ᄌ ᅥ
머리를	ᄆ ᅥ ᄅ ᅵ ᄅ ᅳ ᆯ
다치면서	ᄃ ᅡ ᄎ ᅵ ᄆ ᅧ ᆫ ᄉ ᅥ
급사하였습니다	ᄀ ᅳ ᆸ ᄊ ᅡ ᄒ ᅡ ᄋ ᅧ ᆮ ᄊ ᅳ ᆷ ᄂ ᅵ ᄃ ᅡ
술탄의	ᄉ ᅮ ᆯ ᄐ ᅡ ᄂ ᅴ
외우게	ᄋ ᅬ ᄋ ᅮ ᄀ ᅦ
난처한	ᄂ ᅡ ᆫ ᄎ ᅥ ᄒ ᅡ ᆫ
일이어서	ᄋ ᅵ ᄅ ᅵ ᄋ ᅥ ᄉ ᅥ
거두어	ᄀ ᅥ ᄃ ᅮ ᄋ ᅥ
달라고	ᄃ ᅡ ᆯ ᄅ ᅡ ᄀ ᅩ
간청하였습니다	ᄀ ᅡ ᆫ ᄎ ᅥ ᆼ ᄒ ᅡ ᄋ ᅧ ᆮ ᄊ ᅳ ᆷ ᄂ ᅵ ᄃ ᅡ
좀처럼	ᄌ ᅩ ᆷ ᄎ ᅥ ᄅ ᅥ ᆷ
만족하지	ᄆ ᅡ ᆫ ᄌ ᅩ ᄏ ᅡ ᄌ ᅵ
못했고	ᄆ ᅩ ᄐ ᅢ ᆮ ᄁ ᅩ
권력을	ᄀ ᅯ ᆯ ᄅ ᅧ ᄀ ᅳ ᆯ
얻기	ᄋ ᅥ ᆮ ᄁ ᅵ
음모를	ᄋ ᅳ ᆷ ᄆ ᅩ ᄅ ᅳ ᆯ
꾸미고	ᄁ ᅮ ᄆ ᅵ ᄀ ᅩ
형태로	ᄒ ᅧ ᆼ ᄐ ᅢ ᄅ ᅩ
마실	ᄆ ᅡ ᄉ ᅵ ᆯ
먹습니다	ᄆ ᅥ ᆨ ᄊ ᅳ ᆷ ᄂ ᅵ ᄃ ᅡ
괜히	ᄀ ᅫ ᆫ ᄒ ᅵ
안주	ᄋ ᅡ ᆫ ᄌ ᅮ
마시게	ᄆ ᅡ ᄉ ᅵ ᄀ ᅦ
취하게	ᄎ ᅱ ᄒ ᅡ ᄀ ᅦ
되므로	ᄃ ᅬ ᄆ ᅳ ᄅ ᅩ
쇠고기는	ᄉ ᅬ ᄀ ᅩ ᄀ ᅵ ᄂ ᅳ ᆫ
쉽게	ᄉ ᅱ ᆸ ᄁ ᅦ
질겨져	ᄌ ᅵ ᆯ ᄀ ᅧ ᄌ ᅥ
일반적으론	ᄋ ᅵ ᆯ ᄇ ᅡ ᆫ ᄌ ᅥ ᄀ ᅳ ᄅ ᅩ ᆫ
사용하지	ᄉ ᅡ ᄋ ᅭ ᆼ ᄒ ᅡ ᄌ ᅵ
않는다	ᄋ ᅡ ᆫ ᄂ ᅳ ᆫ ᄃ ᅡ
김치는	ᄀ ᅵ ᆷ ᄎ ᅵ ᄂ ᅳ ᆫ
높은	ᄂ ᅩ ᄑ ᅳ ᆫ
온도로	ᄋ ᅩ ᆫ ᄃ ᅩ ᄅ ᅩ
끓일	ᄁ ᅳ ᄅ ᅵ ᆯ
유산균이	ᄋ ᅲ ᄉ ᅡ ᆫ ᄀ ᅲ ᄂ ᅵ
파괴되므로	ᄑ ᅡ ᄀ ᅬ ᄃ ᅬ ᄆ ᅳ ᄅ ᅩ
조리하지	ᄌ ᅩ ᄅ ᅵ ᄒ ᅡ ᄌ ᅵ
몸에	ᄆ ᅩ ᄆ ᅦ
볶을	ᄇ ᅩ ᄁ ᅳ ᆯ
사용되는	ᄉ ᅡ ᄋ ᅭ ᆼ ᄃ ᅬ ᄂ ᅳ ᆫ
기름	ᄀ ᅵ ᄅ ᅳ ᆷ
지방	ᄌ ᅵ ᄇ ᅡ ᆼ
함량도	ᄒ ᅡ ᆷ ᄂ ᅣ ᆼ ᄃ ᅩ
편입니다	ᄑ ᅧ ᄂ ᅵ ᆷ ᄂ ᅵ ᄃ ᅡ
생산권	ᄉ ᅢ ᆼ ᄉ ᅡ ᆫ ᄀ ᅯ ᆫ
확보와	ᄒ ᅪ ᆨ ᄈ ᅩ ᄋ ᅪ
유통을	ᄋ ᅲ ᄐ ᅩ ᆼ ᄋ ᅳ ᆯ
장악하기	ᄌ ᅡ ᆼ ᄋ ᅡ ᄏ ᅡ ᄀ ᅵ
온갖	ᄋ ᅩ ᆫ ᄀ ᅡ ᆮ
지혜를	ᄌ ᅵ ᄒ ᅨ ᄅ ᅳ ᆯ
짜내느라	ᄍ ᅡ ᄂ ᅢ ᄂ ᅳ ᄅ ᅡ
고심했다	ᄀ ᅩ ᄉ ᅵ ᆷ ᄒ ᅢ ᆮ ᄄ ᅡ
처음에는	ᄎ ᅥ ᄋ ᅳ ᄆ ᅦ ᄂ ᅳ ᆫ
많지도	ᄆ ᅡ ᆫ ᄎ ᅵ ᄃ ᅩ
싸지도	ᄊ ᅡ ᄌ ᅵ ᄃ ᅩ
않아서	ᄋ ᅡ ᄂ ᅡ ᄉ ᅥ
세계	ᄉ ᅦ ᄀ ᅨ
곳에서는	ᄀ ᅩ ᄉ ᅦ ᄉ ᅥ ᄂ ᅳ ᆫ
꿀을	ᄁ ᅮ ᄅ ᅳ ᆯ
애용하였다	ᄋ ᅢ ᄋ ᅭ ᆼ ᄒ ᅡ ᄋ ᅧ ᆮ ᄄ ᅡ
수많은	ᄉ ᅮ ᄆ ᅡ ᄂ ᅳ ᆫ
초기	ᄎ ᅩ ᄀ ᅵ
사회들은	ᄉ ᅡ ᄒ ᅬ ᄃ ᅳ ᄅ ᅳ ᆫ
신들이	ᄉ ᅵ ᆫ ᄃ ᅳ ᄅ ᅵ
내려준	ᄂ ᅢ ᄅ ᅧ ᄌ ᅮ ᆫ
생각하였다	ᄉ ᅢ ᆼ ᄀ ᅡ ᄏ ᅡ ᄋ ᅧ ᆮ ᄄ ᅡ
빠져나오는	ᄈ ᅡ ᄌ ᅥ ᄂ ᅡ ᄋ ᅩ ᄂ ᅳ ᆫ
탈수	ᄐ ᅡ ᆯ ᄉ ᅮ
반응이	ᄇ ᅡ ᄂ ᅳ ᆼ ᄋ ᅵ
진행되어	ᄌ ᅵ ᆫ ᄒ ᅢ ᆼ ᄃ ᅬ ᄋ ᅥ
미라가	ᄆ ᅵ ᄅ ᅡ ᄀ ᅡ
구소련이	ᄀ ᅮ ᄉ ᅩ ᄅ ᅧ ᄂ ᅵ
해체될	ᄒ ᅢ ᄎ ᅦ ᄃ ᅬ ᆯ
공화국	ᄀ ᅩ ᆼ ᄒ ᅪ ᄀ ᅮ ᆨ
경계대로	ᄀ ᅧ ᆼ ᄀ ᅨ ᄃ ᅢ ᄅ ᅩ
신생	ᄉ ᅵ ᆫ ᄉ ᅢ ᆼ
주권	ᄌ ᅮ ᄀ ᅯ ᆫ
국가들이	ᄀ ᅮ ᆨ ᄁ ᅡ ᄃ ᅳ ᄅ ᅵ
출범하였다	ᄎ ᅮ ᆯ ᄇ ᅥ ᆷ ᄒ ᅡ ᄋ ᅧ ᆮ ᄄ ᅡ
검색을	ᄀ ᅥ ᆷ ᄉ ᅢ ᄀ ᅳ ᆯ
때도	ᄄ ᅢ ᄃ ᅩ
넣어야	ᄂ ᅥ ᄋ ᅥ ᄋ ᅣ
하며	ᄒ ᅡ ᄆ ᅧ
결과	ᄀ ᅧ ᆯ ᄀ ᅪ
글자가	ᄀ ᅳ ᆯ ᄌ ᅡ ᄀ ᅡ
배열된다	ᄇ ᅢ ᄋ ᅧ ᆯ ᄃ ᅬ ᆫ ᄃ ᅡ
과학자들이	ᄀ ᅪ ᄒ ᅡ ᆨ ᄍ ᅡ ᄃ ᅳ ᄅ ᅵ
유전자	ᄋ ᅲ ᄌ ᅥ ᆫ ᄌ ᅡ
조작을	ᄌ ᅩ ᄌ ᅡ ᄀ ᅳ ᆯ
배아를	ᄇ ᅢ ᄋ ᅡ ᄅ ᅳ ᆯ
만들었다고	ᄆ ᅡ ᆫ ᄃ ᅳ ᄅ ᅥ ᆮ ᄄ ᅡ ᄀ ᅩ
발표했다	ᄇ ᅡ ᆯ ᄑ ᅭ ᄒ ᅢ ᆮ ᄄ ᅡ
그녀는	ᄀ ᅳ ᄂ ᅧ ᄂ ᅳ ᆫ
정신을	ᄌ ᅥ ᆼ ᄉ ᅵ ᄂ ᅳ ᆯ
바짝	ᄇ ᅡ ᄍ ᅡ ᆨ
차리고	ᄎ ᅡ ᄅ ᅵ ᄀ ᅩ
조작이라고	ᄌ ᅩ ᄌ ᅡ ᄀ ᅵ ᄅ ᅡ ᄀ ᅩ
이야기하라고	ᄋ ᅵ ᄋ ᅣ ᄀ ᅵ ᄒ ᅡ ᄅ ᅡ ᄀ ᅩ
지시했다	ᄌ ᅵ ᄉ ᅵ ᄒ ᅢ ᆮ ᄄ ᅡ
조작하는	ᄌ ᅩ ᄌ ᅡ ᄏ ᅡ ᄂ ᅳ ᆫ
발생할	ᄇ ᅡ ᆯ ᄉ ᅢ ᆼ ᄒ ᅡ ᆯ
상황을	ᄉ ᅡ ᆼ ᄒ ᅪ ᆼ ᄋ ᅳ ᆯ
설명해	ᄉ ᅥ ᆯ ᄆ ᅧ ᆼ ᄒ ᅢ
놓았다	ᄂ ᅩ ᄋ ᅡ ᆮ ᄄ ᅡ
스토리의	ᄉ ᅳ ᄐ ᅩ ᄅ ᅵ ᄋ ᅴ
흐름과는	ᄒ ᅳ ᄅ ᅳ ᆷ ᄀ ᅪ ᄂ ᅳ ᆫ
연관성이	ᄋ ᅧ ᆫ ᄀ ᅪ ᆫ ᄉ ᅥ ᆼ ᄋ ᅵ
보였다	ᄇ ᅩ ᄋ ᅧ ᆮ ᄄ ᅡ
스무	ᄉ ᅳ ᄆ ᅮ
한기만	ᄒ ᅡ ᆫ ᄀ ᅵ ᄆ ᅡ ᆫ
일에서	ᄋ ᅵ ᄅ ᅦ ᄉ ᅥ
이주일간	ᄋ ᅵ ᄌ ᅮ ᄋ ᅵ ᆯ ᄀ ᅡ ᆫ
강한	ᄀ ᅡ ᆼ ᄒ ᅡ ᆫ
윈도우	ᄋ ᅱ ᆫ ᄃ ᅩ ᄋ ᅮ
곳에서	ᄀ ᅩ ᄉ ᅦ ᄉ ᅥ
