심폐소생술	ᄉ ᅵ ᆷ ᄑ ᅨ ᄉ ᅩ ᄉ ᅢ ᆼ ᄉ ᅮ ᆯ
자격증	ᄌ ᅡ ᄀ ᅧ ᆨ ᄍ ᅳ ᆼ
취득을	ᄎ ᅱ ᄃ ᅳ ᄀ ᅳ ᆯ
원하시면	ᄋ ᅯ ᆫ ᄒ ᅡ ᄉ ᅵ ᄆ ᅧ ᆫ
인터넷으로	ᄋ ᅵ ᆫ ᄐ ᅥ ᄂ ᅦ ᄉ ᅳ ᄅ ᅩ
신청해	ᄉ ᅵ ᆫ ᄎ ᅥ ᆼ ᄒ ᅢ
주세요	ᄌ ᅮ ᄉ ᅦ ᄋ ᅭ
주연	ᄌ ᅮ ᄋ ᅧ ᆫ
배우	ᄇ ᅢ ᄋ ᅮ
캐스팅이	ᄏ ᅢ ᄉ ᅳ ᄐ ᅵ ᆼ ᄋ ᅵ
마무리되는	ᄆ ᅡ ᄆ ᅮ ᄅ ᅵ ᄃ ᅬ ᄂ ᅳ ᆫ
대로	ᄃ ᅢ ᄅ ᅩ
촬영을	ᄎ ᅪ ᄅ ᅧ ᆼ ᄋ ᅳ ᆯ
시작할	ᄉ ᅵ ᄌ ᅡ ᄏ ᅡ ᆯ
거래	ᄀ ᅥ ᄅ ᅢ
드라마	ᄃ ᅳ ᄅ ᅡ ᄆ ᅡ
관계자	ᄀ ᅪ ᆫ ᄀ ᅨ ᄌ ᅡ
분들은	ᄇ ᅮ ᆫ ᄃ ᅳ ᄅ ᅳ ᆫ
모두	ᄆ ᅩ ᄃ ᅮ
회의실로	ᄒ ᅬ ᄋ ᅴ ᄉ ᅵ ᆯ ᄅ ᅩ
들어와	ᄃ ᅳ ᄅ ᅥ ᄋ ᅪ
주십시오	ᄌ ᅮ ᄉ ᅵ ᆸ ᄊ ᅵ ᄋ ᅩ
현재	ᄒ ᅧ ᆫ ᄌ ᅢ
본	ᄇ ᅩ ᆫ
사건과	ᄉ ᅡ ᄀ ᅥ ᆫ ᄀ ᅪ
관련하여	ᄀ ᅪ ᆯ ᄅ ᅧ ᆫ ᄒ ᅡ ᄋ ᅧ
내부	ᄂ ᅢ ᄇ ᅮ
감사를	ᄀ ᅡ ᆷ ᄉ ᅡ ᄅ ᅳ ᆯ
진행하고	ᄌ ᅵ ᆫ ᄒ ᅢ ᆼ ᄒ ᅡ ᄀ ᅩ
있습니다	ᄋ ᅵ ᆮ ᄊ ᅳ ᆷ ᄂ ᅵ ᄃ ᅡ
불국사와	ᄇ ᅮ ᆯ ᄀ ᅮ ᆨ ᄊ ᅡ ᄋ ᅪ
석굴암은	ᄉ ᅥ ᆨ ᄁ ᅮ ᄅ ᅡ ᄆ ᅳ ᆫ
유네스코	ᄋ ᅲ ᄂ ᅦ ᄉ ᅳ ᄏ ᅩ
세계문화유산으로	ᄉ ᅦ ᄀ ᅨ ᄆ ᅮ ᆫ ᄒ ᅪ ᄋ ᅲ ᄉ ᅡ ᄂ ᅳ ᄅ ᅩ
등재되어	ᄃ ᅳ ᆼ ᄌ ᅢ ᄃ ᅬ ᄋ ᅥ
있어	ᄋ ᅵ ᄊ ᅥ
우정을	ᄋ ᅮ ᄌ ᅥ ᆼ ᄋ ᅳ ᆯ
진화심리학의	ᄌ ᅵ ᆫ ᄒ ᅪ ᄉ ᅵ ᆷ ᄂ ᅵ ᄒ ᅡ ᄀ ᅴ
관점에서	ᄀ ᅪ ᆫ ᄌ ᅥ ᄆ ᅦ ᄉ ᅥ
분석하려는	ᄇ ᅮ ᆫ ᄉ ᅥ ᄏ ᅡ ᄅ ᅧ ᄂ ᅳ ᆫ
시도가	ᄉ ᅵ ᄃ ᅩ ᄀ ᅡ
있었습니다	ᄋ ᅵ ᄊ ᅥ ᆮ ᄊ ᅳ ᆷ ᄂ ᅵ ᄃ ᅡ
죄송하지만	ᄌ ᅬ ᄉ ᅩ ᆼ ᄒ ᅡ ᄌ ᅵ ᄆ ᅡ ᆫ
여기서	ᄋ ᅧ ᄀ ᅵ ᄉ ᅥ
가장	ᄀ ᅡ ᄌ ᅡ ᆼ
가까운	ᄀ ᅡ ᄁ ᅡ ᄋ ᅮ ᆫ
버스	ᄇ ᅥ ᄉ ᅳ
정류장이	ᄌ ᅥ ᆼ ᄂ ᅲ ᄌ ᅡ ᆼ ᄋ ᅵ
어디에	ᄋ ᅥ ᄃ ᅵ ᄋ ᅦ
있습니까	ᄋ ᅵ ᆮ ᄊ ᅳ ᆷ ᄂ ᅵ ᄁ ᅡ
소설	ᄉ ᅩ ᄉ ᅥ ᆯ
백경의	ᄇ ᅢ ᆨ ᄁ ᅧ ᆼ ᄋ ᅴ
주인공으로	ᄌ ᅮ ᄋ ᅵ ᆫ ᄀ ᅩ ᆼ ᄋ ᅳ ᄅ ᅩ
나왔던	ᄂ ᅡ ᄋ ᅪ ᆮ ᄄ ᅥ ᆫ
향유고래의	ᄒ ᅣ ᆼ ᄋ ᅲ ᄀ ᅩ ᄅ ᅢ ᄋ ᅴ
몸무게는	ᄆ ᅩ ᆷ ᄆ ᅮ ᄀ ᅦ ᄂ ᅳ ᆫ
수십	ᄉ ᅮ ᄉ ᅵ ᆸ
톤에	ᄐ ᅩ ᄂ ᅦ
달합니다	ᄃ ᅡ ᆯ ᄒ ᅡ ᆷ ᄂ ᅵ ᄃ ᅡ
지구	ᄌ ᅵ ᄀ ᅮ
온난화로	ᄋ ᅩ ᆫ ᄂ ᅡ ᆫ ᄒ ᅪ ᄅ ᅩ
인해	ᄋ ᅵ ᆫ ᄒ ᅢ
나타나는	ᄂ ᅡ ᄐ ᅡ ᄂ ᅡ ᄂ ᅳ ᆫ
현상들을	ᄒ ᅧ ᆫ ᄉ ᅡ ᆼ ᄃ ᅳ ᄅ ᅳ ᆯ
잘	ᄌ ᅡ ᆯ
정리해	ᄌ ᅥ ᆼ ᄂ ᅵ ᄒ ᅢ
보세요	ᄇ ᅩ ᄉ ᅦ ᄋ ᅭ
국립중앙박물관의	ᄀ ᅮ ᆼ ᄂ ᅵ ᆸ ᄍ ᅮ ᆼ ᄋ ᅡ ᆼ ᄇ ᅡ ᆼ ᄆ ᅮ ᆯ ᄀ ᅪ ᄂ ᅴ
개관	ᄀ ᅢ ᄀ ᅪ ᆫ
시간은	ᄉ ᅵ ᄀ ᅡ ᄂ ᅳ ᆫ
오전	ᄋ ᅩ ᄌ ᅥ ᆫ
열	ᄋ ᅧ ᆯ
시입니다	ᄉ ᅵ ᄋ ᅵ ᆷ ᄂ ᅵ ᄃ ᅡ
세종문화회관에서	ᄉ ᅦ ᄌ ᅩ ᆼ ᄆ ᅮ ᆫ ᄒ ᅪ ᄒ ᅬ ᄀ ᅪ ᄂ ᅦ ᄉ ᅥ
사진전이	ᄉ ᅡ ᄌ ᅵ ᆫ ᄌ ᅥ ᄂ ᅵ
있다는데	ᄋ ᅵ ᆮ ᄄ ᅡ ᄂ ᅳ ᆫ ᄃ ᅦ
같이	ᄀ ᅡ ᄎ ᅵ
가볼래	ᄀ ᅡ ᄇ ᅩ ᆯ ᄅ ᅢ
오월은	ᄋ ᅩ ᄋ ᅯ ᄅ ᅳ ᆫ
가정의	ᄀ ᅡ ᄌ ᅥ ᆼ ᄋ ᅴ
달이라	ᄃ ᅡ ᄅ ᅵ ᄅ ᅡ
특별	ᄐ ᅳ ᆨ ᄈ ᅧ ᆯ
공연이	ᄀ ᅩ ᆼ ᄋ ᅧ ᄂ ᅵ
많이	ᄆ ᅡ ᄂ ᅵ
계획되어	ᄀ ᅨ ᄒ ᅬ ᆨ ᄄ ᅬ ᄋ ᅥ
있대	ᄋ ᅵ ᆮ ᄄ ᅢ
오늘	ᄋ ᅩ ᄂ ᅳ ᆯ
오후에	ᄋ ᅩ ᄒ ᅮ ᄋ ᅦ
비가	ᄇ ᅵ ᄀ ᅡ
온다고	ᄋ ᅩ ᆫ ᄃ ᅡ ᄀ ᅩ
하니까	ᄒ ᅡ ᄂ ᅵ ᄁ ᅡ
우산을	ᄋ ᅮ ᄉ ᅡ ᄂ ᅳ ᆯ
꼭	ᄁ ᅩ ᆨ
챙겨	ᄎ ᅢ ᆼ ᄀ ᅧ
불규칙한	ᄇ ᅮ ᆯ ᄀ ᅲ ᄎ ᅵ ᄏ ᅡ ᆫ
식사	ᄉ ᅵ ᆨ ᄊ ᅡ
습관과	ᄉ ᅳ ᆸ ᄁ ᅪ ᆫ ᄀ ᅪ
과식은	ᄀ ᅪ ᄉ ᅵ ᄀ ᅳ ᆫ
소화	ᄉ ᅩ ᄒ ᅪ
불량의	ᄇ ᅮ ᆯ ᄅ ᅣ ᆼ ᄋ ᅴ
원인이	ᄋ ᅯ ᄂ ᅵ ᄂ ᅵ
돼	ᄃ ᅫ
그	ᄀ ᅳ
문제는	ᄆ ᅮ ᆫ ᄌ ᅦ ᄂ ᅳ ᆫ
중앙선거관리위원회에	ᄌ ᅮ ᆼ ᄋ ᅡ ᆼ ᄉ ᅥ ᆫ ᄀ ᅥ ᄀ ᅪ ᆯ ᄅ ᅵ ᄋ ᅱ ᄋ ᅯ ᆫ ᄒ ᅬ ᄋ ᅦ
문의해	ᄆ ᅮ ᄂ ᅴ ᄒ ᅢ
보셔야	ᄇ ᅩ ᄉ ᅧ ᄋ ᅣ
합니다	ᄒ ᅡ ᆷ ᄂ ᅵ ᄃ ᅡ
북미	ᄇ ᅮ ᆼ ᄆ ᅵ
정상회담의	ᄌ ᅥ ᆼ ᄉ ᅡ ᆼ ᄒ ᅬ ᄃ ᅡ ᄆ ᅴ
일정과	ᄋ ᅵ ᆯ ᄌ ᅥ ᆼ ᄀ ᅪ
장소가	ᄌ ᅡ ᆼ ᄉ ᅩ ᄀ ᅡ
이번	ᄋ ᅵ ᄇ ᅥ ᆫ
주	ᄌ ᅮ
내로	ᄂ ᅢ ᄅ ᅩ
공개될	ᄀ ᅩ ᆼ ᄀ ᅢ ᄃ ᅬ ᆯ
예정입니다	ᄋ ᅨ ᄌ ᅥ ᆼ ᄋ ᅵ ᆷ ᄂ ᅵ ᄃ ᅡ
아프가니스탄에서	ᄋ ᅡ ᄑ ᅳ ᄀ ᅡ ᄂ ᅵ ᄉ ᅳ ᄐ ᅡ ᄂ ᅦ ᄉ ᅥ
지진으로	ᄌ ᅵ ᄌ ᅵ ᄂ ᅳ ᄅ ᅩ
현재까지	ᄒ ᅧ ᆫ ᄌ ᅢ ᄁ ᅡ ᄌ ᅵ
명의	ᄆ ᅧ ᆼ ᄋ ᅴ
부상자가	ᄇ ᅮ ᄉ ᅡ ᆼ ᄌ ᅡ ᄀ ᅡ
발생했다고	ᄇ ᅡ ᆯ ᄉ ᅢ ᆼ ᄒ ᅢ ᆮ ᄄ ᅡ ᄀ ᅩ
전해졌습니다	ᄌ ᅥ ᆫ ᄒ ᅢ ᄌ ᅥ ᆮ ᄊ ᅳ ᆷ ᄂ ᅵ ᄃ ᅡ
파블로	ᄑ ᅡ ᄇ ᅳ ᆯ ᄅ ᅩ
피카소의	ᄑ ᅵ ᄏ ᅡ ᄉ ᅩ ᄋ ᅴ
그림이	ᄀ ᅳ ᄅ ᅵ ᄆ ᅵ
천오백억	ᄎ ᅥ ᄂ ᅩ ᄇ ᅢ ᄀ ᅥ ᆨ
원에	ᄋ ᅯ ᄂ ᅦ
낙찰되었대요	ᄂ ᅡ ᆨ ᄎ ᅡ ᆯ ᄃ ᅬ ᄋ ᅥ ᆮ ᄄ ᅢ ᄋ ᅭ
내년	ᄂ ᅢ ᄂ ᅧ ᆫ
초	ᄎ ᅩ
어린이용	ᄋ ᅥ ᄅ ᅵ ᄂ ᅵ ᄋ ᅭ ᆼ
스마트워치가	ᄉ ᅳ ᄆ ᅡ ᄐ ᅳ ᄋ ᅯ ᄎ ᅵ ᄀ ᅡ
출시될	ᄎ ᅮ ᆯ ᄉ ᅵ ᄃ ᅬ ᆯ
이	ᄋ ᅵ
대리와	ᄃ ᅢ ᄅ ᅵ ᄋ ᅪ
김	ᄀ ᅵ ᆷ
대리는	ᄃ ᅢ ᄅ ᅵ ᄂ ᅳ ᆫ
내일	ᄂ ᅢ ᄋ ᅵ ᆯ
백화점에서	ᄇ ᅢ ᄏ ᅪ ᄌ ᅥ ᄆ ᅦ ᄉ ᅥ
시장조사를	ᄉ ᅵ ᄌ ᅡ ᆼ ᄌ ᅩ ᄉ ᅡ ᄅ ᅳ ᆯ
해주세요	ᄒ ᅢ ᄌ ᅮ ᄉ ᅦ ᄋ ᅭ
화장품도	ᄒ ᅪ ᄌ ᅡ ᆼ ᄑ ᅮ ᆷ ᄃ ᅩ
유통기한과	ᄋ ᅲ ᄐ ᅩ ᆼ ᄀ ᅵ ᄒ ᅡ ᆫ ᄀ ᅪ
제조	ᄌ ᅦ ᄌ ᅩ
일자를	ᄋ ᅵ ᆯ ᄌ ᅡ ᄅ ᅳ ᆯ
확인하고	ᄒ ᅪ ᄀ ᅵ ᆫ ᄒ ᅡ ᄀ ᅩ
써야	ᄊ ᅥ ᄋ ᅣ
해	ᄒ ᅢ
색상은	ᄉ ᅢ ᆨ ᄊ ᅡ ᆼ ᄋ ᅳ ᆫ
베이지로	ᄇ ᅦ ᄋ ᅵ ᄌ ᅵ ᄅ ᅩ
크기는	ᄏ ᅳ ᄀ ᅵ ᄂ ᅳ ᆫ
작은	ᄌ ᅡ ᄀ ᅳ ᆫ
치수로	ᄎ ᅵ ᄉ ᅮ ᄅ ᅩ
하나	ᄒ ᅡ ᄂ ᅡ
이태원에	ᄋ ᅵ ᄐ ᅢ ᄋ ᅯ ᄂ ᅦ
새로	ᄉ ᅢ ᄅ ᅩ
생긴	ᄉ ᅢ ᆼ ᄀ ᅵ ᆫ
쌀국수집	ᄊ ᅡ ᆯ ᄀ ᅮ ᆨ ᄊ ᅮ ᄌ ᅵ ᆸ
가서	ᄀ ᅡ ᄉ ᅥ
저녁	ᄌ ᅥ ᄂ ᅧ ᆨ
먹자	ᄆ ᅥ ᆨ ᄍ ᅡ
그럼	ᄀ ᅳ ᄅ ᅥ ᆷ
아홉	ᄋ ᅡ ᄒ ᅩ ᆸ
시에	ᄉ ᅵ ᄋ ᅦ
회사	ᄒ ᅬ ᄉ ᅡ
앞	ᄋ ᅡ ᆸ
카페에서	ᄏ ᅡ ᄑ ᅦ ᄋ ᅦ ᄉ ᅥ
뵙죠	ᄇ ᅬ ᆸ ᄍ ᅭ
개명은	ᄀ ᅢ ᄆ ᅧ ᆼ ᄋ ᅳ ᆫ
법률상	ᄇ ᅥ ᆷ ᄂ ᅲ ᆯ ᄉ ᅡ ᆼ
이름을	ᄋ ᅵ ᄅ ᅳ ᄆ ᅳ ᆯ
바꾸는	ᄇ ᅡ ᄁ ᅮ ᄂ ᅳ ᆫ
일을	ᄋ ᅵ ᄅ ᅳ ᆯ
말해	ᄆ ᅡ ᆯ ᄒ ᅢ
황제펭귄은	ᄒ ᅪ ᆼ ᄌ ᅦ ᄑ ᅦ ᆼ ᄀ ᅱ ᄂ ᅳ ᆫ
지구상에	ᄌ ᅵ ᄀ ᅮ ᄉ ᅡ ᆼ ᄋ ᅦ
있는	ᄋ ᅵ ᆫ ᄂ ᅳ ᆫ
펭귄	ᄑ ᅦ ᆼ ᄀ ᅱ ᆫ
중	ᄌ ᅮ ᆼ
몸집이	ᄆ ᅩ ᆷ ᄌ ᅵ ᄇ ᅵ
커	ᄏ ᅥ
양키	ᄋ ᅣ ᆼ ᄏ ᅵ
스타디움은	ᄉ ᅳ ᄐ ᅡ ᄃ ᅵ ᄋ ᅮ ᄆ ᅳ ᆫ
메이저리그를	ᄆ ᅦ ᄋ ᅵ ᄌ ᅥ ᄅ ᅵ ᄀ ᅳ ᄅ ᅳ ᆯ
상징하는	ᄉ ᅡ ᆼ ᄌ ᅵ ᆼ ᄒ ᅡ ᄂ ᅳ ᆫ
야구장이죠	ᄋ ᅣ ᄀ ᅮ ᄌ ᅡ ᆼ ᄋ ᅵ ᄌ ᅭ
지문으로	ᄌ ᅵ ᄆ ᅮ ᄂ ᅳ ᄅ ᅩ
범인을	ᄇ ᅥ ᄆ ᅵ ᄂ ᅳ ᆯ
찾을	ᄎ ᅡ ᄌ ᅳ ᆯ
방법에	ᄇ ᅡ ᆼ ᄇ ᅥ ᄇ ᅦ
대해	ᄃ ᅢ ᄒ ᅢ
알고	ᄋ ᅡ ᆯ ᄀ ᅩ
계세요	ᄀ ᅨ ᄉ ᅦ ᄋ ᅭ
발표	ᄇ ᅡ ᆯ ᄑ ᅭ
자료는	ᄌ ᅡ ᄅ ᅭ ᄂ ᅳ ᆫ
회의	ᄒ ᅬ ᄋ ᅴ
전에	ᄌ ᅥ ᄂ ᅦ
미리	ᄆ ᅵ ᄅ ᅵ
메일로	ᄆ ᅦ ᄋ ᅵ ᆯ ᄅ ᅩ
보내주세요	ᄇ ᅩ ᄂ ᅢ ᄌ ᅮ ᄉ ᅦ ᄋ ᅭ
전염병을	ᄌ ᅥ ᄂ ᅧ ᆷ ᄇ ᅧ ᆼ ᄋ ᅳ ᆯ
예방하려면	ᄋ ᅨ ᄇ ᅡ ᆼ ᄒ ᅡ ᄅ ᅧ ᄆ ᅧ ᆫ
철저한	ᄎ ᅥ ᆯ ᄌ ᅥ ᄒ ᅡ ᆫ
소독과	ᄉ ᅩ ᄃ ᅩ ᆨ ᄁ ᅪ
멸균이	ᄆ ᅧ ᆯ ᄀ ᅲ ᄂ ᅵ
중요합니다	ᄌ ᅮ ᆼ ᄋ ᅭ ᄒ ᅡ ᆷ ᄂ ᅵ ᄃ ᅡ
노르웨이에	ᄂ ᅩ ᄅ ᅳ ᄋ ᅰ ᄋ ᅵ ᄋ ᅦ
가실	ᄀ ᅡ ᄉ ᅵ ᆯ
거라면	ᄀ ᅥ ᄅ ᅡ ᄆ ᅧ ᆫ
여름이	ᄋ ᅧ ᄅ ᅳ ᄆ ᅵ
여행하기	ᄋ ᅧ ᄒ ᅢ ᆼ ᄒ ᅡ ᄀ ᅵ
좋은	ᄌ ᅩ ᄋ ᅳ ᆫ
계절이에요	ᄀ ᅨ ᄌ ᅥ ᄅ ᅵ ᄋ ᅦ ᄋ ᅭ
미국	ᄆ ᅵ ᄀ ᅮ ᆨ
하와이주	ᄒ ᅡ ᄋ ᅪ ᄋ ᅵ ᄌ ᅮ
하와이	ᄒ ᅡ ᄋ ᅪ ᄋ ᅵ
섬에서	ᄉ ᅥ ᄆ ᅦ ᄉ ᅥ
칠일째	ᄎ ᅵ ᄅ ᅵ ᆯ ᄍ ᅢ
화산	ᄒ ᅪ ᄉ ᅡ ᆫ
지진	ᄌ ᅵ ᄌ ᅵ ᆫ
활동이	ᄒ ᅪ ᆯ ᄃ ᅩ ᆼ ᄋ ᅵ
계속되고	ᄀ ᅨ ᄉ ᅩ ᆨ ᄄ ᅬ ᄀ ᅩ
덕수궁	ᄃ ᅥ ᆨ ᄊ ᅮ ᄀ ᅮ ᆼ
석조전은	ᄉ ᅥ ᆨ ᄍ ᅩ ᄌ ᅥ ᄂ ᅳ ᆫ
최초의	ᄎ ᅬ ᄎ ᅩ ᄋ ᅴ
서양식	ᄉ ᅥ ᄋ ᅣ ᆼ ᄉ ᅵ ᆨ
석조	ᄉ ᅥ ᆨ ᄍ ᅩ
건물로	ᄀ ᅥ ᆫ ᄆ ᅮ ᆯ ᄅ ᅩ
알려졌어	ᄋ ᅡ ᆯ ᄅ ᅧ ᄌ ᅥ ᄊ ᅥ
입춘은	ᄋ ᅵ ᆸ ᄎ ᅮ ᄂ ᅳ ᆫ
대한과	ᄃ ᅢ ᄒ ᅡ ᆫ ᄀ ᅪ
우수	ᄋ ᅮ ᄉ ᅮ
사이에	ᄉ ᅡ ᄋ ᅵ ᄋ ᅦ
절기입니다	ᄌ ᅥ ᆯ ᄀ ᅵ ᄋ ᅵ ᆷ ᄂ ᅵ ᄃ ᅡ
아보카도는	ᄋ ᅡ ᄇ ᅩ ᄏ ᅡ ᄃ ᅩ ᄂ ᅳ ᆫ
멕시코가	ᄆ ᅦ ᆨ ᄊ ᅵ ᄏ ᅩ ᄀ ᅡ
원산지이고	ᄋ ᅯ ᆫ ᄉ ᅡ ᆫ ᄌ ᅵ ᄋ ᅵ ᄀ ᅩ
비타민과	ᄇ ᅵ ᄐ ᅡ ᄆ ᅵ ᆫ ᄀ ᅪ
미네랄이	ᄆ ᅵ ᄂ ᅦ ᄅ ᅡ ᄅ ᅵ
풍부한	ᄑ ᅮ ᆼ ᄇ ᅮ ᄒ ᅡ ᆫ
과일이에요	ᄀ ᅪ ᄋ ᅵ ᄅ ᅵ ᄋ ᅦ ᄋ ᅭ
오트밀은	ᄋ ᅩ ᄐ ᅳ ᄆ ᅵ ᄅ ᅳ ᆫ
식이섬유가	ᄉ ᅵ ᄀ ᅵ ᄉ ᅥ ᄆ ᅲ ᄀ ᅡ
풍부해서	ᄑ ᅮ ᆼ ᄇ ᅮ ᄒ ᅢ ᄉ ᅥ
아침	ᄋ ᅡ ᄎ ᅵ ᆷ
대용으로도	ᄃ ᅢ ᄋ ᅭ ᆼ ᄋ ᅳ ᄅ ᅩ ᄃ ᅩ
좋아	ᄌ ᅩ ᄋ ᅡ
프랑스	ᄑ ᅳ ᄅ ᅡ ᆼ ᄉ ᅳ
인권	ᄋ ᅵ ᆫ ᄀ ᅯ ᆫ
선언은	ᄉ ᅥ ᄂ ᅥ ᄂ ᅳ ᆫ
천칠백팔십구년에	ᄎ ᅥ ᆫ ᄎ ᅵ ᆯ ᄇ ᅢ ᆨ ᄑ ᅡ ᆯ ᄉ ᅵ ᆸ ᄁ ᅮ ᄂ ᅧ ᄂ ᅦ
선포되었습니다	ᄉ ᅥ ᆫ ᄑ ᅩ ᄃ ᅬ ᄋ ᅥ ᆮ ᄊ ᅳ ᆷ ᄂ ᅵ ᄃ ᅡ
프로젝트	ᄑ ᅳ ᄅ ᅩ ᄌ ᅦ ᆨ ᄐ ᅳ
연락해	ᄋ ᅧ ᆯ ᄅ ᅡ ᄏ ᅢ
나눠드린	ᄂ ᅡ ᄂ ᅯ ᄃ ᅳ ᄅ ᅵ ᆫ
유인물은	ᄋ ᅲ ᄋ ᅵ ᆫ ᄆ ᅮ ᄅ ᅳ ᆫ
다음	ᄃ ᅡ ᄋ ᅳ ᆷ
수업	ᄉ ᅮ ᄋ ᅥ ᆸ
시간에도	ᄉ ᅵ ᄀ ᅡ ᄂ ᅦ ᄃ ᅩ
챙겨오세요	ᄎ ᅢ ᆼ ᄀ ᅧ ᄋ ᅩ ᄉ ᅦ ᄋ ᅭ
다	ᄃ ᅡ
쓰신	ᄊ ᅳ ᄉ ᅵ ᆫ
일회용	ᄋ ᅵ ᆯ ᄒ ᅬ ᄋ ᅭ ᆼ
컵은	ᄏ ᅥ ᄇ ᅳ ᆫ
여기에	ᄋ ᅧ ᄀ ᅵ ᄋ ᅦ
두시면	ᄃ ᅮ ᄉ ᅵ ᄆ ᅧ ᆫ
됩니다	ᄃ ᅬ ᆷ ᄂ ᅵ ᄃ ᅡ
어제	ᄋ ᅥ ᄌ ᅦ
흰	ᄒ ᅵ ᆫ
셔츠에	ᄉ ᅧ ᄎ ᅳ ᄋ ᅦ
검은	ᄀ ᅥ ᄆ ᅳ ᆫ
바지	ᄇ ᅡ ᄌ ᅵ
입었던	ᄋ ᅵ ᄇ ᅥ ᆮ ᄄ ᅥ ᆫ
분	ᄇ ᅮ ᆫ
말이지	ᄆ ᅡ ᄅ ᅵ ᄌ ᅵ
달	ᄃ ᅡ ᆯ
경에	ᄀ ᅧ ᆼ ᄋ ᅦ
한	ᄒ ᅡ ᆫ
번	ᄇ ᅥ ᆫ
들를	ᄃ ᅳ ᆯ ᄅ ᅳ ᆯ
일이	ᄋ ᅵ ᄅ ᅵ
있을	ᄋ ᅵ ᄊ ᅳ ᆯ
것	ᄀ ᅥ ᆮ
같아	ᄀ ᅡ ᄐ ᅡ
내가	ᄂ ᅢ ᄀ ᅡ
자료	ᄌ ᅡ ᄅ ᅭ
조사할	ᄌ ᅩ ᄉ ᅡ ᄒ ᅡ ᆯ
테니까	ᄐ ᅦ ᄂ ᅵ ᄁ ᅡ
스크립트	ᄉ ᅳ ᄏ ᅳ ᄅ ᅵ ᆸ ᄐ ᅳ
작성은	ᄌ ᅡ ᆨ ᄊ ᅥ ᆼ ᄋ ᅳ ᆫ
네가	ᄂ ᅦ ᄀ ᅡ
맡아줘	ᄆ ᅡ ᄐ ᅡ ᄌ ᅯ
우리	ᄋ ᅮ ᄅ ᅵ
하숙집은	ᄒ ᅡ ᄉ ᅮ ᆨ ᄍ ᅵ ᄇ ᅳ ᆫ
벽에	ᄇ ᅧ ᄀ ᅦ
대문이	ᄃ ᅢ ᄆ ᅮ ᄂ ᅵ
파란색인	ᄑ ᅡ ᄅ ᅡ ᆫ ᄉ ᅢ ᄀ ᅵ ᆫ
삼층짜리	ᄉ ᅡ ᆷ ᄎ ᅳ ᆼ ᄍ ᅡ ᄅ ᅵ
집이야	ᄌ ᅵ ᄇ ᅵ ᄋ ᅣ
쭉	ᄍ ᅮ ᆨ
가시다가	ᄀ ᅡ ᄉ ᅵ ᄃ ᅡ ᄀ ᅡ
교차로	ᄀ ᅭ ᄎ ᅡ ᄅ ᅩ
끼고	ᄁ ᅵ ᄀ ᅩ
오른쪽으로	ᄋ ᅩ ᄅ ᅳ ᆫ ᄍ ᅩ ᄀ ᅳ ᄅ ᅩ
도시면	ᄃ ᅩ ᄉ ᅵ ᄆ ᅧ ᆫ
보여요	ᄇ ᅩ ᄋ ᅧ ᄋ ᅭ
내일은	ᄂ ᅢ ᄋ ᅵ ᄅ ᅳ ᆫ
자폐인의	ᄌ ᅡ ᄑ ᅨ ᄋ ᅵ ᄂ ᅴ
날이니	ᄂ ᅡ ᄅ ᅵ ᄂ ᅵ
파란색	ᄑ ᅡ ᄅ ᅡ ᆫ ᄉ ᅢ ᆨ
티를	ᄐ ᅵ ᄅ ᅳ ᆯ
입고	ᄋ ᅵ ᆸ ᄁ ᅩ
오렴	ᄋ ᅩ ᄅ ᅧ ᆷ
주차장	ᄌ ᅮ ᄎ ᅡ ᄌ ᅡ ᆼ
바닥	ᄇ ᅡ ᄃ ᅡ ᆨ
공사가	ᄀ ᅩ ᆼ ᄉ ᅡ ᄀ ᅡ
예정되어	ᄋ ᅨ ᄌ ᅥ ᆼ ᄃ ᅬ ᄋ ᅥ
있으니	ᄋ ᅵ ᄊ ᅳ ᄂ ᅵ
차량을	ᄎ ᅡ ᄅ ᅣ ᆼ ᄋ ᅳ ᆯ
이동시켜	ᄋ ᅵ ᄃ ᅩ ᆼ ᄉ ᅵ ᄏ ᅧ
기숙사	ᄀ ᅵ ᄉ ᅮ ᆨ ᄊ ᅡ
생활을	ᄉ ᅢ ᆼ ᄒ ᅪ ᄅ ᅳ ᆯ
할	ᄒ ᅡ ᆯ
때는	ᄄ ᅢ ᄂ ᅳ ᆫ
생활이	ᄉ ᅢ ᆼ ᄒ ᅪ ᄅ ᅵ
규칙적이었어	ᄀ ᅲ ᄎ ᅵ ᆨ ᄍ ᅥ ᄀ ᅵ ᄋ ᅥ ᄊ ᅥ
최	ᄎ ᅬ
대리	ᄃ ᅢ ᄅ ᅵ
거래처에서	ᄀ ᅥ ᄅ ᅢ ᄎ ᅥ ᄋ ᅦ ᄉ ᅥ
장소	ᄌ ᅡ ᆼ ᄉ ᅩ
관련	ᄀ ᅪ ᆯ ᄅ ᅧ ᆫ
메일을	ᄆ ᅦ ᄋ ᅵ ᄅ ᅳ ᆯ
보냈더라	ᄇ ᅩ ᄂ ᅢ ᆮ ᄄ ᅥ ᄅ ᅡ
민주주의	ᄆ ᅵ ᆫ ᄌ ᅮ ᄌ ᅮ ᄋ ᅴ
국가의	ᄀ ᅮ ᆨ ᄁ ᅡ ᄋ ᅴ
주인은	ᄌ ᅮ ᄋ ᅵ ᄂ ᅳ ᆫ
국민입니다	ᄀ ᅮ ᆼ ᄆ ᅵ ᄂ ᅵ ᆷ ᄂ ᅵ ᄃ ᅡ
버스에는	ᄇ ᅥ ᄉ ᅳ ᄋ ᅦ ᄂ ᅳ ᆫ
컵에	ᄏ ᅥ ᄇ ᅦ
담긴	ᄃ ᅡ ᆷ ᄀ ᅵ ᆫ
음료를	ᄋ ᅳ ᆷ ᄂ ᅭ ᄅ ᅳ ᆯ
들고	ᄃ ᅳ ᆯ ᄀ ᅩ
탈	ᄐ ᅡ ᆯ
수	ᄉ ᅮ
없습니다	ᄋ ᅥ ᆸ ᄊ ᅳ ᆷ ᄂ ᅵ ᄃ ᅡ
결제가	ᄀ ᅧ ᆯ ᄌ ᅦ ᄀ ᅡ
정상적으로	ᄌ ᅥ ᆼ ᄉ ᅡ ᆼ ᄌ ᅥ ᄀ ᅳ ᄅ ᅩ
완료되었습니다	ᄋ ᅪ ᆯ ᄅ ᅭ ᄃ ᅬ ᄋ ᅥ ᆮ ᄊ ᅳ ᆷ ᄂ ᅵ ᄃ ᅡ
소중한	ᄉ ᅩ ᄌ ᅮ ᆼ ᄒ ᅡ ᆫ
정보	ᄌ ᅥ ᆼ ᄇ ᅩ
보호를	ᄇ ᅩ ᄒ ᅩ ᄅ ᅳ ᆯ
위해	ᄋ ᅱ ᄒ ᅢ
주기적으로	ᄌ ᅮ ᄀ ᅵ ᄌ ᅥ ᄀ ᅳ ᄅ ᅩ
비밀번호를	ᄇ ᅵ ᄆ ᅵ ᆯ ᄇ ᅥ ᆫ ᄒ ᅩ ᄅ ᅳ ᆯ
변경해	ᄇ ᅧ ᆫ ᄀ ᅧ ᆼ ᄒ ᅢ
손해보험	ᄉ ᅩ ᆫ ᄒ ᅢ ᄇ ᅩ ᄒ ᅥ ᆷ
홈페이지	ᄒ ᅩ ᆷ ᄑ ᅦ ᄋ ᅵ ᄌ ᅵ
회원이	ᄒ ᅬ ᄋ ᅯ ᄂ ᅵ
되신	ᄃ ᅬ ᄉ ᅵ ᆫ
것을	ᄀ ᅥ ᄉ ᅳ ᆯ
환영합니다	ᄒ ᅪ ᄂ ᅧ ᆼ ᄒ ᅡ ᆷ ᄂ ᅵ ᄃ ᅡ
공모에	ᄀ ᅩ ᆼ ᄆ ᅩ ᄋ ᅦ
응모해	ᄋ ᅳ ᆼ ᄆ ᅩ ᄒ ᅢ
주셔서	ᄌ ᅮ ᄉ ᅧ ᄉ ᅥ
감사합니다	ᄀ ᅡ ᆷ ᄉ ᅡ ᄒ ᅡ ᆷ ᄂ ᅵ ᄃ ᅡ
오늘은	ᄋ ᅩ ᄂ ᅳ ᄅ ᅳ ᆫ
폭염	ᄑ ᅩ ᄀ ᅧ ᆷ
수준의	ᄉ ᅮ ᄌ ᅮ ᄂ ᅴ
더위가	ᄃ ᅥ ᄋ ᅱ ᄀ ᅡ
누그러지겠습니다	ᄂ ᅮ ᄀ ᅳ ᄅ ᅥ ᄌ ᅵ ᄀ ᅦ ᆮ ᄊ ᅳ ᆷ ᄂ ᅵ ᄃ ᅡ
피부	ᄑ ᅵ ᄇ ᅮ
노화를	ᄂ ᅩ ᄒ ᅪ ᄅ ᅳ ᆯ
막으려면	ᄆ ᅡ ᄀ ᅳ ᄅ ᅧ ᄆ ᅧ ᆫ
유수분	ᄋ ᅲ ᄉ ᅮ ᄇ ᅮ ᆫ
균형에	ᄀ ᅲ ᆫ ᄒ ᅧ ᆼ ᄋ ᅦ
신경	ᄉ ᅵ ᆫ ᄀ ᅧ ᆼ
쓰셔야	ᄊ ᅳ ᄉ ᅧ ᄋ ᅣ
자외선에	ᄌ ᅡ ᄋ ᅬ ᄉ ᅥ ᄂ ᅦ
노출된	ᄂ ᅩ ᄎ ᅮ ᆯ ᄃ ᅬ ᆫ
모발은	ᄆ ᅩ ᄇ ᅡ ᄅ ᅳ ᆫ
단백질이	ᄃ ᅡ ᆫ ᄇ ᅢ ᆨ ᄍ ᅵ ᄅ ᅵ
파괴되고	ᄑ ᅡ ᄀ ᅬ ᄃ ᅬ ᄀ ᅩ
윤기와	ᄋ ᅲ ᆫ ᄀ ᅵ ᄋ ᅪ
탄력을	ᄐ ᅡ ᆯ ᄅ ᅧ ᄀ ᅳ ᆯ
잃어요	ᄋ ᅵ ᄅ ᅥ ᄋ ᅭ
바다의	ᄇ ᅡ ᄃ ᅡ ᄋ ᅴ
포식자로	ᄑ ᅩ ᄉ ᅵ ᆨ ᄍ ᅡ ᄅ ᅩ
불리는	ᄇ ᅮ ᆯ ᄅ ᅵ ᄂ ᅳ ᆫ
백상아리	ᄇ ᅢ ᆨ ᄊ ᅡ ᆼ ᄋ ᅡ ᄅ ᅵ
마리가	ᄆ ᅡ ᄅ ᅵ ᄀ ᅡ
발견되었어요	ᄇ ᅡ ᆯ ᄀ ᅧ ᆫ ᄃ ᅬ ᄋ ᅥ ᄊ ᅥ ᄋ ᅭ
투표는	ᄐ ᅮ ᄑ ᅭ ᄂ ᅳ ᆫ
국민의	ᄀ ᅮ ᆼ ᄆ ᅵ ᄂ ᅴ
권리입니다	ᄀ ᅯ ᆯ ᄅ ᅵ ᄋ ᅵ ᆷ ᄂ ᅵ ᄃ ᅡ
소방차의	ᄉ ᅩ ᄇ ᅡ ᆼ ᄎ ᅡ ᄋ ᅴ
출동을	ᄎ ᅮ ᆯ ᄃ ᅩ ᆼ ᄋ ᅳ ᆯ
방해할	ᄇ ᅡ ᆼ ᄒ ᅢ ᄒ ᅡ ᆯ
경우	ᄀ ᅧ ᆼ ᄋ ᅮ
최대	ᄎ ᅬ ᄃ ᅢ
이백만	ᄋ ᅵ ᄇ ᅢ ᆼ ᄆ ᅡ ᆫ
원의	ᄋ ᅯ ᄂ ᅴ
과태료가	ᄀ ᅪ ᄐ ᅢ ᄅ ᅭ ᄀ ᅡ
부과된	ᄇ ᅮ ᄀ ᅪ ᄃ ᅬ ᆫ
대	ᄃ ᅢ
언제부터	ᄋ ᅥ ᆫ ᄌ ᅦ ᄇ ᅮ ᄐ ᅥ
소방차는	ᄉ ᅩ ᄇ ᅡ ᆼ ᄎ ᅡ ᄂ ᅳ ᆫ
빨간색이	ᄈ ᅡ ᆯ ᄀ ᅡ ᆫ ᄉ ᅢ ᄀ ᅵ
되었을까	ᄃ ᅬ ᄋ ᅥ ᄊ ᅳ ᆯ ᄁ ᅡ
지나가는	ᄌ ᅵ ᄂ ᅡ ᄀ ᅡ ᄂ ᅳ ᆫ
소방차에	ᄉ ᅩ ᄇ ᅡ ᆼ ᄎ ᅡ ᄋ ᅦ
길을	ᄀ ᅵ ᄅ ᅳ ᆯ
열어주세요	ᄋ ᅧ ᄅ ᅥ ᄌ ᅮ ᄉ ᅦ ᄋ ᅭ
오신	ᄋ ᅩ ᄉ ᅵ ᆫ
순서대로	ᄉ ᅮ ᆫ ᄉ ᅥ ᄃ ᅢ ᄅ ᅩ
처리해	ᄎ ᅥ ᄅ ᅵ ᄒ ᅢ
드리겠습니다	ᄃ ᅳ ᄅ ᅵ ᄀ ᅦ ᆮ ᄊ ᅳ ᆷ ᄂ ᅵ ᄃ ᅡ
신용카드를	ᄉ ᅵ ᄂ ᅭ ᆼ ᄏ ᅡ ᄃ ᅳ ᄅ ᅳ ᆯ
지참하시고	ᄌ ᅵ ᄎ ᅡ ᆷ ᄒ ᅡ ᄉ ᅵ ᄀ ᅩ
고객센터에서	ᄀ ᅩ ᄀ ᅢ ᆨ ᄊ ᅦ ᆫ ᄐ ᅥ ᄋ ᅦ ᄉ ᅥ
영수증	ᄋ ᅧ ᆼ ᄉ ᅮ ᄌ ᅳ ᆼ
재발급을	ᄌ ᅢ ᄇ ᅡ ᆯ ᄀ ᅳ ᄇ ᅳ ᆯ
받으면	ᄇ ᅡ ᄃ ᅳ ᄆ ᅧ ᆫ
해변가에	ᄒ ᅢ ᄇ ᅧ ᆫ ᄀ ᅡ ᄋ ᅦ
상어가	ᄉ ᅡ ᆼ ᄋ ᅥ ᄀ ᅡ
출몰해	ᄎ ᅮ ᆯ ᄆ ᅩ ᆯ ᄒ ᅢ
피서객들의	ᄑ ᅵ ᄉ ᅥ ᄀ ᅢ ᆨ ᄄ ᅳ ᄅ ᅴ
주의가	ᄌ ᅮ ᄋ ᅴ ᄀ ᅡ
필요합니다	ᄑ ᅵ ᄅ ᅭ ᄒ ᅡ ᆷ ᄂ ᅵ ᄃ ᅡ
방울토마토는	ᄇ ᅡ ᆼ ᄋ ᅮ ᆯ ᄐ ᅩ ᄆ ᅡ ᄐ ᅩ ᄂ ᅳ ᆫ
꼭지가	ᄁ ᅩ ᆨ ᄍ ᅵ ᄀ ᅡ
싱싱한	ᄉ ᅵ ᆼ ᄉ ᅵ ᆼ ᄒ ᅡ ᆫ
게	ᄀ ᅦ
상품이야	ᄉ ᅡ ᆼ ᄑ ᅮ ᄆ ᅵ ᄋ ᅣ
아침은	ᄋ ᅡ ᄎ ᅵ ᄆ ᅳ ᆫ
쌀밥	ᄊ ᅡ ᆯ ᄇ ᅡ ᆸ
대신	ᄃ ᅢ ᄉ ᅵ ᆫ
귀리나	ᄀ ᅱ ᄅ ᅵ ᄂ ᅡ
오트밀	ᄋ ᅩ ᄐ ᅳ ᄆ ᅵ ᆯ
점심은	ᄌ ᅥ ᆷ ᄉ ᅵ ᄆ ᅳ ᆫ
황제처럼	ᄒ ᅪ ᆼ ᄌ ᅦ ᄎ ᅥ ᄅ ᅥ ᆷ
저녁은	ᄌ ᅥ ᄂ ᅧ ᄀ ᅳ ᆫ
든든하게	ᄃ ᅳ ᆫ ᄃ ᅳ ᆫ ᄒ ᅡ ᄀ ᅦ
점심	ᄌ ᅥ ᆷ ᄉ ᅵ ᆷ
특선	ᄐ ᅳ ᆨ ᄊ ᅥ ᆫ
메뉴는	ᄆ ᅦ ᄂ ᅲ ᄂ ᅳ ᆫ
갈비탕	ᄀ ᅡ ᆯ ᄇ ᅵ ᄐ ᅡ ᆼ
이래	ᄋ ᅵ ᄅ ᅢ
비닐봉지도	ᄇ ᅵ ᄂ ᅵ ᆯ ᄇ ᅩ ᆼ ᄌ ᅵ ᄃ ᅩ
이제는	ᄋ ᅵ ᄌ ᅦ ᄂ ᅳ ᆫ
돈	ᄃ ᅩ ᆫ
주고	ᄌ ᅮ ᄀ ᅩ
사야	ᄉ ᅡ ᄋ ᅣ
회원님	ᄒ ᅬ ᄋ ᅯ ᆫ ᄂ ᅵ ᆷ
영화	ᄋ ᅧ ᆼ ᄒ ᅪ
예매가	ᄋ ᅨ ᄆ ᅢ ᄀ ᅡ
기프티카드로	ᄀ ᅵ ᄑ ᅳ ᄐ ᅵ ᄏ ᅡ ᄃ ᅳ ᄅ ᅩ
사람들에게	ᄉ ᅡ ᄅ ᅡ ᆷ ᄃ ᅳ ᄅ ᅦ ᄀ ᅦ
마음을	ᄆ ᅡ ᄋ ᅳ ᄆ ᅳ ᆯ
전하세요	ᄌ ᅥ ᆫ ᄒ ᅡ ᄉ ᅦ ᄋ ᅭ
콜드	ᄏ ᅩ ᆯ ᄃ ᅳ
부루는	ᄇ ᅮ ᄅ ᅮ ᄂ ᅳ ᆫ
커피	ᄏ ᅥ ᄑ ᅵ
원두를	ᄋ ᅯ ᆫ ᄃ ᅮ ᄅ ᅳ ᆯ
차가운	ᄎ ᅡ ᄀ ᅡ ᄋ ᅮ ᆫ
물로	ᄆ ᅮ ᆯ ᄅ ᅩ
오랜	ᄋ ᅩ ᄅ ᅢ ᆫ
시간을	ᄉ ᅵ ᄀ ᅡ ᄂ ᅳ ᆯ
들여	ᄃ ᅳ ᄅ ᅧ
우려내는	ᄋ ᅮ ᄅ ᅧ ᄂ ᅢ ᄂ ᅳ ᆫ
방식을	ᄇ ᅡ ᆼ ᄉ ᅵ ᄀ ᅳ ᆯ
무분별한	ᄆ ᅮ ᄇ ᅮ ᆫ ᄇ ᅧ ᆯ ᄒ ᅡ ᆫ
종이컵	ᄌ ᅩ ᆼ ᄋ ᅵ ᄏ ᅥ ᆸ
사용을	ᄉ ᅡ ᄋ ᅭ ᆼ ᄋ ᅳ ᆯ
자제하고	ᄌ ᅡ ᄌ ᅦ ᄒ ᅡ ᄀ ᅩ
텀블러	ᄐ ᅥ ᆷ ᄇ ᅳ ᆯ ᄅ ᅥ
생활화합시다	ᄉ ᅢ ᆼ ᄒ ᅪ ᆯ ᄒ ᅪ ᄒ ᅡ ᆸ ᄊ ᅵ ᄃ ᅡ
미세먼지	ᄆ ᅵ ᄉ ᅦ ᄆ ᅥ ᆫ ᄌ ᅵ
제거에	ᄌ ᅦ ᄀ ᅥ ᄋ ᅦ
효과적인	ᄒ ᅭ ᄀ ᅪ ᄌ ᅥ ᄀ ᅵ ᆫ
공기청정기를	ᄀ ᅩ ᆼ ᄀ ᅵ ᄎ ᅥ ᆼ ᄌ ᅥ ᆼ ᄀ ᅵ ᄅ ᅳ ᆯ
추천해	ᄎ ᅮ ᄎ ᅥ ᆫ ᄒ ᅢ
하루	ᄒ ᅡ ᄅ ᅮ
일곱	ᄋ ᅵ ᆯ ᄀ ᅩ ᆸ
여덟	ᄋ ᅧ ᄃ ᅥ ᆯ
시간의	ᄉ ᅵ ᄀ ᅡ ᄂ ᅴ
수면이	ᄉ ᅮ ᄆ ᅧ ᄂ ᅵ
건강에	ᄀ ᅥ ᆫ ᄀ ᅡ ᆼ ᄋ ᅦ
좋다는	ᄌ ᅩ ᄐ ᅡ ᄂ ᅳ ᆫ
연구	ᄋ ᅧ ᆫ ᄀ ᅮ
결과가	ᄀ ᅧ ᆯ ᄀ ᅪ ᄀ ᅡ
나왔어	ᄂ ᅡ ᄋ ᅪ ᄊ ᅥ
점심을	ᄌ ᅥ ᆷ ᄉ ᅵ ᄆ ᅳ ᆯ
누가	ᄂ ᅮ ᄀ ᅡ
살지	ᄉ ᅡ ᆯ ᄌ ᅵ
사다리	ᄉ ᅡ ᄃ ᅡ ᄅ ᅵ
타기로	ᄐ ᅡ ᄀ ᅵ ᄅ ᅩ
정하자	ᄌ ᅥ ᆼ ᄒ ᅡ ᄌ ᅡ
에너지	ᄋ ᅦ ᄂ ᅥ ᄌ ᅵ
절약과	ᄌ ᅥ ᄅ ᅣ ᆨ ᄁ ᅪ
건강을	ᄀ ᅥ ᆫ ᄀ ᅡ ᆼ ᄋ ᅳ ᆯ
저층은	ᄌ ᅥ ᄎ ᅳ ᆼ ᄋ ᅳ ᆫ
계단을	ᄀ ᅨ ᄃ ᅡ ᄂ ᅳ ᆯ
이용합시다	ᄋ ᅵ ᄋ ᅭ ᆼ ᄒ ᅡ ᆸ ᄊ ᅵ ᄃ ᅡ
정부가	ᄌ ᅥ ᆼ ᄇ ᅮ ᄀ ᅡ
권장하는	ᄀ ᅯ ᆫ ᄌ ᅡ ᆼ ᄒ ᅡ ᄂ ᅳ ᆫ
여름철	ᄋ ᅧ ᄅ ᅳ ᆷ ᄎ ᅥ ᆯ
실내	ᄉ ᅵ ᆯ ᄅ ᅢ
적정	ᄌ ᅥ ᆨ ᄍ ᅥ ᆼ
온도는	ᄋ ᅩ ᆫ ᄃ ᅩ ᄂ ᅳ ᆫ
이십육에서	ᄋ ᅵ ᄉ ᅵ ᄇ ᅲ ᄀ ᅦ ᄉ ᅥ
이십팔	ᄋ ᅵ ᄉ ᅵ ᆸ ᄑ ᅡ ᆯ
도입니다	ᄃ ᅩ ᄋ ᅵ ᆷ ᄂ ᅵ ᄃ ᅡ
반소매	ᄇ ᅡ ᆫ ᄉ ᅩ ᄆ ᅢ
와이셔츠에	ᄋ ᅪ ᄋ ᅵ ᄉ ᅧ ᄎ ᅳ ᄋ ᅦ
넥타이를	ᄂ ᅦ ᆨ ᄐ ᅡ ᄋ ᅵ ᄅ ᅳ ᆯ
매지	ᄆ ᅢ ᄌ ᅵ
않으면	ᄋ ᅡ ᄂ ᅳ ᄆ ᅧ ᆫ
체감온도를	ᄎ ᅦ ᄀ ᅡ ᄆ ᅩ ᆫ ᄃ ᅩ ᄅ ᅳ ᆯ
이도	ᄋ ᅵ ᄃ ᅩ
낮출	ᄂ ᅡ ᆮ ᄎ ᅮ ᆯ
드신	ᄃ ᅳ ᄉ ᅵ ᆫ
식판의	ᄉ ᅵ ᆨ ᄑ ᅡ ᄂ ᅴ
음식	ᄋ ᅳ ᆷ ᄉ ᅵ ᆨ
찌꺼기는	ᄍ ᅵ ᄁ ᅥ ᄀ ᅵ ᄂ ᅳ ᆫ
음식물	ᄋ ᅳ ᆷ ᄉ ᅵ ᆼ ᄆ ᅮ ᆯ
쓰레기통에	ᄊ ᅳ ᄅ ᅦ ᄀ ᅵ ᄐ ᅩ ᆼ ᄋ ᅦ
버려주세요	ᄇ ᅥ ᄅ ᅧ ᄌ ᅮ ᄉ ᅦ ᄋ ᅭ
회식에	ᄒ ᅬ ᄉ ᅵ ᄀ ᅦ
참석이	ᄎ ᅡ ᆷ ᄉ ᅥ ᄀ ᅵ
어려우신	ᄋ ᅥ ᄅ ᅧ ᄋ ᅮ ᄉ ᅵ ᆫ
말씀해	ᄆ ᅡ ᆯ ᄊ ᅳ ᆷ ᄒ ᅢ
칸에서	ᄏ ᅡ ᄂ ᅦ ᄉ ᅥ
수상한	ᄉ ᅮ ᄉ ᅡ ᆼ ᄒ ᅡ ᆫ
영화인	ᄋ ᅧ ᆼ ᄒ ᅪ ᄋ ᅵ ᆫ
만큼	ᄆ ᅡ ᆫ ᄏ ᅳ ᆷ
작품성은	ᄌ ᅡ ᆨ ᄑ ᅮ ᆷ ᄉ ᅥ ᆼ ᄋ ᅳ ᆫ
보장하지	ᄇ ᅩ ᄌ ᅡ ᆼ ᄒ ᅡ ᄌ ᅵ
음식은	ᄋ ᅳ ᆷ ᄉ ᅵ ᄀ ᅳ ᆫ
맛도	ᄆ ᅡ ᆮ ᄄ ᅩ
중요하지만	ᄌ ᅮ ᆼ ᄋ ᅭ ᄒ ᅡ ᄌ ᅵ ᄆ ᅡ ᆫ
스타일링도	ᄉ ᅳ ᄐ ᅡ ᄋ ᅵ ᆯ ᄅ ᅵ ᆼ ᄃ ᅩ
중요하다고	ᄌ ᅮ ᆼ ᄋ ᅭ ᄒ ᅡ ᄃ ᅡ ᄀ ᅩ
생각해	ᄉ ᅢ ᆼ ᄀ ᅡ ᄏ ᅢ
원만한	ᄋ ᅯ ᆫ ᄆ ᅡ ᆫ ᄒ ᅡ ᆫ
인간관계를	ᄋ ᅵ ᆫ ᄀ ᅡ ᆫ ᄀ ᅪ ᆫ ᄀ ᅨ ᄅ ᅳ ᆯ
위해서는	ᄋ ᅱ ᄒ ᅢ ᄉ ᅥ ᄂ ᅳ ᆫ
하얀	ᄒ ᅡ ᄋ ᅣ ᆫ
거짓말도	ᄀ ᅥ ᄌ ᅵ ᆫ ᄆ ᅡ ᆯ ᄃ ᅩ
필요하다고	ᄑ ᅵ ᄅ ᅭ ᄒ ᅡ ᄃ ᅡ ᄀ ᅩ
봐	ᄇ ᅪ
다이어트를	ᄃ ᅡ ᄋ ᅵ ᄋ ᅥ ᄐ ᅳ ᄅ ᅳ ᆯ
하려면	ᄒ ᅡ ᄅ ᅧ ᄆ ᅧ ᆫ
기초대사량을	ᄀ ᅵ ᄎ ᅩ ᄃ ᅢ ᄉ ᅡ ᄅ ᅣ ᆼ ᄋ ᅳ ᆯ
높이는	ᄂ ᅩ ᄑ ᅵ ᄂ ᅳ ᆫ
중요해	ᄌ ᅮ ᆼ ᄋ ᅭ ᄒ ᅢ
점심때	ᄌ ᅥ ᆷ ᄉ ᅵ ᆷ ᄄ ᅢ
상추를	ᄉ ᅡ ᆼ ᄎ ᅮ ᄅ ᅳ ᆯ
먹어서	ᄆ ᅥ ᄀ ᅥ ᄉ ᅥ
졸린	ᄌ ᅩ ᆯ ᄅ ᅵ ᆫ
아니라	ᄋ ᅡ ᄂ ᅵ ᄅ ᅡ
만성	ᄆ ᅡ ᆫ ᄉ ᅥ ᆼ
피로가	ᄑ ᅵ ᄅ ᅩ ᄀ ᅡ
문제야	ᄆ ᅮ ᆫ ᄌ ᅦ ᄋ ᅣ
커피를	ᄏ ᅥ ᄑ ᅵ ᄅ ᅳ ᆯ
마시면	ᄆ ᅡ ᄉ ᅵ ᄆ ᅧ ᆫ
이뇨작용이	ᄋ ᅵ ᄂ ᅭ ᄌ ᅡ ᄀ ᅭ ᆼ ᄋ ᅵ
심해져서	ᄉ ᅵ ᆷ ᄒ ᅢ ᄌ ᅥ ᄉ ᅥ
물을	ᄆ ᅮ ᄅ ᅳ ᆯ
더	ᄃ ᅥ
마셔줘야	ᄆ ᅡ ᄉ ᅧ ᄌ ᅯ ᄋ ᅣ
내	ᄂ ᅢ
동안의	ᄃ ᅩ ᆼ ᄋ ᅡ ᄂ ᅴ
비결은	ᄇ ᅵ ᄀ ᅧ ᄅ ᅳ ᆫ
육식보다는	ᄋ ᅲ ᆨ ᄊ ᅵ ᆨ ᄈ ᅩ ᄃ ᅡ ᄂ ᅳ ᆫ
채식을	ᄎ ᅢ ᄉ ᅵ ᄀ ᅳ ᆯ
선호한다는	ᄉ ᅥ ᆫ ᄒ ᅩ ᄒ ᅡ ᆫ ᄃ ᅡ ᄂ ᅳ ᆫ
거야	ᄀ ᅥ ᄋ ᅣ
건강	ᄀ ᅥ ᆫ ᄀ ᅡ ᆼ
검진	ᄀ ᅥ ᆷ ᄌ ᅵ ᆫ
예약이	ᄋ ᅨ ᄋ ᅣ ᄀ ᅵ
되어	ᄃ ᅬ ᄋ ᅥ
있어서	ᄋ ᅵ ᄊ ᅥ ᄉ ᅥ
금식이야	ᄀ ᅳ ᆷ ᄉ ᅵ ᄀ ᅵ ᄋ ᅣ
부모님의	ᄇ ᅮ ᄆ ᅩ ᄂ ᅵ ᄆ ᅴ
결혼기념일	ᄀ ᅧ ᆯ ᄒ ᅩ ᆫ ᄀ ᅵ ᄂ ᅧ ᄆ ᅵ ᆯ
선물로	ᄉ ᅥ ᆫ ᄆ ᅮ ᆯ ᄅ ᅩ
뭐가	ᄆ ᅯ ᄀ ᅡ
좋을까	ᄌ ᅩ ᄋ ᅳ ᆯ ᄁ ᅡ
피자는	ᄑ ᅵ ᄌ ᅡ ᄂ ᅳ ᆫ
이렇게	ᄋ ᅵ ᄅ ᅥ ᄏ ᅦ
손으로	ᄉ ᅩ ᄂ ᅳ ᄅ ᅩ
먹어야	ᄆ ᅥ ᄀ ᅥ ᄋ ᅣ
제	ᄌ ᅦ
맛이	ᄆ ᅡ ᄉ ᅵ
지	ᄌ ᅵ
비상구의	ᄇ ᅵ ᄉ ᅡ ᆼ ᄀ ᅮ ᄋ ᅴ
문을	ᄆ ᅮ ᄂ ᅳ ᆯ
잠그거나	ᄌ ᅡ ᆷ ᄀ ᅳ ᄀ ᅥ ᄂ ᅡ
물건을	ᄆ ᅮ ᆯ ᄀ ᅥ ᄂ ᅳ ᆯ
쌓아두는	ᄊ ᅡ ᄋ ᅡ ᄃ ᅮ ᄂ ᅳ ᆫ
건	ᄀ ᅥ ᆫ
불법이야	ᄇ ᅮ ᆯ ᄇ ᅥ ᄇ ᅵ ᄋ ᅣ
좋다고	ᄌ ᅩ ᄐ ᅡ ᄀ ᅩ
착각하는	ᄎ ᅡ ᆨ ᄁ ᅡ ᄏ ᅡ ᄂ ᅳ ᆫ
음식들이	ᄋ ᅳ ᆷ ᄉ ᅵ ᆨ ᄄ ᅳ ᄅ ᅵ
의외로	ᄋ ᅴ ᄋ ᅬ ᄅ ᅩ
많다고	ᄆ ᅡ ᆫ ᄐ ᅡ ᄀ ᅩ
온라인에서	ᄋ ᅩ ᆯ ᄅ ᅡ ᄋ ᅵ ᄂ ᅦ ᄉ ᅥ
졸업	ᄌ ᅩ ᄅ ᅥ ᆸ
증명서와	ᄌ ᅳ ᆼ ᄆ ᅧ ᆼ ᄉ ᅥ ᄋ ᅪ
성적	ᄉ ᅥ ᆼ ᄌ ᅥ ᆨ
증명서	ᄌ ᅳ ᆼ ᄆ ᅧ ᆼ ᄉ ᅥ
발급하는	ᄇ ᅡ ᆯ ᄀ ᅳ ᄑ ᅡ ᄂ ᅳ ᆫ
방법을	ᄇ ᅡ ᆼ ᄇ ᅥ ᄇ ᅳ ᆯ
알려주세요	ᄋ ᅡ ᆯ ᄅ ᅧ ᄌ ᅮ ᄉ ᅦ ᄋ ᅭ
추가	ᄎ ᅮ ᄀ ᅡ
주문하시겠습니까	ᄌ ᅮ ᄆ ᅮ ᆫ ᄒ ᅡ ᄉ ᅵ ᄀ ᅦ ᆮ ᄊ ᅳ ᆷ ᄂ ᅵ ᄁ ᅡ
레몬의	ᄅ ᅦ ᄆ ᅩ ᄂ ᅴ
상큼함이	ᄉ ᅡ ᆼ ᄏ ᅳ ᆷ ᄒ ᅡ ᄆ ᅵ
입	ᄋ ᅵ ᆸ
안	ᄋ ᅡ ᆫ
가득	ᄀ ᅡ ᄃ ᅳ ᆨ
퍼져요	ᄑ ᅥ ᄌ ᅥ ᄋ ᅭ
요즘	ᄋ ᅭ ᄌ ᅳ ᆷ
제주도에	ᄌ ᅦ ᄌ ᅮ ᄃ ᅩ ᄋ ᅦ
맹독을	ᄆ ᅢ ᆼ ᄃ ᅩ ᄀ ᅳ ᆯ
지닌	ᄌ ᅵ ᄂ ᅵ ᆫ
파란	ᄑ ᅡ ᄅ ᅡ ᆫ
고리문어가	ᄀ ᅩ ᄅ ᅵ ᄆ ᅮ ᄂ ᅥ ᄀ ᅡ
자주	ᄌ ᅡ ᄌ ᅮ
오랫동안	ᄋ ᅩ ᄅ ᅢ ᆮ ᄄ ᅩ ᆼ ᄋ ᅡ ᆫ
짝사랑해왔던	ᄍ ᅡ ᆨ ᄊ ᅡ ᄅ ᅡ ᆼ ᄒ ᅢ ᄋ ᅪ ᆮ ᄄ ᅥ ᆫ
지금	ᄌ ᅵ ᄀ ᅳ ᆷ
곁에	ᄀ ᅧ ᄐ ᅦ
있다는	ᄋ ᅵ ᆮ ᄄ ᅡ ᄂ ᅳ ᆫ
꿈만	ᄁ ᅮ ᆷ ᄆ ᅡ ᆫ
경치	ᄀ ᅧ ᆼ ᄎ ᅵ
좋고	ᄌ ᅩ ᄏ ᅩ
음식도	ᄋ ᅳ ᆷ ᄉ ᅵ ᆨ ᄄ ᅩ
맛있고	ᄆ ᅡ ᄉ ᅵ ᆮ ᄁ ᅩ
여행은	ᄋ ᅧ ᄒ ᅢ ᆼ ᄋ ᅳ ᆫ
대만족이야	ᄃ ᅢ ᄆ ᅡ ᆫ ᄌ ᅩ ᄀ ᅵ ᄋ ᅣ
보잘것없는	ᄇ ᅩ ᄌ ᅡ ᆯ ᄀ ᅥ ᄉ ᅥ ᆷ ᄂ ᅳ ᆫ
선물이지만	ᄉ ᅥ ᆫ ᄆ ᅮ ᄅ ᅵ ᄌ ᅵ ᄆ ᅡ ᆫ
좋아해	ᄌ ᅩ ᄋ ᅡ ᄒ ᅢ
주니까	ᄌ ᅮ ᄂ ᅵ ᄁ ᅡ
정말	ᄌ ᅥ ᆼ ᄆ ᅡ ᆯ
기뻐	ᄀ ᅵ ᄈ ᅥ
난	ᄂ ᅡ ᆫ
널	ᄂ ᅥ ᆯ
바라보고	ᄇ ᅡ ᄅ ᅡ ᄇ ᅩ ᄀ ᅩ
것만으로도	ᄀ ᅥ ᆫ ᄆ ᅡ ᄂ ᅳ ᄅ ᅩ ᄃ ᅩ
행복해	ᄒ ᅢ ᆼ ᄇ ᅩ ᄏ ᅢ
드디어	ᄃ ᅳ ᄃ ᅵ ᄋ ᅥ
내일이	ᄂ ᅢ ᄋ ᅵ ᄅ ᅵ
동안	ᄃ ᅩ ᆼ ᄋ ᅡ ᆫ
기다리던	ᄀ ᅵ ᄃ ᅡ ᄅ ᅵ ᄃ ᅥ ᆫ
월급날이라서	ᄋ ᅯ ᆯ ᄀ ᅳ ᆷ ᄂ ᅡ ᄅ ᅵ ᄅ ᅡ ᄉ ᅥ
그런지	ᄀ ᅳ ᄅ ᅥ ᆫ ᄌ ᅵ
기분	ᄀ ᅵ ᄇ ᅮ ᆫ
최고야	ᄎ ᅬ ᄀ ᅩ ᄋ ᅣ
항상	ᄒ ᅡ ᆼ ᄉ ᅡ ᆼ
옆에	ᄋ ᅧ ᄑ ᅦ
줘서	ᄌ ᅯ ᄉ ᅥ
고마워	ᄀ ᅩ ᄆ ᅡ ᄋ ᅯ
이런	ᄋ ᅵ ᄅ ᅥ ᆫ
선물까지	ᄉ ᅥ ᆫ ᄆ ᅮ ᆯ ᄁ ᅡ ᄌ ᅵ
주시고	ᄌ ᅮ ᄉ ᅵ ᄀ ᅩ
풀려서	ᄑ ᅮ ᆯ ᄅ ᅧ ᄉ ᅥ
살맛	ᄉ ᅡ ᆯ ᄆ ᅡ ᆮ
난다	ᄂ ᅡ ᆫ ᄃ ᅡ
에피소드	ᄋ ᅦ ᄑ ᅵ ᄉ ᅩ ᄃ ᅳ
진짜	ᄌ ᅵ ᆫ ᄍ ᅡ
재밌더라	ᄌ ᅢ ᄆ ᅵ ᆮ ᄄ ᅥ ᄅ ᅡ
해외여행은	ᄒ ᅢ ᄋ ᅬ ᄋ ᅧ ᄒ ᅢ ᆼ ᄋ ᅳ ᆫ
처음이라	ᄎ ᅥ ᄋ ᅳ ᄆ ᅵ ᄅ ᅡ
엄청나게	ᄋ ᅥ ᆷ ᄎ ᅥ ᆼ ᄂ ᅡ ᄀ ᅦ
들떠	ᄃ ᅳ ᆯ ᄄ ᅥ
곧	ᄀ ᅩ ᆮ
만날	ᄆ ᅡ ᆫ ᄂ ᅡ ᆯ
있다고	ᄋ ᅵ ᆮ ᄄ ᅡ ᄀ ᅩ
생각하니	ᄉ ᅢ ᆼ ᄀ ᅡ ᄏ ᅡ ᄂ ᅵ
너무	ᄂ ᅥ ᄆ ᅮ
설렌다	ᄉ ᅥ ᆯ ᄅ ᅦ ᆫ ᄃ ᅡ
친구야	ᄎ ᅵ ᆫ ᄀ ᅮ ᄋ ᅣ
축하해줘	ᄎ ᅮ ᄏ ᅡ ᄒ ᅢ ᄌ ᅯ
나	ᄂ ᅡ
여자친구	ᄋ ᅧ ᄌ ᅡ ᄎ ᅵ ᆫ ᄀ ᅮ
생겼어	ᄉ ᅢ ᆼ ᄀ ᅧ ᄊ ᅥ
먹자마자	ᄆ ᅥ ᆨ ᄍ ᅡ ᄆ ᅡ ᄌ ᅡ
안에서	ᄋ ᅡ ᄂ ᅦ ᄉ ᅥ
살살	ᄉ ᅡ ᆯ ᄉ ᅡ ᆯ
녹는데	ᄂ ᅩ ᆼ ᄂ ᅳ ᆫ ᄃ ᅦ
지금까지	ᄌ ᅵ ᄀ ᅳ ᆷ ᄁ ᅡ ᄌ ᅵ
뮤지컬	ᄆ ᅲ ᄌ ᅵ ᄏ ᅥ ᆯ
중에	ᄌ ᅮ ᆼ ᄋ ᅦ
무대가	ᄆ ᅮ ᄃ ᅢ ᄀ ᅡ
제일	ᄌ ᅦ ᄋ ᅵ ᆯ
멋졌어	ᄆ ᅥ ᆮ ᄍ ᅥ ᄊ ᅥ
집	ᄌ ᅵ ᆸ
강아지는	ᄀ ᅡ ᆼ ᄋ ᅡ ᄌ ᅵ ᄂ ᅳ ᆫ
하는	ᄒ ᅡ ᄂ ᅳ ᆫ
짓이	ᄌ ᅵ ᄉ ᅵ
귀엽고	ᄀ ᅱ ᄋ ᅧ ᆸ ᄁ ᅩ
사랑스러워	ᄉ ᅡ ᄅ ᅡ ᆼ ᄉ ᅳ ᄅ ᅥ ᄋ ᅯ
산	ᄉ ᅡ ᆫ
정상이라	ᄌ ᅥ ᆼ ᄉ ᅡ ᆼ ᄋ ᅵ ᄅ ᅡ
공기	ᄀ ᅩ ᆼ ᄀ ᅵ
상쾌하다	ᄉ ᅡ ᆼ ᄏ ᅫ ᄒ ᅡ ᄃ ᅡ
직구	ᄌ ᅵ ᆨ ᄁ ᅮ
성공해서	ᄉ ᅥ ᆼ ᄀ ᅩ ᆼ ᄒ ᅢ ᄉ ᅥ
콧노래가	ᄏ ᅩ ᆫ ᄂ ᅩ ᄅ ᅢ ᄀ ᅡ
절로	ᄌ ᅥ ᆯ ᄅ ᅩ
나와	ᄂ ᅡ ᄋ ᅪ
선물이	ᄉ ᅥ ᆫ ᄆ ᅮ ᄅ ᅵ
마음에	ᄆ ᅡ ᄋ ᅳ ᄆ ᅦ
들어	ᄃ ᅳ ᄅ ᅥ
소개팅	ᄉ ᅩ ᄀ ᅢ ᄐ ᅵ ᆼ
생각만	ᄉ ᅢ ᆼ ᄀ ᅡ ᆼ ᄆ ᅡ ᆫ
하면	ᄒ ᅡ ᄆ ᅧ ᆫ
자꾸만	ᄌ ᅡ ᄁ ᅮ ᄆ ᅡ ᆫ
웃음이	ᄋ ᅮ ᄉ ᅳ ᄆ ᅵ
너	ᄂ ᅥ
놈이구나	ᄂ ᅩ ᄆ ᅵ ᄀ ᅮ ᄂ ᅡ
여기	ᄋ ᅧ ᄀ ᅵ
레스토랑	ᄅ ᅦ ᄉ ᅳ ᄐ ᅩ ᄅ ᅡ ᆼ
분위기도	ᄇ ᅮ ᄂ ᅱ ᄀ ᅵ ᄃ ᅩ
근사한데	ᄀ ᅳ ᆫ ᄉ ᅡ ᄒ ᅡ ᆫ ᄃ ᅦ
가격	ᄀ ᅡ ᄀ ᅧ ᆨ
대비	ᄃ ᅢ ᄇ ᅵ
성능이	ᄉ ᅥ ᆼ ᄂ ᅳ ᆼ ᄋ ᅵ
꽤	ᄁ ᅫ
괜찮은	ᄀ ᅫ ᆫ ᄎ ᅡ ᄂ ᅳ ᆫ
걸	ᄀ ᅥ ᆯ
고양이	ᄀ ᅩ ᄋ ᅣ ᆼ ᄋ ᅵ
애교	ᄋ ᅢ ᄀ ᅭ
부리는	ᄇ ᅮ ᄅ ᅵ ᄂ ᅳ ᆫ
귀엽지	ᄀ ᅱ ᄋ ᅧ ᆸ ᄍ ᅵ
발표회	ᄇ ᅡ ᆯ ᄑ ᅭ ᄒ ᅬ
무대에서	ᄆ ᅮ ᄃ ᅢ ᄋ ᅦ ᄉ ᅥ
수진이가	ᄉ ᅮ ᄌ ᅵ ᄂ ᅵ ᄀ ᅡ
잘하던	ᄌ ᅡ ᆯ ᄒ ᅡ ᄃ ᅥ ᆫ
친구여서	ᄎ ᅵ ᆫ ᄀ ᅮ ᄋ ᅧ ᄉ ᅥ
든든하다	ᄃ ᅳ ᆫ ᄃ ᅳ ᆫ ᄒ ᅡ ᄃ ᅡ
역시	ᄋ ᅧ ᆨ ᄊ ᅵ
평양	ᄑ ᅧ ᆼ ᄋ ᅣ ᆼ
냉면이	ᄂ ᅢ ᆼ ᄆ ᅧ ᄂ ᅵ
전국에서	ᄌ ᅥ ᆫ ᄀ ᅮ ᄀ ᅦ ᄉ ᅥ
답답했던	ᄃ ᅡ ᆸ ᄄ ᅡ ᄑ ᅢ ᆮ ᄄ ᅥ ᆫ
속이	ᄉ ᅩ ᄀ ᅵ
뻥	ᄈ ᅥ ᆼ
뚫리는	ᄄ ᅮ ᆯ ᄅ ᅵ ᄂ ᅳ ᆫ
저	ᄌ ᅥ
남자	ᄂ ᅡ ᆷ ᄌ ᅡ
비현실적일	ᄇ ᅵ ᄒ ᅧ ᆫ ᄉ ᅵ ᆯ ᄌ ᅥ ᄀ ᅵ ᆯ
정도로	ᄌ ᅥ ᆼ ᄃ ᅩ ᄅ ᅩ
근사한	ᄀ ᅳ ᆫ ᄉ ᅡ ᄒ ᅡ ᆫ
통신사	ᄐ ᅩ ᆼ ᄉ ᅵ ᆫ ᄉ ᅡ
할인에	ᄒ ᅡ ᄅ ᅵ ᄂ ᅦ
오케이	ᄋ ᅩ ᄏ ᅦ ᄋ ᅵ
캐쉬백까지	ᄏ ᅢ ᄉ ᅱ ᄇ ᅢ ᆨ ᄁ ᅡ ᄌ ᅵ
완전	ᄋ ᅪ ᆫ ᄌ ᅥ ᆫ
굳었지요	ᄀ ᅮ ᄃ ᅥ ᆮ ᄍ ᅵ ᄋ ᅭ
작가가	ᄌ ᅡ ᆨ ᄁ ᅡ ᄀ ᅡ
웃기려고	ᄋ ᅮ ᆮ ᄁ ᅵ ᄅ ᅧ ᄀ ᅩ
작심했나	ᄌ ᅡ ᆨ ᄊ ᅵ ᆷ ᄒ ᅢ ᆫ ᄂ ᅡ
이거	ᄋ ᅵ ᄀ ᅥ
배꼽	ᄇ ᅢ ᄁ ᅩ ᆸ
빠지겠다	ᄈ ᅡ ᄌ ᅵ ᄀ ᅦ ᆮ ᄄ ᅡ
엄마	ᄋ ᅥ ᆷ ᄆ ᅡ
학교	ᄒ ᅡ ᆨ ᄁ ᅭ
백	ᄇ ᅢ ᆨ
미터	ᄆ ᅵ ᄐ ᅥ
달리기	ᄃ ᅡ ᆯ ᄅ ᅵ ᄀ ᅵ
신기록	ᄉ ᅵ ᆫ ᄀ ᅵ ᄅ ᅩ ᆨ
세웠어요	ᄉ ᅦ ᄋ ᅯ ᄊ ᅥ ᄋ ᅭ
모델	ᄆ ᅩ ᄃ ᅦ ᆯ
보는	ᄇ ᅩ ᄂ ᅳ ᆫ
것만으로	ᄀ ᅥ ᆫ ᄆ ᅡ ᄂ ᅳ ᄅ ᅩ
마음이	ᄆ ᅡ ᄋ ᅳ ᄆ ᅵ
훈훈해지네	ᄒ ᅮ ᆫ ᄒ ᅮ ᆫ ᄒ ᅢ ᄌ ᅵ ᄂ ᅦ
자기는	ᄌ ᅡ ᄀ ᅵ ᄂ ᅳ ᆫ
누구를	ᄂ ᅮ ᄀ ᅮ ᄅ ᅳ ᆯ
닮아서	ᄃ ᅡ ᆯ ᄆ ᅡ ᄉ ᅥ
예뻐	ᄋ ᅨ ᄈ ᅥ
예쁜	ᄋ ᅨ ᄈ ᅳ ᆫ
딸이	ᄄ ᅡ ᄅ ᅵ
뽀뽀해줘서	ᄈ ᅩ ᄈ ᅩ ᄒ ᅢ ᄌ ᅯ ᄉ ᅥ
아빠는	ᄋ ᅡ ᄈ ᅡ ᄂ ᅳ ᆫ
기분이	ᄀ ᅵ ᄇ ᅮ ᄂ ᅵ
날아갈	ᄂ ᅡ ᄅ ᅡ ᄀ ᅡ ᆯ
결혼식이라서	ᄀ ᅧ ᆯ ᄒ ᅩ ᆫ ᄉ ᅵ ᄀ ᅵ ᄅ ᅡ ᄉ ᅥ
설레서	ᄉ ᅥ ᆯ ᄅ ᅦ ᄉ ᅥ
잠이	ᄌ ᅡ ᄆ ᅵ
와	ᄋ ᅪ
십	ᄉ ᅵ ᆸ
년	ᄂ ᅧ ᆫ
준비한	ᄌ ᅮ ᆫ ᄇ ᅵ ᄒ ᅡ ᆫ
꿈이	ᄁ ᅮ ᄆ ᅵ
이루어졌어	ᄋ ᅵ ᄅ ᅮ ᄋ ᅥ ᄌ ᅥ ᄊ ᅥ
좋아하는	ᄌ ᅩ ᄋ ᅡ ᄒ ᅡ ᄂ ᅳ ᆫ
영화야	ᄋ ᅧ ᆼ ᄒ ᅪ ᄋ ᅣ
재밌겠지	ᄌ ᅢ ᄆ ᅵ ᆮ ᄁ ᅦ ᆮ ᄍ ᅵ
말로	ᄆ ᅡ ᆯ ᄅ ᅩ
표현할	ᄑ ᅭ ᄒ ᅧ ᆫ ᄒ ᅡ ᆯ
수가	ᄉ ᅮ ᄀ ᅡ
없을	ᄋ ᅥ ᆸ ᄊ ᅳ ᆯ
흐뭇하다	ᄒ ᅳ ᄆ ᅮ ᄐ ᅡ ᄃ ᅡ
울컥할	ᄋ ᅮ ᆯ ᄏ ᅥ ᄏ ᅡ ᆯ
따뜻해지는	ᄄ ᅡ ᄄ ᅳ ᄐ ᅢ ᄌ ᅵ ᄂ ᅳ ᆫ
장면이야	ᄌ ᅡ ᆼ ᄆ ᅧ ᄂ ᅵ ᄋ ᅣ
나를	ᄂ ᅡ ᄅ ᅳ ᆯ
준비했다니	ᄌ ᅮ ᆫ ᄇ ᅵ ᄒ ᅢ ᆮ ᄄ ᅡ ᄂ ᅵ
감동이야	ᄀ ᅡ ᆷ ᄃ ᅩ ᆼ ᄋ ᅵ ᄋ ᅣ
햇살도	ᄒ ᅢ ᄊ ᅡ ᆯ ᄃ ᅩ
바람도	ᄇ ᅡ ᄅ ᅡ ᆷ ᄃ ᅩ
선선하고	ᄉ ᅥ ᆫ ᄉ ᅥ ᆫ ᄒ ᅡ ᄀ ᅩ
날씨	ᄂ ᅡ ᆯ ᄊ ᅵ
좋죠	ᄌ ᅩ ᄎ ᅭ
결국	ᄀ ᅧ ᆯ ᄀ ᅮ ᆨ
해냈다니	ᄒ ᅢ ᄂ ᅢ ᆮ ᄄ ᅡ ᄂ ᅵ
자신이	ᄌ ᅡ ᄉ ᅵ ᄂ ᅵ
대견스러워	ᄃ ᅢ ᄀ ᅧ ᆫ ᄉ ᅳ ᄅ ᅥ ᄋ ᅯ
흥겨워서	ᄒ ᅳ ᆼ ᄀ ᅧ ᄋ ᅯ ᄉ ᅥ
노래가	ᄂ ᅩ ᄅ ᅢ ᄀ ᅡ
나는구먼	ᄂ ᅡ ᄂ ᅳ ᆫ ᄀ ᅮ ᄆ ᅥ ᆫ
신나서	ᄉ ᅵ ᆫ ᄂ ᅡ ᄉ ᅥ
춤이	ᄎ ᅮ ᄆ ᅵ
나네	ᄂ ᅡ ᄂ ᅦ
경사	ᄀ ᅧ ᆼ ᄉ ᅡ
났네	ᄂ ᅡ ᆫ ᄂ ᅦ
났어	ᄂ ᅡ ᄊ ᅥ
뭘	ᄆ ᅯ ᆯ
준비하시고	ᄌ ᅮ ᆫ ᄇ ᅵ ᄒ ᅡ ᄉ ᅵ ᄀ ᅩ
매번	ᄆ ᅢ ᄇ ᅥ ᆫ
고맙습니다	ᄀ ᅩ ᄆ ᅡ ᆸ ᄊ ᅳ ᆷ ᄂ ᅵ ᄃ ᅡ
너와	ᄂ ᅥ ᄋ ᅪ
함께	ᄒ ᅡ ᆷ ᄁ ᅦ
모든	ᄆ ᅩ ᄃ ᅳ ᆫ
시간이	ᄉ ᅵ ᄀ ᅡ ᄂ ᅵ
즐거워	ᄌ ᅳ ᆯ ᄀ ᅥ ᄋ ᅯ
딸	ᄄ ᅡ ᆯ
애교에	ᄋ ᅢ ᄀ ᅭ ᄋ ᅦ
녹는다	ᄂ ᅩ ᆼ ᄂ ᅳ ᆫ ᄃ ᅡ
녹아	ᄂ ᅩ ᄀ ᅡ
순간	ᄉ ᅮ ᆫ ᄀ ᅡ ᆫ
저는	ᄌ ᅥ ᄂ ᅳ ᆫ
운	ᄋ ᅮ ᆫ
사람입니다	ᄉ ᅡ ᄅ ᅡ ᄆ ᅵ ᆷ ᄂ ᅵ ᄃ ᅡ
천국이	ᄎ ᅥ ᆫ ᄀ ᅮ ᄀ ᅵ
따로	ᄄ ᅡ ᄅ ᅩ
있나	ᄋ ᅵ ᆫ ᄂ ᅡ
행복하면	ᄒ ᅢ ᆼ ᄇ ᅩ ᄏ ᅡ ᄆ ᅧ ᆫ
그곳이	ᄀ ᅳ ᄀ ᅩ ᄉ ᅵ
손님이	ᄉ ᅩ ᆫ ᄂ ᅵ ᄆ ᅵ
많아	ᄆ ᅡ ᄂ ᅡ
몸은	ᄆ ᅩ ᄆ ᅳ ᆫ
고돼도	ᄀ ᅩ ᄃ ᅫ ᄃ ᅩ
장사가	ᄌ ᅡ ᆼ ᄉ ᅡ ᄀ ᅡ
같은	ᄀ ᅡ ᄐ ᅳ ᆫ
사람이	ᄉ ᅡ ᄅ ᅡ ᄆ ᅵ
친구라니	ᄎ ᅵ ᆫ ᄀ ᅮ ᄅ ᅡ ᄂ ᅵ
행운아야	ᄒ ᅢ ᆼ ᄋ ᅮ ᄂ ᅡ ᄋ ᅣ
사장님	ᄉ ᅡ ᄌ ᅡ ᆼ ᄂ ᅵ ᆷ
오늘부로	ᄋ ᅩ ᄂ ᅳ ᆯ ᄇ ᅮ ᄅ ᅩ
아빠	ᄋ ᅡ ᄈ ᅡ
됐습니다	ᄃ ᅫ ᆮ ᄊ ᅳ ᆷ ᄂ ᅵ ᄃ ᅡ
자기야	ᄌ ᅡ ᄀ ᅵ ᄋ ᅣ
언니	ᄋ ᅥ ᆫ ᄂ ᅵ
사법고시	ᄉ ᅡ ᄇ ᅥ ᆸ ᄁ ᅩ ᄉ ᅵ
합격했어	ᄒ ᅡ ᆸ ᄁ ᅧ ᄏ ᅢ ᄊ ᅥ
순간이	ᄉ ᅮ ᆫ ᄀ ᅡ ᄂ ᅵ
영원했으면	ᄋ ᅧ ᆼ ᄋ ᅯ ᆫ ᄒ ᅢ ᄊ ᅳ ᄆ ᅧ ᆫ
좋겠다	ᄌ ᅩ ᄏ ᅦ ᆮ ᄄ ᅡ
하늘이	ᄒ ᅡ ᄂ ᅳ ᄅ ᅵ
청명하니	ᄎ ᅥ ᆼ ᄆ ᅧ ᆼ ᄒ ᅡ ᄂ ᅵ
기분도	ᄀ ᅵ ᄇ ᅮ ᆫ ᄃ ᅩ
웹	ᄋ ᅰ ᆸ
소설이	ᄉ ᅩ ᄉ ᅥ ᄅ ᅵ
순위권에	ᄉ ᅮ ᄂ ᅱ ᄀ ᅯ ᄂ ᅦ
들었다고요	ᄃ ᅳ ᄅ ᅥ ᆮ ᄄ ᅡ ᄀ ᅩ ᄋ ᅭ
오래간만에	ᄋ ᅩ ᄅ ᅢ ᄀ ᅡ ᆫ ᄆ ᅡ ᄂ ᅦ
기쁜	ᄀ ᅵ ᄈ ᅳ ᆫ
소식을	ᄉ ᅩ ᄉ ᅵ ᄀ ᅳ ᆯ
들으니	ᄃ ᅳ ᄅ ᅳ ᄂ ᅵ
좋네요	ᄌ ᅩ ᆫ ᄂ ᅦ ᄋ ᅭ
끝까지	ᄁ ᅳ ᆮ ᄁ ᅡ ᄌ ᅵ
최선을	ᄎ ᅬ ᄉ ᅥ ᄂ ᅳ ᆯ
다한	ᄃ ᅡ ᄒ ᅡ ᆫ
선수들	ᄉ ᅥ ᆫ ᄉ ᅮ ᄃ ᅳ ᆯ
자랑스럽습니다	ᄌ ᅡ ᄅ ᅡ ᆼ ᄉ ᅳ ᄅ ᅥ ᆸ ᄊ ᅳ ᆷ ᄂ ᅵ ᄃ ᅡ
영화에서나	ᄋ ᅧ ᆼ ᄒ ᅪ ᄋ ᅦ ᄉ ᅥ ᄂ ᅡ
볼	ᄇ ᅩ ᆯ
법한	ᄇ ᅥ ᄑ ᅡ ᆫ
풍경을	ᄑ ᅮ ᆼ ᄀ ᅧ ᆼ ᄋ ᅳ ᆯ
실제로	ᄉ ᅵ ᆯ ᄌ ᅦ ᄅ ᅩ
보다니	ᄇ ᅩ ᄃ ᅡ ᄂ ᅵ
황홀하다	ᄒ ᅪ ᆼ ᄒ ᅩ ᆯ ᄒ ᅡ ᄃ ᅡ
자식들	ᄌ ᅡ ᄉ ᅵ ᆨ ᄄ ᅳ ᆯ
덕을	ᄃ ᅥ ᄀ ᅳ ᆯ
톡톡히	ᄐ ᅩ ᆨ ᄐ ᅩ ᄏ ᅵ
보네	ᄇ ᅩ ᄂ ᅦ
그렇게	ᄀ ᅳ ᄅ ᅥ ᄏ ᅦ
칭찬해	ᄎ ᅵ ᆼ ᄎ ᅡ ᆫ ᄒ ᅢ
주시니	ᄌ ᅮ ᄉ ᅵ ᄂ ᅵ
몸	ᄆ ᅩ ᆷ
둘	ᄃ ᅮ ᆯ
바를	ᄇ ᅡ ᄅ ᅳ ᆯ
모르겠네요	ᄆ ᅩ ᄅ ᅳ ᄀ ᅦ ᆫ ᄂ ᅦ ᄋ ᅭ
선생님의	ᄉ ᅥ ᆫ ᄉ ᅢ ᆼ ᄂ ᅵ ᄆ ᅴ
지도로	ᄌ ᅵ ᄃ ᅩ ᄅ ᅩ
해낼	ᄒ ᅢ ᄂ ᅢ ᆯ
있었어요	ᄋ ᅵ ᄊ ᅥ ᄊ ᅥ ᄋ ᅭ
여기에다	ᄋ ᅧ ᄀ ᅵ ᄋ ᅦ ᄃ ᅡ
김치를	ᄀ ᅵ ᆷ ᄎ ᅵ ᄅ ᅳ ᆯ
딱	ᄄ ᅡ ᆨ
얹어	ᄋ ᅥ ᆫ ᄌ ᅥ
먹으면	ᄆ ᅥ ᄀ ᅳ ᄆ ᅧ ᆫ
그만이야	ᄀ ᅳ ᄆ ᅡ ᄂ ᅵ ᄋ ᅣ
다른	ᄃ ᅡ ᄅ ᅳ ᆫ
몰라도	ᄆ ᅩ ᆯ ᄅ ᅡ ᄃ ᅩ
겉절이는	ᄀ ᅥ ᆮ ᄍ ᅥ ᄅ ᅵ ᄂ ᅳ ᆫ
끝내준다니까	ᄁ ᅳ ᆫ ᄂ ᅢ ᄌ ᅮ ᆫ ᄃ ᅡ ᄂ ᅵ ᄁ ᅡ
쥐구멍에도	ᄌ ᅱ ᄀ ᅮ ᄆ ᅥ ᆼ ᄋ ᅦ ᄃ ᅩ
볕들	ᄇ ᅧ ᆮ ᄄ ᅳ ᆯ
날이	ᄂ ᅡ ᄅ ᅵ
있다더니	ᄋ ᅵ ᆮ ᄄ ᅡ ᄃ ᅥ ᄂ ᅵ
인생에도	ᄋ ᅵ ᆫ ᄉ ᅢ ᆼ ᄋ ᅦ ᄃ ᅩ
영광이	ᄋ ᅧ ᆼ ᄀ ᅪ ᆼ ᄋ ᅵ
비치는구나	ᄇ ᅵ ᄎ ᅵ ᄂ ᅳ ᆫ ᄀ ᅮ ᄂ ᅡ
바로	ᄇ ᅡ ᄅ ᅩ
날을	ᄂ ᅡ ᄅ ᅳ ᆯ
위해서	ᄋ ᅱ ᄒ ᅢ ᄉ ᅥ
살아온	ᄉ ᅡ ᄅ ᅡ ᄋ ᅩ ᆫ
거	ᄀ ᅥ
아니겠어	ᄋ ᅡ ᄂ ᅵ ᄀ ᅦ ᄊ ᅥ
반	ᄇ ᅡ ᆫ
학생들의	ᄒ ᅡ ᆨ ᄊ ᅢ ᆼ ᄃ ᅳ ᄅ ᅴ
수학	ᄉ ᅮ ᄒ ᅡ ᆨ
실력이	ᄉ ᅵ ᆯ ᄅ ᅧ ᄀ ᅵ
날로	ᄂ ᅡ ᆯ ᄅ ᅩ
일취월장하네	ᄋ ᅵ ᆯ ᄎ ᅱ ᄋ ᅯ ᆯ ᄌ ᅡ ᆼ ᄒ ᅡ ᄂ ᅦ
이러니	ᄋ ᅵ ᄅ ᅥ ᄂ ᅵ
어떻게	ᄋ ᅥ ᄄ ᅥ ᄏ ᅦ
너를	ᄂ ᅥ ᄅ ᅳ ᆯ
사랑하지	ᄉ ᅡ ᄅ ᅡ ᆼ ᄒ ᅡ ᄌ ᅵ
않고	ᄋ ᅡ ᆫ ᄏ ᅩ
배기겠니	ᄇ ᅢ ᄀ ᅵ ᄀ ᅦ ᆫ ᄂ ᅵ
첫	ᄎ ᅥ ᆮ
아이가	ᄋ ᅡ ᄋ ᅵ ᄀ ᅡ
태어난	ᄐ ᅢ ᄋ ᅥ ᄂ ᅡ ᆫ
기쁨은	ᄀ ᅵ ᄈ ᅳ ᄆ ᅳ ᆫ
평생	ᄑ ᅧ ᆼ ᄉ ᅢ ᆼ
잊지	ᄋ ᅵ ᆮ ᄍ ᅵ
못할	ᄆ ᅩ ᄐ ᅡ ᆯ
풍경이	ᄑ ᅮ ᆼ ᄀ ᅧ ᆼ ᄋ ᅵ
아름다워서	ᄋ ᅡ ᄅ ᅳ ᆷ ᄃ ᅡ ᄋ ᅯ ᄉ ᅥ
가슴이	ᄀ ᅡ ᄉ ᅳ ᄆ ᅵ
뭉클할	ᄆ ᅮ ᆼ ᄏ ᅳ ᆯ ᄒ ᅡ ᆯ
정도야	ᄌ ᅥ ᆼ ᄃ ᅩ ᄋ ᅣ
도전에	ᄃ ᅩ ᄌ ᅥ ᄂ ᅦ
성공했다니	ᄉ ᅥ ᆼ ᄀ ᅩ ᆼ ᄒ ᅢ ᆮ ᄄ ᅡ ᄂ ᅵ
벅차올라서	ᄇ ᅥ ᆨ ᄎ ᅡ ᄋ ᅩ ᆯ ᄅ ᅡ ᄉ ᅥ
울구	ᄋ ᅮ ᆯ ᄀ ᅮ
싶다	ᄉ ᅵ ᆸ ᄄ ᅡ
이따	ᄋ ᅵ ᄄ ᅡ
친구들이랑	ᄎ ᅵ ᆫ ᄀ ᅮ ᄃ ᅳ ᄅ ᅵ ᄅ ᅡ ᆼ
놀러	ᄂ ᅩ ᆯ ᄅ ᅥ
갈	ᄀ ᅡ ᆯ
생각하니까	ᄉ ᅢ ᆼ ᄀ ᅡ ᄏ ᅡ ᄂ ᅵ ᄁ ᅡ
흥분된다	ᄒ ᅳ ᆼ ᄇ ᅮ ᆫ ᄃ ᅬ ᆫ ᄃ ᅡ
맛있는	ᄆ ᅡ ᄉ ᅵ ᆫ ᄂ ᅳ ᆫ
것도	ᄀ ᅥ ᆮ ᄄ ᅩ
먹고	ᄆ ᅥ ᆨ ᄁ ᅩ
재밌게	ᄌ ᅢ ᄆ ᅵ ᆮ ᄁ ᅦ
놀아야지	ᄂ ᅩ ᄅ ᅡ ᄋ ᅣ ᄌ ᅵ
기대된다	ᄀ ᅵ ᄃ ᅢ ᄃ ᅬ ᆫ ᄃ ᅡ
내게	ᄂ ᅢ ᄀ ᅦ
행운이	ᄒ ᅢ ᆼ ᄋ ᅮ ᄂ ᅵ
찾아왔다니	ᄎ ᅡ ᄌ ᅡ ᄋ ᅪ ᆮ ᄄ ᅡ ᄂ ᅵ
실감이	ᄉ ᅵ ᆯ ᄀ ᅡ ᄆ ᅵ
마치	ᄆ ᅡ ᄎ ᅵ
구름	ᄀ ᅮ ᄅ ᅳ ᆷ
위를	ᄋ ᅱ ᄅ ᅳ ᆯ
걷는	ᄀ ᅥ ᆫ ᄂ ᅳ ᆫ
기분이야	ᄀ ᅵ ᄇ ᅮ ᄂ ᅵ ᄋ ᅣ
학자금	ᄒ ᅡ ᆨ ᄍ ᅡ ᄀ ᅳ ᆷ
대출을	ᄃ ᅢ ᄎ ᅮ ᄅ ᅳ ᆯ
갚고	ᄀ ᅡ ᆸ ᄁ ᅩ
나니까	ᄂ ᅡ ᄂ ᅵ ᄁ ᅡ
홀가분해졌어	ᄒ ᅩ ᆯ ᄀ ᅡ ᄇ ᅮ ᆫ ᄒ ᅢ ᄌ ᅥ ᄊ ᅥ
소프라노의	ᄉ ᅩ ᄑ ᅳ ᄅ ᅡ ᄂ ᅩ ᄋ ᅴ
목소리가	ᄆ ᅩ ᆨ ᄊ ᅩ ᄅ ᅵ ᄀ ᅡ
어릴	ᄋ ᅥ ᄅ ᅵ ᆯ
때	ᄄ ᅢ
먹었던	ᄆ ᅥ ᄀ ᅥ ᆮ ᄄ ᅥ ᆫ
솜사탕처럼	ᄉ ᅩ ᆷ ᄉ ᅡ ᄐ ᅡ ᆼ ᄎ ᅥ ᄅ ᅥ ᆷ
감미롭다	ᄀ ᅡ ᆷ ᄆ ᅵ ᄅ ᅩ ᆸ ᄄ ᅡ
남자친구가	ᄂ ᅡ ᆷ ᄌ ᅡ ᄎ ᅵ ᆫ ᄀ ᅮ ᄀ ᅡ
몰래	ᄆ ᅩ ᆯ ᄅ ᅢ
깜짝	ᄁ ᅡ ᆷ ᄍ ᅡ ᆨ
생일	ᄉ ᅢ ᆼ ᄋ ᅵ ᆯ
파티에	ᄑ ᅡ ᄐ ᅵ ᄋ ᅦ
감동했어	ᄀ ᅡ ᆷ ᄃ ᅩ ᆼ ᄒ ᅢ ᄊ ᅥ
사람의	ᄉ ᅡ ᄅ ᅡ ᄆ ᅴ
호탕한	ᄒ ᅩ ᄐ ᅡ ᆼ ᄒ ᅡ ᆫ
웃음소리를	ᄋ ᅮ ᄉ ᅳ ᆷ ᄉ ᅩ ᄅ ᅵ ᄅ ᅳ ᆯ
듣고	ᄃ ᅳ ᆮ ᄁ ᅩ
있으면	ᄋ ᅵ ᄊ ᅳ ᄆ ᅧ ᆫ
나까지	ᄂ ᅡ ᄁ ᅡ ᄌ ᅵ
유쾌해져	ᄋ ᅲ ᄏ ᅫ ᄒ ᅢ ᄌ ᅥ
호텔	ᄒ ᅩ ᄐ ᅦ ᆯ
시설이	ᄉ ᅵ ᄉ ᅥ ᄅ ᅵ
예약	ᄋ ᅨ ᄋ ᅣ ᆨ
사이트에서	ᄉ ᅡ ᄋ ᅵ ᄐ ᅳ ᄋ ᅦ ᄉ ᅥ
것보다	ᄀ ᅥ ᆮ ᄈ ᅩ ᄃ ᅡ
깨끗하고	ᄁ ᅢ ᄁ ᅳ ᄐ ᅡ ᄀ ᅩ
쾌적해서	ᄏ ᅫ ᄌ ᅥ ᄏ ᅢ ᄉ ᅥ
만족스러워	ᄆ ᅡ ᆫ ᄌ ᅩ ᆨ ᄊ ᅳ ᄅ ᅥ ᄋ ᅯ
배고팠는데	ᄇ ᅢ ᄀ ᅩ ᄑ ᅡ ᆫ ᄂ ᅳ ᆫ ᄃ ᅦ
이제야	ᄋ ᅵ ᄌ ᅦ ᄋ ᅣ
살	ᄉ ᅡ ᆯ
일일	ᄋ ᅵ ᄅ ᅵ ᆯ
일	ᄋ ᅵ ᆯ
팩	ᄑ ᅢ ᆨ
실천하고	ᄉ ᅵ ᆯ ᄎ ᅥ ᆫ ᄒ ᅡ ᄀ ᅩ
있거든	ᄋ ᅵ ᆮ ᄁ ᅥ ᄃ ᅳ ᆫ
얼굴에서	ᄋ ᅥ ᆯ ᄀ ᅮ ᄅ ᅦ ᄉ ᅥ
빛이	ᄇ ᅵ ᄎ ᅵ
나지	ᄂ ᅡ ᄌ ᅵ
갑자기	ᄀ ᅡ ᆸ ᄍ ᅡ ᄀ ᅵ
쏟아지던	ᄊ ᅩ ᄃ ᅡ ᄌ ᅵ ᄃ ᅥ ᆫ
그치고	ᄀ ᅳ ᄎ ᅵ ᄀ ᅩ
나니	ᄂ ᅡ ᄂ ᅵ
날씨가	ᄂ ᅡ ᆯ ᄊ ᅵ ᄀ ᅡ
화창해졌어	ᄒ ᅪ ᄎ ᅡ ᆼ ᄒ ᅢ ᄌ ᅥ ᄊ ᅥ
주말에	ᄌ ᅮ ᄆ ᅡ ᄅ ᅦ
푹	ᄑ ᅮ ᆨ
쉬어서	ᄉ ᅱ ᄋ ᅥ ᄉ ᅥ
월요일	ᄋ ᅯ ᄅ ᅭ ᄋ ᅵ ᆯ
아침을	ᄋ ᅡ ᄎ ᅵ ᄆ ᅳ ᆯ
활기차게	ᄒ ᅪ ᆯ ᄀ ᅵ ᄎ ᅡ ᄀ ᅦ
성과가	ᄉ ᅥ ᆼ ᄀ ᅪ ᄀ ᅡ
나오기	ᄂ ᅡ ᄋ ᅩ ᄀ ᅵ
시작했어	ᄉ ᅵ ᄌ ᅡ ᄏ ᅢ ᄊ ᅥ
기다린	ᄀ ᅵ ᄃ ᅡ ᄅ ᅵ ᆫ
보람이	ᄇ ᅩ ᄅ ᅡ ᄆ ᅵ
다행이야	ᄃ ᅡ ᄒ ᅢ ᆼ ᄋ ᅵ ᄋ ᅣ
미숙아였던	ᄆ ᅵ ᄉ ᅮ ᄀ ᅡ ᄋ ᅧ ᆮ ᄄ ᅥ ᆫ
아들	ᄋ ᅡ ᄃ ᅳ ᆯ
녀석이	ᄂ ᅧ ᄉ ᅥ ᄀ ᅵ
씩씩하고	ᄊ ᅵ ᆨ ᄊ ᅵ ᄏ ᅡ ᄀ ᅩ
건강하게	ᄀ ᅥ ᆫ ᄀ ᅡ ᆼ ᄒ ᅡ ᄀ ᅦ
자라줘서	ᄌ ᅡ ᄅ ᅡ ᄌ ᅯ ᄉ ᅥ
대견해요	ᄃ ᅢ ᄀ ᅧ ᆫ ᄒ ᅢ ᄋ ᅭ
다행히	ᄃ ᅡ ᄒ ᅢ ᆼ ᄒ ᅵ
배	ᄇ ᅢ
속에	ᄉ ᅩ ᄀ ᅦ
크고	ᄏ ᅳ ᄀ ᅩ
있대요	ᄋ ᅵ ᆮ ᄄ ᅢ ᄋ ᅭ
연락이	ᄋ ᅧ ᆯ ᄅ ᅡ ᄀ ᅵ
끊겼던	ᄁ ᅳ ᆫ ᄏ ᅧ ᆮ ᄄ ᅥ ᆫ
친구의	ᄎ ᅵ ᆫ ᄀ ᅮ ᄋ ᅴ
알게	ᄋ ᅡ ᆯ ᄀ ᅦ
됐어요	ᄃ ᅫ ᄊ ᅥ ᄋ ᅭ
천진난만한	ᄎ ᅥ ᆫ ᄌ ᅵ ᆫ ᄂ ᅡ ᆫ ᄆ ᅡ ᆫ ᄒ ᅡ ᆫ
아이들의	ᄋ ᅡ ᄋ ᅵ ᄃ ᅳ ᄅ ᅴ
미소를	ᄆ ᅵ ᄉ ᅩ ᄅ ᅳ ᆯ
보니	ᄇ ᅩ ᄂ ᅵ
좋아지네요	ᄌ ᅩ ᄋ ᅡ ᄌ ᅵ ᄂ ᅦ ᄋ ᅭ
메리	ᄆ ᅦ ᄅ ᅵ
크리스마스	ᄏ ᅳ ᄅ ᅵ ᄉ ᅳ ᄆ ᅡ ᄉ ᅳ
즐거운	ᄌ ᅳ ᆯ ᄀ ᅥ ᄋ ᅮ ᆫ
성탄절	ᄉ ᅥ ᆼ ᄐ ᅡ ᆫ ᄌ ᅥ ᆯ
보내세요	ᄇ ᅩ ᄂ ᅢ ᄉ ᅦ ᄋ ᅭ
우리의	ᄋ ᅮ ᄅ ᅵ ᄋ ᅴ
만남을	ᄆ ᅡ ᆫ ᄂ ᅡ ᄆ ᅳ ᆯ
축복하듯	ᄎ ᅮ ᆨ ᄈ ᅩ ᄏ ᅡ ᄃ ᅳ ᆮ
하늘에서	ᄒ ᅡ ᄂ ᅳ ᄅ ᅦ ᄉ ᅥ
벚꽃이	ᄇ ᅥ ᆮ ᄁ ᅩ ᄎ ᅵ
흩날리네요	ᄒ ᅳ ᆫ ᄂ ᅡ ᆯ ᄅ ᅵ ᄂ ᅦ ᄋ ᅭ
좋게	ᄌ ᅩ ᄏ ᅦ
비행기	ᄇ ᅵ ᄒ ᅢ ᆼ ᄀ ᅵ
좌석을	ᄌ ᅪ ᄉ ᅥ ᄀ ᅳ ᆯ
업그레이드	ᄋ ᅥ ᆸ ᄁ ᅳ ᄅ ᅦ ᄋ ᅵ ᄃ ᅳ
받았어요	ᄇ ᅡ ᄃ ᅡ ᄊ ᅥ ᄋ ᅭ
연탄	ᄋ ᅧ ᆫ ᄐ ᅡ ᆫ
배달	ᄇ ᅢ ᄃ ᅡ ᆯ
봉사	ᄇ ᅩ ᆼ ᄉ ᅡ
활동을	ᄒ ᅪ ᆯ ᄃ ᅩ ᆼ ᄋ ᅳ ᆯ
했는데	ᄒ ᅢ ᆫ ᄂ ᅳ ᆫ ᄃ ᅦ
힘들었지만	ᄒ ᅵ ᆷ ᄃ ᅳ ᄅ ᅥ ᆮ ᄍ ᅵ ᄆ ᅡ ᆫ
나눔의	ᄂ ᅡ ᄂ ᅮ ᄆ ᅴ
기쁨이란	ᄀ ᅵ ᄈ ᅳ ᄆ ᅵ ᄅ ᅡ ᆫ
시험이	ᄉ ᅵ ᄒ ᅥ ᄆ ᅵ
끝났어	ᄁ ᅳ ᆫ ᄂ ᅡ ᄊ ᅥ
신나게	ᄉ ᅵ ᆫ ᄂ ᅡ ᄀ ᅦ
즐길	ᄌ ᅳ ᆯ ᄀ ᅵ ᆯ
제가	ᄌ ᅦ ᄀ ᅡ
유럽	ᄋ ᅲ ᄅ ᅥ ᆸ
여행에	ᄋ ᅧ ᄒ ᅢ ᆼ ᄋ ᅦ
당첨됐다고요	ᄃ ᅡ ᆼ ᄎ ᅥ ᆷ ᄃ ᅫ ᆮ ᄄ ᅡ ᄀ ᅩ ᄋ ᅭ
나의	ᄂ ᅡ ᄋ ᅴ
고백을	ᄀ ᅩ ᄇ ᅢ ᄀ ᅳ ᆯ
받아줘서	ᄇ ᅡ ᄃ ᅡ ᄌ ᅯ ᄉ ᅥ
세상을	ᄉ ᅦ ᄉ ᅡ ᆼ ᄋ ᅳ ᆯ
가진	ᄀ ᅡ ᄌ ᅵ ᆫ
것만	ᄀ ᅥ ᆫ ᄆ ᅡ ᆫ
같아요	ᄀ ᅡ ᄐ ᅡ ᄋ ᅭ
저에게	ᄌ ᅥ ᄋ ᅦ ᄀ ᅦ
올지는	ᄋ ᅩ ᆯ ᄌ ᅵ ᄂ ᅳ ᆫ
몰랐어요	ᄆ ᅩ ᆯ ᄅ ᅡ ᄊ ᅥ ᄋ ᅭ
이번에	ᄋ ᅵ ᄇ ᅥ ᄂ ᅦ
제대로	ᄌ ᅦ ᄃ ᅢ ᄅ ᅩ
횡재했어	ᄒ ᅬ ᆼ ᄌ ᅢ ᄒ ᅢ ᄊ ᅥ
가격도	ᄀ ᅡ ᄀ ᅧ ᆨ ᄄ ᅩ
가격이지만	ᄀ ᅡ ᄀ ᅧ ᄀ ᅵ ᄌ ᅵ ᄆ ᅡ ᆫ
원	ᄋ ᅯ ᆫ
플러스	ᄑ ᅳ ᆯ ᄅ ᅥ ᄉ ᅳ
원이지	ᄋ ᅯ ᄂ ᅵ ᄌ ᅵ
뭐야	ᄆ ᅯ ᄋ ᅣ
어떡해	ᄋ ᅥ ᄄ ᅥ ᄏ ᅢ
면접	ᄆ ᅧ ᆫ ᄌ ᅥ ᆸ
숨겨둔	ᄉ ᅮ ᆷ ᄀ ᅧ ᄃ ᅮ ᆫ
비상금도	ᄇ ᅵ ᄉ ᅡ ᆼ ᄀ ᅳ ᆷ ᄃ ᅩ
모른	ᄆ ᅩ ᄅ ᅳ ᆫ
척해주고	ᄎ ᅥ ᄏ ᅢ ᄌ ᅮ ᄀ ᅩ
마누라	ᄆ ᅡ ᄂ ᅮ ᄅ ᅡ
최고	ᄎ ᅬ ᄀ ᅩ
너한테	ᄂ ᅥ ᄒ ᅡ ᆫ ᄐ ᅦ
말을	ᄆ ᅡ ᄅ ᅳ ᆯ
들으니까	ᄃ ᅳ ᄅ ᅳ ᄂ ᅵ ᄁ ᅡ
아프다	ᄋ ᅡ ᄑ ᅳ ᄃ ᅡ
좋아했던	ᄌ ᅩ ᄋ ᅡ ᄒ ᅢ ᆮ ᄄ ᅥ ᆫ
배우였는데	ᄇ ᅢ ᄋ ᅮ ᄋ ᅧ ᆫ ᄂ ᅳ ᆫ ᄃ ᅦ
그런	ᄀ ᅳ ᄅ ᅥ ᆫ
사고를	ᄉ ᅡ ᄀ ᅩ ᄅ ᅳ ᆯ
당했다니	ᄃ ᅡ ᆼ ᄒ ᅢ ᆮ ᄄ ᅡ ᄂ ᅵ
속상해	ᄉ ᅩ ᆨ ᄊ ᅡ ᆼ ᄒ ᅢ
입영	ᄋ ᅵ ᄇ ᅧ ᆼ
통지서를	ᄐ ᅩ ᆼ ᄌ ᅵ ᄉ ᅥ ᄅ ᅳ ᆯ
받았거든	ᄇ ᅡ ᄃ ᅡ ᆮ ᄁ ᅥ ᄃ ᅳ ᆫ
우울해	ᄋ ᅮ ᄋ ᅮ ᆯ ᄒ ᅢ
어머니가	ᄋ ᅥ ᄆ ᅥ ᄂ ᅵ ᄀ ᅡ
장례식에	ᄌ ᅡ ᆼ ᄂ ᅨ ᄉ ᅵ ᄀ ᅦ
다녀온	ᄃ ᅡ ᄂ ᅧ ᄋ ᅩ ᆫ
후로	ᄒ ᅮ ᄅ ᅩ
계속	ᄀ ᅨ ᄉ ᅩ ᆨ
기운이	ᄀ ᅵ ᄋ ᅮ ᄂ ᅵ
없으셔서	ᄋ ᅥ ᆸ ᄊ ᅳ ᄉ ᅧ ᄉ ᅥ
걱정된다	ᄀ ᅥ ᆨ ᄍ ᅥ ᆼ ᄃ ᅬ ᆫ ᄃ ᅡ
선생님	ᄉ ᅥ ᆫ ᄉ ᅢ ᆼ ᄂ ᅵ ᆷ
애석한	ᄋ ᅢ ᄉ ᅥ ᄏ ᅡ ᆫ
금할	ᄀ ᅳ ᆷ ᄒ ᅡ ᆯ
길이	ᄀ ᅵ ᄅ ᅵ
너까지	ᄂ ᅥ ᄁ ᅡ ᄌ ᅵ
말할	ᄆ ᅡ ᆯ ᄒ ᅡ ᆯ
줄이야	ᄌ ᅮ ᄅ ᅵ ᄋ ᅣ
서럽다	ᄉ ᅥ ᄅ ᅥ ᆸ ᄄ ᅡ
위로가	ᄋ ᅱ ᄅ ᅩ ᄀ ᅡ
필요한데	ᄑ ᅵ ᄅ ᅭ ᄒ ᅡ ᆫ ᄃ ᅦ
아무도	ᄋ ᅡ ᄆ ᅮ ᄃ ᅩ
없으니	ᄋ ᅥ ᆸ ᄊ ᅳ ᄂ ᅵ
울적해	ᄋ ᅮ ᆯ ᄌ ᅥ ᄏ ᅢ
다시	ᄃ ᅡ ᄉ ᅵ
못	ᄆ ᅩ ᆮ
본다고	ᄇ ᅩ ᆫ ᄃ ᅡ ᄀ ᅩ
눈물만	ᄂ ᅮ ᆫ ᄆ ᅮ ᆯ ᄆ ᅡ ᆫ
고시원에서도	ᄀ ᅩ ᄉ ᅵ ᄋ ᅯ ᄂ ᅦ ᄉ ᅥ ᄃ ᅩ
쫓겨나고	ᄍ ᅩ ᆮ ᄁ ᅧ ᄂ ᅡ ᄀ ᅩ
처지가	ᄎ ᅥ ᄌ ᅵ ᄀ ᅡ
서글퍼서	ᄉ ᅥ ᄀ ᅳ ᆯ ᄑ ᅥ ᄉ ᅥ
울고	ᄋ ᅮ ᆯ ᄀ ᅩ
싶어	ᄉ ᅵ ᄑ ᅥ
친구들	ᄎ ᅵ ᆫ ᄀ ᅮ ᄃ ᅳ ᆯ
집이나	ᄌ ᅵ ᄇ ᅵ ᄂ ᅡ
전전하는	ᄌ ᅥ ᆫ ᄌ ᅥ ᆫ ᄒ ᅡ ᄂ ᅳ ᆫ
신세가	ᄉ ᅵ ᆫ ᄉ ᅦ ᄀ ᅡ
처량하다	ᄎ ᅥ ᄅ ᅣ ᆼ ᄒ ᅡ ᄃ ᅡ
시골	ᄉ ᅵ ᄀ ᅩ ᆯ
부모님이	ᄇ ᅮ ᄆ ᅩ ᄂ ᅵ ᄆ ᅵ
보내주신	ᄇ ᅩ ᄂ ᅢ ᄌ ᅮ ᄉ ᅵ ᆫ
한약을	ᄒ ᅡ ᄂ ᅣ ᄀ ᅳ ᆯ
목이	ᄆ ᅩ ᄀ ᅵ
멘다	ᄆ ᅦ ᆫ ᄃ ᅡ
해준	ᄒ ᅢ ᄌ ᅮ ᆫ
얼만데	ᄋ ᅥ ᆯ ᄆ ᅡ ᆫ ᄃ ᅦ
섭섭하다	ᄉ ᅥ ᆸ ᄊ ᅥ ᄑ ᅡ ᄃ ᅡ
투병	ᄐ ᅮ ᄇ ᅧ ᆼ
중이시라는	ᄌ ᅮ ᆼ ᄋ ᅵ ᄉ ᅵ ᄅ ᅡ ᄂ ᅳ ᆫ
그분	ᄀ ᅳ ᄇ ᅮ ᆫ
부자는	ᄇ ᅮ ᄌ ᅡ ᄂ ᅳ ᆫ
망해도	ᄆ ᅡ ᆼ ᄒ ᅢ ᄃ ᅩ
삼대는	ᄉ ᅡ ᆷ ᄃ ᅢ ᄂ ᅳ ᆫ
간다던데	ᄀ ᅡ ᆫ ᄃ ᅡ ᄃ ᅥ ᆫ ᄃ ᅦ
사정이	ᄉ ᅡ ᄌ ᅥ ᆼ ᄋ ᅵ
딱하게	ᄄ ᅡ ᄏ ᅡ ᄀ ᅦ
됐어	ᄃ ᅫ ᄊ ᅥ
프로젝트가	ᄑ ᅳ ᄅ ᅩ ᄌ ᅦ ᆨ ᄐ ᅳ ᄀ ᅡ
무산됐다니	ᄆ ᅮ ᄉ ᅡ ᆫ ᄃ ᅫ ᆮ ᄄ ᅡ ᄂ ᅵ
다했는데	ᄃ ᅡ ᄒ ᅢ ᆫ ᄂ ᅳ ᆫ ᄃ ᅦ
안타깝다	ᄋ ᅡ ᆫ ᄐ ᅡ ᄁ ᅡ ᆸ ᄄ ᅡ
계약	ᄀ ᅨ ᄋ ᅣ ᆨ
종료인데	ᄌ ᅩ ᆼ ᄂ ᅭ ᄋ ᅵ ᆫ ᄃ ᅦ
열심히	ᄋ ᅧ ᆯ ᄉ ᅵ ᆷ ᄒ ᅵ
애쓰는	ᄋ ᅢ ᄊ ᅳ ᄂ ᅳ ᆫ
모습이	ᄆ ᅩ ᄉ ᅳ ᄇ ᅵ
안쓰러워	ᄋ ᅡ ᆫ ᄊ ᅳ ᄅ ᅥ ᄋ ᅯ
죽겠어	ᄌ ᅮ ᆨ ᄁ ᅦ ᄊ ᅥ
주인이	ᄌ ᅮ ᄋ ᅵ ᄂ ᅵ
교통사고라며	ᄀ ᅭ ᄐ ᅩ ᆼ ᄉ ᅡ ᄀ ᅩ ᄅ ᅡ ᄆ ᅧ
불쌍해서	ᄇ ᅮ ᆯ ᄊ ᅡ ᆼ ᄒ ᅢ ᄉ ᅥ
또	ᄄ ᅩ
불합격	ᄇ ᅮ ᆯ ᄒ ᅡ ᆸ ᄁ ᅧ ᆨ
괴로워서	ᄀ ᅬ ᄅ ᅩ ᄋ ᅯ ᄉ ᅥ
숨이	ᄉ ᅮ ᄆ ᅵ
쉬어져	ᄉ ᅱ ᄋ ᅥ ᄌ ᅥ
술에	ᄉ ᅮ ᄅ ᅦ
취한	ᄎ ᅱ ᄒ ᅡ ᆫ
아버지의	ᄋ ᅡ ᄇ ᅥ ᄌ ᅵ ᄋ ᅴ
노랫가락이	ᄂ ᅩ ᄅ ᅢ ᆮ ᄁ ᅡ ᄅ ᅡ ᄀ ᅵ
오늘따라	ᄋ ᅩ ᄂ ᅳ ᆯ ᄄ ᅡ ᄅ ᅡ
구슬프게	ᄀ ᅮ ᄉ ᅳ ᆯ ᄑ ᅳ ᄀ ᅦ
들리네	ᄃ ᅳ ᆯ ᄅ ᅵ ᄂ ᅦ
그녀가	ᄀ ᅳ ᄂ ᅧ ᄀ ᅡ
남자와	ᄂ ᅡ ᆷ ᄌ ᅡ ᄋ ᅪ
결혼을	ᄀ ᅧ ᆯ ᄒ ᅩ ᄂ ᅳ ᆯ
하다니	ᄒ ᅡ ᄃ ᅡ ᄂ ᅵ
무너진	ᄆ ᅮ ᄂ ᅥ ᄌ ᅵ ᆫ
탓인가	ᄐ ᅡ ᄉ ᅵ ᆫ ᄀ ᅡ
이상하게	ᄋ ᅵ ᄉ ᅡ ᆼ ᄒ ᅡ ᄀ ᅦ
축축	ᄎ ᅮ ᆨ ᄎ ᅮ ᆨ
처져요	ᄎ ᅥ ᄌ ᅥ ᄋ ᅭ
그때	ᄀ ᅳ ᄄ ᅢ
사고로	ᄉ ᅡ ᄀ ᅩ ᄅ ᅩ
돌아가신	ᄃ ᅩ ᄅ ᅡ ᄀ ᅡ ᄉ ᅵ ᆫ
분들을	ᄇ ᅮ ᆫ ᄃ ᅳ ᄅ ᅳ ᆯ
생각하면	ᄉ ᅢ ᆼ ᄀ ᅡ ᄏ ᅡ ᄆ ᅧ ᆫ
애석할	ᄋ ᅢ ᄉ ᅥ ᄏ ᅡ ᆯ
따름이야	ᄄ ᅡ ᄅ ᅳ ᄆ ᅵ ᄋ ᅣ
날	ᄂ ᅡ ᆯ
좋으련만	ᄌ ᅩ ᄋ ᅳ ᄅ ᅧ ᆫ ᄆ ᅡ ᆫ
아쉽다	ᄋ ᅡ ᄉ ᅱ ᆸ ᄄ ᅡ
병석에	ᄇ ᅧ ᆼ ᄉ ᅥ ᄀ ᅦ
누워	ᄂ ᅮ ᄋ ᅯ
보고	ᄇ ᅩ ᄀ ᅩ
눈물이	ᄂ ᅮ ᆫ ᄆ ᅮ ᄅ ᅵ
이제	ᄋ ᅵ ᄌ ᅦ
화도	ᄒ ᅪ ᄃ ᅩ
다만	ᄃ ᅡ ᄆ ᅡ ᆫ
이렇게밖에	ᄋ ᅵ ᄅ ᅥ ᄏ ᅦ ᄇ ᅡ ᄁ ᅦ
못하는	ᄆ ᅩ ᄐ ᅡ ᄂ ᅳ ᆫ
자신에게	ᄌ ᅡ ᄉ ᅵ ᄂ ᅦ ᄀ ᅦ
실망스러울	ᄉ ᅵ ᆯ ᄆ ᅡ ᆼ ᄉ ᅳ ᄅ ᅥ ᄋ ᅮ ᆯ
뿐이야	ᄈ ᅮ ᄂ ᅵ ᄋ ᅣ
회색빛으로	ᄒ ᅬ ᄉ ᅢ ᆨ ᄈ ᅵ ᄎ ᅳ ᄅ ᅩ
가득한	ᄀ ᅡ ᄃ ᅳ ᄏ ᅡ ᆫ
마음처럼	ᄆ ᅡ ᄋ ᅳ ᆷ ᄎ ᅥ ᄅ ᅥ ᆷ
세상도	ᄉ ᅦ ᄉ ᅡ ᆼ ᄃ ᅩ
우중충해	ᄋ ᅮ ᄌ ᅮ ᆼ ᄎ ᅮ ᆼ ᄒ ᅢ
보인다	ᄇ ᅩ ᄋ ᅵ ᆫ ᄃ ᅡ
명절인데	ᄆ ᅧ ᆼ ᄌ ᅥ ᄅ ᅵ ᆫ ᄃ ᅦ
부모님을	ᄇ ᅮ ᄆ ᅩ ᄂ ᅵ ᄆ ᅳ ᆯ
뵐	ᄇ ᅬ ᆯ
면목도	ᄆ ᅧ ᆫ ᄆ ᅩ ᆨ ᄄ ᅩ
없고	ᄋ ᅥ ᆸ ᄁ ᅩ
마음만	ᄆ ᅡ ᄋ ᅳ ᆷ ᄆ ᅡ ᆫ
무거워진다	ᄆ ᅮ ᄀ ᅥ ᄋ ᅯ ᄌ ᅵ ᆫ ᄃ ᅡ
기일이	ᄀ ᅵ ᄋ ᅵ ᄅ ᅵ
다가오니	ᄃ ᅡ ᄀ ᅡ ᄋ ᅩ ᄂ ᅵ
할머님	ᄒ ᅡ ᆯ ᄆ ᅥ ᄂ ᅵ ᆷ
생각이	ᄉ ᅢ ᆼ ᄀ ᅡ ᄀ ᅵ
나는구나	ᄂ ᅡ ᄂ ᅳ ᆫ ᄀ ᅮ ᄂ ᅡ
혼자	ᄒ ᅩ ᆫ ᄌ ᅡ
있으려니	ᄋ ᅵ ᄊ ᅳ ᄅ ᅧ ᄂ ᅵ
쓸쓸하다	ᄊ ᅳ ᆯ ᄊ ᅳ ᆯ ᄒ ᅡ ᄃ ᅡ
차라리	ᄎ ᅡ ᄅ ᅡ ᄅ ᅵ
아팠으면	ᄋ ᅡ ᄑ ᅡ ᄊ ᅳ ᄆ ᅧ ᆫ
잘하고	ᄌ ᅡ ᆯ ᄒ ᅡ ᄀ ᅩ
싶은데	ᄉ ᅵ ᄑ ᅳ ᆫ ᄃ ᅦ
맘대로	ᄆ ᅡ ᆷ ᄃ ᅢ ᄅ ᅩ
되지	ᄃ ᅬ ᄌ ᅵ
않네	ᄋ ᅡ ᆫ ᄂ ᅦ
유리창	ᄋ ᅲ ᄅ ᅵ ᄎ ᅡ ᆼ
밖의	ᄇ ᅡ ᄁ ᅴ
사람들은	ᄉ ᅡ ᄅ ᅡ ᆷ ᄃ ᅳ ᄅ ᅳ ᆫ
저렇게	ᄌ ᅥ ᄅ ᅥ ᄏ ᅦ
행복할까	ᄒ ᅢ ᆼ ᄇ ᅩ ᄏ ᅡ ᆯ ᄁ ᅡ
가장의	ᄀ ᅡ ᄌ ᅡ ᆼ ᄋ ᅴ
무게에	ᄆ ᅮ ᄀ ᅦ ᄋ ᅦ
짓눌린	ᄌ ᅵ ᆫ ᄂ ᅮ ᆯ ᄅ ᅵ ᆫ
아버지	ᄋ ᅡ ᄇ ᅥ ᄌ ᅵ
뒷모습이	ᄃ ᅱ ᆫ ᄆ ᅩ ᄉ ᅳ ᄇ ᅵ
애처로워	ᄋ ᅢ ᄎ ᅥ ᄅ ᅩ ᄋ ᅯ
보여	ᄇ ᅩ ᄋ ᅧ
민석이는	ᄆ ᅵ ᆫ ᄉ ᅥ ᄀ ᅵ ᄂ ᅳ ᆫ
이번에도	ᄋ ᅵ ᄇ ᅥ ᄂ ᅦ ᄃ ᅩ
서류	ᄉ ᅥ ᄅ ᅲ
심사에서	ᄉ ᅵ ᆷ ᄉ ᅡ ᄋ ᅦ ᄉ ᅥ
떨어졌대	ᄄ ᅥ ᄅ ᅥ ᄌ ᅥ ᆮ ᄄ ᅢ
축	ᄎ ᅮ ᆨ
처진	ᄎ ᅥ ᄌ ᅵ ᆫ
양	ᄋ ᅣ ᆼ
어깨를	ᄋ ᅥ ᄁ ᅢ ᄅ ᅳ ᆯ
그러고	ᄀ ᅳ ᄅ ᅥ ᄀ ᅩ
싶지	ᄉ ᅵ ᆸ ᄍ ᅵ
않은데	ᄋ ᅡ ᄂ ᅳ ᆫ ᄃ ᅦ
자꾸	ᄌ ᅡ ᄁ ᅮ
처지를	ᄎ ᅥ ᄌ ᅵ ᄅ ᅳ ᆯ
비관하게	ᄇ ᅵ ᄀ ᅪ ᆫ ᄒ ᅡ ᄀ ᅦ
팀원들	ᄐ ᅵ ᄆ ᅯ ᆫ ᄃ ᅳ ᆯ
기대했을	ᄀ ᅵ ᄃ ᅢ ᄒ ᅢ ᄊ ᅳ ᆯ
텐데	ᄐ ᅦ ᆫ ᄃ ᅦ
좋지	ᄌ ᅩ ᄎ ᅵ
않아	ᄋ ᅡ ᄂ ᅡ
무겁네요	ᄆ ᅮ ᄀ ᅥ ᆷ ᄂ ᅦ ᄋ ᅭ
와서	ᄋ ᅪ ᄉ ᅥ
해야	ᄒ ᅢ ᄋ ᅣ
했던	ᄒ ᅢ ᆮ ᄄ ᅥ ᆫ
건데	ᄀ ᅥ ᆫ ᄃ ᅦ
후회스러워	ᄒ ᅮ ᄒ ᅬ ᄉ ᅳ ᄅ ᅥ ᄋ ᅯ
낙담하지	ᄂ ᅡ ᆨ ᄄ ᅡ ᆷ ᄒ ᅡ ᄌ ᅵ
말라는	ᄆ ᅡ ᆯ ᄅ ᅡ ᄂ ᅳ ᆫ
들어도	ᄃ ᅳ ᄅ ᅥ ᄃ ᅩ
어쩔	ᄋ ᅥ ᄍ ᅥ ᆯ
없는	ᄋ ᅥ ᆷ ᄂ ᅳ ᆫ
사는	ᄉ ᅡ ᄂ ᅳ ᆫ
아니야	ᄋ ᅡ ᄂ ᅵ ᄋ ᅣ
진심	ᄌ ᅵ ᆫ ᄉ ᅵ ᆷ
죽고	ᄌ ᅮ ᆨ ᄁ ᅩ
아버지가	ᄋ ᅡ ᄇ ᅥ ᄌ ᅵ ᄀ ᅡ
모습을	ᄆ ᅩ ᄉ ᅳ ᄇ ᅳ ᆯ
보셨으면	ᄇ ᅩ ᄉ ᅧ ᄊ ᅳ ᄆ ᅧ ᆫ
얼마나	ᄋ ᅥ ᆯ ᄆ ᅡ ᄂ ᅡ
좋아하셨을까	ᄌ ᅩ ᄋ ᅡ ᄒ ᅡ ᄉ ᅧ ᄊ ᅳ ᆯ ᄁ ᅡ
병원에	ᄇ ᅧ ᆼ ᄋ ᅯ ᄂ ᅦ
계신	ᄀ ᅨ ᄉ ᅵ ᆫ
어머니를	ᄋ ᅥ ᄆ ᅥ ᄂ ᅵ ᄅ ᅳ ᆯ
떠올리면	ᄄ ᅥ ᄋ ᅩ ᆯ ᄅ ᅵ ᄆ ᅧ ᆫ
무너져	ᄆ ᅮ ᄂ ᅥ ᄌ ᅥ
내리는	ᄂ ᅢ ᄅ ᅵ ᄂ ᅳ ᆫ
할아버지는	ᄒ ᅡ ᄅ ᅡ ᄇ ᅥ ᄌ ᅵ ᄂ ᅳ ᆫ
언제쯤	ᄋ ᅥ ᆫ ᄌ ᅦ ᄍ ᅳ ᆷ
북녘의	ᄇ ᅮ ᆼ ᄂ ᅧ ᄏ ᅴ
고향	ᄀ ᅩ ᄒ ᅣ ᆼ
땅을	ᄄ ᅡ ᆼ ᄋ ᅳ ᆯ
밟아	ᄇ ᅡ ᄇ ᅡ
보실	ᄇ ᅩ ᄉ ᅵ ᆯ
있을까	ᄋ ᅵ ᄊ ᅳ ᆯ ᄁ ᅡ
힘들게	ᄒ ᅵ ᆷ ᄃ ᅳ ᆯ ᄀ ᅦ
공모전인데	ᄀ ᅩ ᆼ ᄆ ᅩ ᄌ ᅥ ᄂ ᅵ ᆫ ᄃ ᅦ
발표를	ᄇ ᅡ ᆯ ᄑ ᅭ ᄅ ᅳ ᆯ
연기한다니	ᄋ ᅧ ᆫ ᄀ ᅵ ᄒ ᅡ ᆫ ᄃ ᅡ ᄂ ᅵ
맥	ᄆ ᅢ ᆨ
빠진다	ᄈ ᅡ ᄌ ᅵ ᆫ ᄃ ᅡ
기다리는	ᄀ ᅵ ᄃ ᅡ ᄅ ᅵ ᄂ ᅳ ᆫ
지쳤어	ᄌ ᅵ ᄎ ᅥ ᄊ ᅥ
그만	ᄀ ᅳ ᄆ ᅡ ᆫ
돌아왔으면	ᄃ ᅩ ᄅ ᅡ ᄋ ᅪ ᄊ ᅳ ᄆ ᅧ ᆫ
좋겠어	ᄌ ᅩ ᄏ ᅦ ᄊ ᅥ
앞에서	ᄋ ᅡ ᄑ ᅦ ᄉ ᅥ
척하는	ᄎ ᅥ ᄏ ᅡ ᄂ ᅳ ᆫ
이젠	ᄋ ᅵ ᄌ ᅦ ᆫ
힘들다	ᄒ ᅵ ᆷ ᄃ ᅳ ᆯ ᄃ ᅡ
마음	ᄆ ᅡ ᄋ ᅳ ᆷ
한구석이	ᄒ ᅡ ᆫ ᄀ ᅮ ᄉ ᅥ ᄀ ᅵ
쓰라리고	ᄊ ᅳ ᄅ ᅡ ᄅ ᅵ ᄀ ᅩ
없이	ᄋ ᅥ ᆸ ᄊ ᅵ
끊지	ᄁ ᅳ ᆫ ᄎ ᅵ
인간관계	ᄋ ᅵ ᆫ ᄀ ᅡ ᆫ ᄀ ᅪ ᆫ ᄀ ᅨ
때문에	ᄄ ᅢ ᄆ ᅮ ᄂ ᅦ
진이	ᄌ ᅵ ᄂ ᅵ
혼자서	ᄒ ᅩ ᆫ ᄌ ᅡ ᄉ ᅥ
외로운	ᄋ ᅬ ᄅ ᅩ ᄋ ᅮ ᆫ
참을	ᄎ ᅡ ᄆ ᅳ ᆯ
있지만	ᄋ ᅵ ᆮ ᄍ ᅵ ᄆ ᅡ ᆫ
둘인데도	ᄃ ᅮ ᄅ ᅵ ᆫ ᄃ ᅦ ᄃ ᅩ
두	ᄃ ᅮ
사람	ᄉ ᅡ ᄅ ᅡ ᆷ
모두에게	ᄆ ᅩ ᄃ ᅮ ᄋ ᅦ ᄀ ᅦ
불행이야	ᄇ ᅮ ᆯ ᄒ ᅢ ᆼ ᄋ ᅵ ᄋ ᅣ
그동안	ᄀ ᅳ ᄃ ᅩ ᆼ ᄋ ᅡ ᆫ
미안했다	ᄆ ᅵ ᄋ ᅡ ᆫ ᄒ ᅢ ᆮ ᄄ ᅡ
놓아줄게	ᄂ ᅩ ᄋ ᅡ ᄌ ᅮ ᆯ ᄀ ᅦ
넘게	ᄂ ᅥ ᆷ ᄁ ᅦ
동고동락했던	ᄃ ᅩ ᆼ ᄀ ᅩ ᄃ ᅩ ᆼ ᄂ ᅡ ᄏ ᅢ ᆮ ᄄ ᅥ ᆫ
고양이가	ᄀ ᅩ ᄋ ᅣ ᆼ ᄋ ᅵ ᄀ ᅡ
집을	ᄌ ᅵ ᄇ ᅳ ᆯ
나가버렸어	ᄂ ᅡ ᄀ ᅡ ᄇ ᅥ ᄅ ᅧ ᄊ ᅥ
때부터	ᄄ ᅢ ᄇ ᅮ ᄐ ᅥ
자란	ᄌ ᅡ ᄅ ᅡ ᆫ
강아지가	ᄀ ᅡ ᆼ ᄋ ᅡ ᄌ ᅵ ᄀ ᅡ
아주	ᄋ ᅡ ᄌ ᅮ
아파	ᄋ ᅡ ᄑ ᅡ
병문안을	ᄇ ᅧ ᆼ ᄆ ᅮ ᄂ ᅡ ᄂ ᅳ ᆯ
갔었는데	ᄀ ᅡ ᄊ ᅥ ᆫ ᄂ ᅳ ᆫ ᄃ ᅦ
마음의	ᄆ ᅡ ᄋ ᅳ ᄆ ᅴ
준비를	ᄌ ᅮ ᆫ ᄇ ᅵ ᄅ ᅳ ᆯ
우시는	ᄋ ᅮ ᄉ ᅵ ᄂ ᅳ ᆫ
봤어	ᄇ ᅪ ᄊ ᅥ
할머니	ᄒ ᅡ ᆯ ᄆ ᅥ ᄂ ᅵ
수술이	ᄉ ᅮ ᄉ ᅮ ᄅ ᅵ
됐나	ᄃ ᅫ ᆫ ᄂ ᅡ
고인이	ᄀ ᅩ ᄋ ᅵ ᄂ ᅵ
곳에	ᄀ ᅩ ᄉ ᅦ
가시기를	ᄀ ᅡ ᄉ ᅵ ᄀ ᅵ ᄅ ᅳ ᆯ
기도하겠습니다	ᄀ ᅵ ᄃ ᅩ ᄒ ᅡ ᄀ ᅦ ᆮ ᄊ ᅳ ᆷ ᄂ ᅵ ᄃ ᅡ
추스르시고	ᄎ ᅮ ᄉ ᅳ ᄅ ᅳ ᄉ ᅵ ᄀ ᅩ
어서	ᄋ ᅥ ᄉ ᅥ
빨리	ᄈ ᅡ ᆯ ᄅ ᅵ
돌아오세요	ᄃ ᅩ ᄅ ᅡ ᄋ ᅩ ᄉ ᅦ ᄋ ᅭ
억울하게	ᄋ ᅥ ᄀ ᅮ ᆯ ᄒ ᅡ ᄀ ᅦ
희생당한	ᄒ ᅵ ᄉ ᅢ ᆼ ᄃ ᅡ ᆼ ᄒ ᅡ ᆫ
그분들을	ᄀ ᅳ ᄇ ᅮ ᆫ ᄃ ᅳ ᄅ ᅳ ᆯ
앞을	ᄋ ᅡ ᄑ ᅳ ᆯ
가린다	ᄀ ᅡ ᄅ ᅵ ᆫ ᄃ ᅡ
멈추지	ᄆ ᅥ ᆷ ᄎ ᅮ ᄌ ᅵ
눈물	ᄂ ᅮ ᆫ ᄆ ᅮ ᆯ
온	ᄋ ᅩ ᆫ
세상이	ᄉ ᅦ ᄉ ᅡ ᆼ ᄋ ᅵ
뿌옇게	ᄈ ᅮ ᄋ ᅧ ᄏ ᅦ
언제부터인가	ᄋ ᅥ ᆫ ᄌ ᅦ ᄇ ᅮ ᄐ ᅥ ᄋ ᅵ ᆫ ᄀ ᅡ
우울증이	ᄋ ᅮ ᄋ ᅮ ᆯ ᄌ ᅳ ᆼ ᄋ ᅵ
집어삼키는	ᄌ ᅵ ᄇ ᅥ ᄉ ᅡ ᆷ ᄏ ᅵ ᄂ ᅳ ᆫ
아직도	ᄋ ᅡ ᄌ ᅵ ᆨ ᄄ ᅩ
부모님께	ᄇ ᅮ ᄆ ᅩ ᄂ ᅵ ᆷ ᄁ ᅦ
용돈을	ᄋ ᅭ ᆼ ᄃ ᅩ ᄂ ᅳ ᆯ
받는다고	ᄇ ᅡ ᆫ ᄂ ᅳ ᆫ ᄃ ᅡ ᄀ ᅩ
사람들이	ᄉ ᅡ ᄅ ᅡ ᆷ ᄃ ᅳ ᄅ ᅵ
한심하게	ᄒ ᅡ ᆫ ᄉ ᅵ ᆷ ᄒ ᅡ ᄀ ᅦ
볼까	ᄇ ᅩ ᆯ ᄁ ᅡ
아픈	ᄋ ᅡ ᄑ ᅳ ᆫ
때문인	ᄄ ᅢ ᄆ ᅮ ᄂ ᅵ ᆫ
같아서	ᄀ ᅡ ᄐ ᅡ ᄉ ᅥ
미안해	ᄆ ᅵ ᄋ ᅡ ᆫ ᄒ ᅢ
탓이야	ᄐ ᅡ ᄉ ᅵ ᄋ ᅣ
네	ᄂ ᅦ
풀	ᄑ ᅮ ᆯ
죽은	ᄌ ᅮ ᄀ ᅳ ᆫ
모습	ᄆ ᅩ ᄉ ᅳ ᆸ
보겠다	ᄇ ᅩ ᄀ ᅦ ᆮ ᄄ ᅡ
우연히	ᄋ ᅮ ᄋ ᅧ ᆫ ᄒ ᅵ
첫사랑이었던	ᄎ ᅥ ᆮ ᄊ ᅡ ᄅ ᅡ ᆼ ᄋ ᅵ ᄋ ᅥ ᆮ ᄄ ᅥ ᆫ
그녀를	ᄀ ᅳ ᄂ ᅧ ᄅ ᅳ ᆯ
길에서	ᄀ ᅵ ᄅ ᅦ ᄉ ᅥ
산산이	ᄉ ᅡ ᆫ ᄉ ᅡ ᄂ ᅵ
조각나는	ᄌ ᅩ ᄀ ᅡ ᆼ ᄂ ᅡ ᄂ ᅳ ᆫ
보내는	ᄇ ᅩ ᄂ ᅢ ᄂ ᅳ ᆫ
아니었는데	ᄋ ᅡ ᄂ ᅵ ᄋ ᅥ ᆫ ᄂ ᅳ ᆫ ᄃ ᅦ
미어지는구나	ᄆ ᅵ ᄋ ᅥ ᄌ ᅵ ᄂ ᅳ ᆫ ᄀ ᅮ ᄂ ᅡ
변호인으로서	ᄇ ᅧ ᆫ ᄒ ᅩ ᄋ ᅵ ᄂ ᅳ ᄅ ᅩ ᄉ ᅥ
참담한	ᄎ ᅡ ᆷ ᄃ ᅡ ᆷ ᄒ ᅡ ᆫ
심정을	ᄉ ᅵ ᆷ ᄌ ᅥ ᆼ ᄋ ᅳ ᆯ
이루	ᄋ ᅵ ᄅ ᅮ
화재로	ᄒ ᅪ ᄌ ᅢ ᄅ ᅩ
가족을	ᄀ ᅡ ᄌ ᅩ ᄀ ᅳ ᆯ
잃은	ᄋ ᅵ ᄅ ᅳ ᆫ
피해자들을	ᄑ ᅵ ᄒ ᅢ ᄌ ᅡ ᄃ ᅳ ᄅ ᅳ ᆯ
참으로	ᄎ ᅡ ᄆ ᅳ ᄅ ᅩ
비통한	ᄇ ᅵ ᄐ ᅩ ᆼ ᄒ ᅡ ᆫ
마음뿐입니다	ᄆ ᅡ ᄋ ᅳ ᆷ ᄈ ᅮ ᄂ ᅵ ᆷ ᄂ ᅵ ᄃ ᅡ
준비도	ᄌ ᅮ ᆫ ᄇ ᅵ ᄃ ᅩ
사람을	ᄉ ᅡ ᄅ ᅡ ᄆ ᅳ ᆯ
보내고	ᄇ ᅩ ᄂ ᅢ ᄀ ᅩ
상실감이	ᄉ ᅡ ᆼ ᄉ ᅵ ᆯ ᄀ ᅡ ᄆ ᅵ
담임	ᄃ ᅡ ᄆ ᅵ ᆷ
선생님께서	ᄉ ᅥ ᆫ ᄉ ᅢ ᆼ ᄂ ᅵ ᆷ ᄁ ᅦ ᄉ ᅥ
편찮으시다고	ᄑ ᅧ ᆫ ᄎ ᅡ ᄂ ᅳ ᄉ ᅵ ᄃ ᅡ ᄀ ᅩ
들었습니다	ᄃ ᅳ ᄅ ᅥ ᆮ ᄊ ᅳ ᆷ ᄂ ᅵ ᄃ ᅡ
집안에	ᄌ ᅵ ᄇ ᅡ ᄂ ᅦ
우환이	ᄋ ᅮ ᄒ ᅪ ᄂ ᅵ
끊이지를	ᄁ ᅳ ᄂ ᅵ ᄌ ᅵ ᄅ ᅳ ᆯ
않아요	ᄋ ᅡ ᄂ ᅡ ᄋ ᅭ
머리가	ᄆ ᅥ ᄅ ᅵ ᄀ ᅡ
멍해졌어	ᄆ ᅥ ᆼ ᄒ ᅢ ᄌ ᅥ ᄊ ᅥ
동창회에서	ᄃ ᅩ ᆼ ᄎ ᅡ ᆼ ᄒ ᅬ ᄋ ᅦ ᄉ ᅥ
만난	ᄆ ᅡ ᆫ ᄂ ᅡ ᆫ
친구들을	ᄎ ᅵ ᆫ ᄀ ᅮ ᄃ ᅳ ᄅ ᅳ ᆯ
초라하고	ᄎ ᅩ ᄅ ᅡ ᄒ ᅡ ᄀ ᅩ
보잘것없었어	ᄇ ᅩ ᄌ ᅡ ᆯ ᄀ ᅥ ᄉ ᅥ ᆸ ᄊ ᅥ ᄊ ᅥ
한창	ᄒ ᅡ ᆫ ᄎ ᅡ ᆼ
나이에	ᄂ ᅡ ᄋ ᅵ ᄋ ᅦ
회사를	ᄒ ᅬ ᄉ ᅡ ᄅ ᅳ ᆯ
떠나는	ᄄ ᅥ ᄂ ᅡ ᄂ ᅳ ᆫ
선배를	ᄉ ᅥ ᆫ ᄇ ᅢ ᄅ ᅳ ᆯ
보면서	ᄇ ᅩ ᄆ ᅧ ᆫ ᄉ ᅥ
안쓰러웠어	ᄋ ᅡ ᆫ ᄊ ᅳ ᄅ ᅥ ᄋ ᅯ ᄊ ᅥ
사랑하지만	ᄉ ᅡ ᄅ ᅡ ᆼ ᄒ ᅡ ᄌ ᅵ ᄆ ᅡ ᆫ
보내줘야	ᄇ ᅩ ᄂ ᅢ ᄌ ᅯ ᄋ ᅣ
그녀	ᄀ ᅳ ᄂ ᅧ
나려는	ᄂ ᅡ ᄅ ᅧ ᄂ ᅳ ᆫ
몇	ᄆ ᅧ ᆮ
번이고	ᄇ ᅥ ᄂ ᅵ ᄀ ᅩ
참았어	ᄎ ᅡ ᄆ ᅡ ᄊ ᅥ
생활고로	ᄉ ᅢ ᆼ ᄒ ᅪ ᆯ ᄀ ᅩ ᄅ ᅩ
범죄자가	ᄇ ᅥ ᆷ ᄌ ᅬ ᄌ ᅡ ᄀ ᅡ
될	ᄃ ᅬ ᆯ
수밖에	ᄉ ᅮ ᄇ ᅡ ᄁ ᅦ
없었던	ᄋ ᅥ ᆸ ᄊ ᅥ ᆮ ᄄ ᅥ ᆫ
피의자를	ᄑ ᅵ ᄋ ᅴ ᄌ ᅡ ᄅ ᅳ ᆯ
측은해지더라	ᄎ ᅳ ᄀ ᅳ ᆫ ᄒ ᅢ ᄌ ᅵ ᄃ ᅥ ᄅ ᅡ
실험	ᄉ ᅵ ᆯ ᄒ ᅥ ᆷ
대상이	ᄃ ᅢ ᄉ ᅡ ᆼ ᄋ ᅵ
연구소에	ᄋ ᅧ ᆫ ᄀ ᅮ ᄉ ᅩ ᄋ ᅦ
갇혀	ᄀ ᅡ ᄐ ᅧ
동물들이	ᄃ ᅩ ᆼ ᄆ ᅮ ᆯ ᄃ ᅳ ᄅ ᅵ
불쌍해	ᄇ ᅮ ᆯ ᄊ ᅡ ᆼ ᄒ ᅢ
굶주림에	ᄀ ᅮ ᆷ ᄌ ᅮ ᄅ ᅵ ᄆ ᅦ
시달리는	ᄉ ᅵ ᄃ ᅡ ᆯ ᄅ ᅵ ᄂ ᅳ ᆫ
아프리카	ᄋ ᅡ ᄑ ᅳ ᄅ ᅵ ᄏ ᅡ
어린이들의	ᄋ ᅥ ᄅ ᅵ ᄂ ᅵ ᄃ ᅳ ᄅ ᅴ
처참했어	ᄎ ᅥ ᄎ ᅡ ᆷ ᄒ ᅢ ᄊ ᅥ
사고	ᄉ ᅡ ᄀ ᅩ
이후	ᄋ ᅵ ᄒ ᅮ
지금까지도	ᄌ ᅵ ᄀ ᅳ ᆷ ᄁ ᅡ ᄌ ᅵ ᄃ ᅩ
가족들	ᄀ ᅡ ᄌ ᅩ ᆨ ᄄ ᅳ ᆯ
슬픔에	ᄉ ᅳ ᆯ ᄑ ᅳ ᄆ ᅦ
잠겨	ᄌ ᅡ ᆷ ᄀ ᅧ
자식을	ᄌ ᅡ ᄉ ᅵ ᄀ ᅳ ᆯ
잃고	ᄋ ᅵ ᆯ ᄏ ᅩ
비탄에	ᄇ ᅵ ᄐ ᅡ ᄂ ᅦ
젖은	ᄌ ᅥ ᄌ ᅳ ᆫ
친구에게	ᄎ ᅵ ᆫ ᄀ ᅮ ᄋ ᅦ ᄀ ᅦ
어떤	ᄋ ᅥ ᄄ ᅥ ᆫ
위로를	ᄋ ᅱ ᄅ ᅩ ᄅ ᅳ ᆯ
해줘야	ᄒ ᅢ ᄌ ᅯ ᄋ ᅣ
할까	ᄒ ᅡ ᆯ ᄁ ᅡ
아이를	ᄋ ᅡ ᄋ ᅵ ᄅ ᅳ ᆯ
키우는	ᄏ ᅵ ᄋ ᅮ ᄂ ᅳ ᆫ
어찌나	ᄋ ᅥ ᄍ ᅵ ᄂ ᅡ
힘겨워	ᄒ ᅵ ᆷ ᄀ ᅧ ᄋ ᅯ
보이던지	ᄇ ᅩ ᄋ ᅵ ᄃ ᅥ ᆫ ᄌ ᅵ
생각을	ᄉ ᅢ ᆼ ᄀ ᅡ ᄀ ᅳ ᆯ
하니	ᄒ ᅡ ᄂ ᅵ
암담하다	ᄋ ᅡ ᆷ ᄃ ᅡ ᆷ ᄒ ᅡ ᄃ ᅡ
버림받은	ᄇ ᅥ ᄅ ᅵ ᆷ ᄇ ᅡ ᄃ ᅳ ᆫ
줄도	ᄌ ᅮ ᆯ ᄃ ᅩ
모르고	ᄆ ᅩ ᄅ ᅳ ᄀ ᅩ
주인을	ᄌ ᅮ ᄋ ᅵ ᄂ ᅳ ᆯ
강아지의	ᄀ ᅡ ᆼ ᄋ ᅡ ᄌ ᅵ ᄋ ᅴ
가엾더라	ᄀ ᅡ ᄋ ᅧ ᆸ ᄄ ᅥ ᄅ ᅡ
늙어가시는	ᄂ ᅳ ᆯ ᄀ ᅥ ᄀ ᅡ ᄉ ᅵ ᄂ ᅳ ᆫ
때마다	ᄄ ᅢ ᄆ ᅡ ᄃ ᅡ
서글퍼져	ᄉ ᅥ ᄀ ᅳ ᆯ ᄑ ᅥ ᄌ ᅥ
동생	ᄃ ᅩ ᆼ ᄉ ᅢ ᆼ
결혼식에서	ᄀ ᅧ ᆯ ᄒ ᅩ ᆫ ᄉ ᅵ ᄀ ᅦ ᄉ ᅥ
취급하던	ᄎ ᅱ ᄀ ᅳ ᄑ ᅡ ᄃ ᅥ ᆫ
서운했어	ᄉ ᅥ ᄋ ᅮ ᆫ ᄒ ᅢ ᄊ ᅥ
쌓아	ᄊ ᅡ ᄋ ᅡ
올린	ᄋ ᅩ ᆯ ᄅ ᅵ ᆫ
커리어보다	ᄏ ᅥ ᄅ ᅵ ᄋ ᅥ ᄇ ᅩ ᄃ ᅡ
결혼	ᄀ ᅧ ᆯ ᄒ ᅩ ᆫ
여부가	ᄋ ᅧ ᄇ ᅮ ᄀ ᅡ
인생의	ᄋ ᅵ ᆫ ᄉ ᅢ ᆼ ᄋ ᅴ
성공	ᄉ ᅥ ᆼ ᄀ ᅩ ᆼ
잣대라니	ᄌ ᅡ ᆮ ᄄ ᅢ ᄅ ᅡ ᄂ ᅵ
허탈하다	ᄒ ᅥ ᄐ ᅡ ᆯ ᄒ ᅡ ᄃ ᅡ
믿고	ᄆ ᅵ ᆮ ᄁ ᅩ
야근도	ᄋ ᅣ ᄀ ᅳ ᆫ ᄃ ᅩ
마다하지	ᄆ ᅡ ᄃ ᅡ ᄒ ᅡ ᄌ ᅵ
않던	ᄋ ᅡ ᆫ ᄐ ᅥ ᆫ
팀원들에게	ᄐ ᅵ ᄆ ᅯ ᆫ ᄃ ᅳ ᄅ ᅦ ᄀ ᅦ
면목이	ᄆ ᅧ ᆫ ᄆ ᅩ ᄀ ᅵ
없다	ᄋ ᅥ ᆸ ᄄ ᅡ
그냥	ᄀ ᅳ ᄂ ᅣ ᆼ
넘긴다면	ᄂ ᅥ ᆷ ᄀ ᅵ ᆫ ᄃ ᅡ ᄆ ᅧ ᆫ
자책하게	ᄌ ᅡ ᄎ ᅢ ᄏ ᅡ ᄀ ᅦ
좌절하고	ᄌ ᅪ ᄌ ᅥ ᆯ ᄒ ᅡ ᄀ ᅩ
않지만	ᄋ ᅡ ᆫ ᄎ ᅵ ᄆ ᅡ ᆫ
일어설	ᄋ ᅵ ᄅ ᅥ ᄉ ᅥ ᆯ
없어	ᄋ ᅥ ᆸ ᄊ ᅥ
유기견	ᄋ ᅲ ᄀ ᅵ ᄀ ᅧ ᆫ
센터에서	ᄉ ᅦ ᆫ ᄐ ᅥ ᄋ ᅦ ᄉ ᅥ
강아지들의	ᄀ ᅡ ᆼ ᄋ ᅡ ᄌ ᅵ ᄃ ᅳ ᄅ ᅴ
애처로웠어	ᄋ ᅢ ᄎ ᅥ ᄅ ᅩ ᄋ ᅯ ᄊ ᅥ
매년	ᄆ ᅢ ᄂ ᅧ ᆫ
이맘때가	ᄋ ᅵ ᄆ ᅡ ᆷ ᄄ ᅢ ᄀ ᅡ
되면	ᄃ ᅬ ᄆ ᅧ ᆫ
먼저	ᄆ ᅥ ᆫ ᄌ ᅥ
떠난	ᄄ ᅥ ᄂ ᅡ ᆫ
친구	ᄎ ᅵ ᆫ ᄀ ᅮ
생각에	ᄉ ᅢ ᆼ ᄀ ᅡ ᄀ ᅦ
코끝이	ᄏ ᅩ ᄁ ᅳ ᄉ ᅵ
시큰해져	ᄉ ᅵ ᄏ ᅳ ᆫ ᄒ ᅢ ᄌ ᅥ
손에서	ᄉ ᅩ ᄂ ᅦ ᄉ ᅥ
놓지	ᄂ ᅩ ᄎ ᅵ
부모님	ᄇ ᅮ ᄆ ᅩ ᄂ ᅵ ᆷ
먹먹해	ᄆ ᅥ ᆼ ᄆ ᅥ ᄏ ᅢ
우리는	ᄋ ᅮ ᄅ ᅵ ᄂ ᅳ ᆫ
그분의	ᄀ ᅳ ᄇ ᅮ ᄂ ᅴ
헌신에	ᄒ ᅥ ᆫ ᄉ ᅵ ᄂ ᅦ
감사하며	ᄀ ᅡ ᆷ ᄉ ᅡ ᄒ ᅡ ᄆ ᅧ
넋을	ᄂ ᅥ ᆨ ᄊ ᅳ ᆯ
위로하고자	ᄋ ᅱ ᄅ ᅩ ᄒ ᅡ ᄀ ᅩ ᄌ ᅡ
역사를	ᄋ ᅧ ᆨ ᄊ ᅡ ᄅ ᅳ ᆯ
잊은	ᄋ ᅵ ᄌ ᅳ ᆫ
민족에게	ᄆ ᅵ ᆫ ᄌ ᅩ ᄀ ᅦ ᄀ ᅦ
미래는	ᄆ ᅵ ᄅ ᅢ ᄂ ᅳ ᆫ
없다는	ᄋ ᅥ ᆸ ᄄ ᅡ ᄂ ᅳ ᆫ
말처럼	ᄆ ᅡ ᆯ ᄎ ᅥ ᄅ ᅥ ᆷ
지금의	ᄌ ᅵ ᄀ ᅳ ᄆ ᅴ
슬픔을	ᄉ ᅳ ᆯ ᄑ ᅳ ᄆ ᅳ ᆯ
기억합시다	ᄀ ᅵ ᄋ ᅥ ᄏ ᅡ ᆸ ᄊ ᅵ ᄃ ᅡ
눈시울이	ᄂ ᅮ ᆫ ᄉ ᅵ ᄋ ᅮ ᄅ ᅵ
붉어진	ᄇ ᅮ ᆯ ᄀ ᅥ ᄌ ᅵ ᆫ
동생은	ᄃ ᅩ ᆼ ᄉ ᅢ ᆼ ᄋ ᅳ ᆫ
어깨에	ᄋ ᅥ ᄁ ᅢ ᄋ ᅦ
기대어	ᄀ ᅵ ᄃ ᅢ ᄋ ᅥ
흐느껴	ᄒ ᅳ ᄂ ᅳ ᄁ ᅧ
울었다	ᄋ ᅮ ᄅ ᅥ ᆮ ᄄ ᅡ
숨죽여	ᄉ ᅮ ᆷ ᄌ ᅮ ᄀ ᅧ
있던	ᄋ ᅵ ᆮ ᄄ ᅥ ᆫ
남자의	ᄂ ᅡ ᆷ ᄌ ᅡ ᄋ ᅴ
어깨가	ᄋ ᅥ ᄁ ᅢ ᄀ ᅡ
들썩이는	ᄃ ᅳ ᆯ ᄊ ᅥ ᄀ ᅵ ᄂ ᅳ ᆫ
어머니는	ᄋ ᅥ ᄆ ᅥ ᄂ ᅵ ᄂ ᅳ ᆫ
할머니의	ᄒ ᅡ ᆯ ᄆ ᅥ ᄂ ᅵ ᄋ ᅴ
영정	ᄋ ᅧ ᆼ ᄌ ᅥ ᆼ
대성통곡을	ᄃ ᅢ ᄉ ᅥ ᆼ ᄐ ᅩ ᆼ ᄀ ᅩ ᄀ ᅳ ᆯ
하셨어	ᄒ ᅡ ᄉ ᅧ ᄊ ᅥ
음악을	ᄋ ᅳ ᄆ ᅡ ᄀ ᅳ ᆯ
들을	ᄃ ᅳ ᄅ ᅳ ᆯ
때면	ᄄ ᅢ ᄆ ᅧ ᆫ
체한	ᄎ ᅦ ᄒ ᅡ ᆫ
것처럼	ᄀ ᅥ ᆮ ᄎ ᅥ ᄅ ᅥ ᆷ
명치끝이	ᄆ ᅧ ᆼ ᄎ ᅵ ᄁ ᅳ ᄉ ᅵ
아려와	ᄋ ᅡ ᄅ ᅧ ᄋ ᅪ
점점	ᄌ ᅥ ᆷ ᄌ ᅥ ᆷ
나이	ᄂ ᅡ ᄋ ᅵ
먹으면서	ᄆ ᅥ ᄀ ᅳ ᄆ ᅧ ᆫ ᄉ ᅥ
눈물샘이	ᄂ ᅮ ᆫ ᄆ ᅮ ᆯ ᄉ ᅢ ᄆ ᅵ
마른	ᄆ ᅡ ᄅ ᅳ ᆫ
줄	ᄌ ᅮ ᆯ
알았는데	ᄋ ᅡ ᄅ ᅡ ᆫ ᄂ ᅳ ᆫ ᄃ ᅦ
아니었나	ᄋ ᅡ ᄂ ᅵ ᄋ ᅥ ᆫ ᄂ ᅡ
가수의	ᄀ ᅡ ᄉ ᅮ ᄋ ᅴ
노래를	ᄂ ᅩ ᄅ ᅢ ᄅ ᅳ ᆯ
절절하게	ᄌ ᅥ ᆯ ᄌ ᅥ ᆯ ᄒ ᅡ ᄀ ᅦ
파고들어	ᄑ ᅡ ᄀ ᅩ ᄃ ᅳ ᄅ ᅥ
가슴	ᄀ ᅡ ᄉ ᅳ ᆷ
시린	ᄉ ᅵ ᄅ ᅵ ᆫ
이별은	ᄋ ᅵ ᄇ ᅧ ᄅ ᅳ ᆫ
번으로	ᄇ ᅥ ᄂ ᅳ ᄅ ᅩ
족하다고	ᄌ ᅩ ᄏ ᅡ ᄃ ᅡ ᄀ ᅩ
생각했는데	ᄉ ᅢ ᆼ ᄀ ᅡ ᄏ ᅢ ᆫ ᄂ ᅳ ᆫ ᄃ ᅦ
아닌가	ᄋ ᅡ ᄂ ᅵ ᆫ ᄀ ᅡ
그리워	ᄀ ᅳ ᄅ ᅵ ᄋ ᅯ
아파요	ᄋ ᅡ ᄑ ᅡ ᄋ ᅭ
사람은	ᄉ ᅡ ᄅ ᅡ ᄆ ᅳ ᆫ
절	ᄌ ᅥ ᆯ
생각하지	ᄉ ᅢ ᆼ ᄀ ᅡ ᄏ ᅡ ᄌ ᅵ
않겠죠	ᄋ ᅡ ᆫ ᄏ ᅦ ᆮ ᄍ ᅭ
마지막이라는	ᄆ ᅡ ᄌ ᅵ ᄆ ᅡ ᄀ ᅵ ᄅ ᅡ ᄂ ᅳ ᆫ
말은	ᄆ ᅡ ᄅ ᅳ ᆫ
슬픈	ᄉ ᅳ ᆯ ᄑ ᅳ ᆫ
계속해서	ᄀ ᅨ ᄉ ᅩ ᄏ ᅢ ᄉ ᅥ
억지	ᄋ ᅥ ᆨ ᄍ ᅵ
주장을	ᄌ ᅮ ᄌ ᅡ ᆼ ᄋ ᅳ ᆯ
하고	ᄒ ᅡ ᄀ ᅩ
모양이지	ᄆ ᅩ ᄋ ᅣ ᆼ ᄋ ᅵ ᄌ ᅵ
코앞인데	ᄏ ᅩ ᄋ ᅡ ᄑ ᅵ ᆫ ᄃ ᅦ
공부는	ᄀ ᅩ ᆼ ᄇ ᅮ ᄂ ᅳ ᆫ
놀기만	ᄂ ᅩ ᆯ ᄀ ᅵ ᄆ ᅡ ᆫ
거니	ᄀ ᅥ ᄂ ᅵ
라디오	ᄅ ᅡ ᄃ ᅵ ᄋ ᅩ
소리	ᄉ ᅩ ᄅ ᅵ
좀	ᄌ ᅩ ᆷ
줄여달라는데	ᄌ ᅮ ᄅ ᅧ ᄃ ᅡ ᆯ ᄅ ᅡ ᄂ ᅳ ᆫ ᄃ ᅦ
그게	ᄀ ᅳ ᄀ ᅦ
어렵습니까	ᄋ ᅥ ᄅ ᅧ ᆸ ᄊ ᅳ ᆷ ᄂ ᅵ ᄁ ᅡ
결제	ᄀ ᅧ ᆯ ᄌ ᅦ
취소는	ᄎ ᅱ ᄉ ᅩ ᄂ ᅳ ᆫ
된다고	ᄃ ᅬ ᆫ ᄃ ᅡ ᄀ ᅩ
누누이	ᄂ ᅮ ᄂ ᅮ ᄋ ᅵ
말씀드렸을	ᄆ ᅡ ᆯ ᄊ ᅳ ᆷ ᄃ ᅳ ᄅ ᅧ ᄊ ᅳ ᆯ
텐데요	ᄐ ᅦ ᆫ ᄃ ᅦ ᄋ ᅭ
도대체	ᄃ ᅩ ᄃ ᅢ ᄎ ᅦ
번을	ᄇ ᅥ ᄂ ᅳ ᆯ
말씀드려야	ᄆ ᅡ ᆯ ᄊ ᅳ ᆷ ᄃ ᅳ ᄅ ᅧ ᄋ ᅣ
술을	ᄉ ᅮ ᄅ ᅳ ᆯ
끊으시겠습니까	ᄁ ᅳ ᄂ ᅳ ᄉ ᅵ ᄀ ᅦ ᆮ ᄊ ᅳ ᆷ ᄂ ᅵ ᄁ ᅡ
탈을	ᄐ ᅡ ᄅ ᅳ ᆯ
쓰고	ᄊ ᅳ ᄀ ᅩ
짓을	ᄌ ᅵ ᄉ ᅳ ᆯ
있니	ᄋ ᅵ ᆫ ᄂ ᅵ
지하철에선	ᄌ ᅵ ᄒ ᅡ ᄎ ᅥ ᄅ ᅦ ᄉ ᅥ ᆫ
큰	ᄏ ᅳ ᆫ
소리로	ᄉ ᅩ ᄅ ᅵ ᄅ ᅩ
통화하시면	ᄐ ᅩ ᆼ ᄒ ᅪ ᄒ ᅡ ᄉ ᅵ ᄆ ᅧ ᆫ
말씀드렸습니다	ᄆ ᅡ ᆯ ᄊ ᅳ ᆷ ᄃ ᅳ ᄅ ᅧ ᆮ ᄊ ᅳ ᆷ ᄂ ᅵ ᄃ ᅡ
아내가	ᄋ ᅡ ᄂ ᅢ ᄀ ᅡ
속을	ᄉ ᅩ ᄀ ᅳ ᆯ
긁는	ᄀ ᅳ ᆼ ᄂ ᅳ ᆫ
데	ᄃ ᅦ
있어야죠	ᄋ ᅵ ᄊ ᅥ ᄋ ᅣ ᄌ ᅭ
번만	ᄇ ᅥ ᆫ ᄆ ᅡ ᆫ
거짓말했다간	ᄀ ᅥ ᄌ ᅵ ᆫ ᄆ ᅡ ᆯ ᄒ ᅢ ᆮ ᄄ ᅡ ᄀ ᅡ ᆫ
그땐	ᄀ ᅳ ᄄ ᅢ ᆫ
혼날	ᄒ ᅩ ᆫ ᄂ ᅡ ᆯ
알아	ᄋ ᅡ ᄅ ᅡ
최소한	ᄎ ᅬ ᄉ ᅩ ᄒ ᅡ ᆫ
반성의	ᄇ ᅡ ᆫ ᄉ ᅥ ᆼ ᄋ ᅴ
기미는	ᄀ ᅵ ᄆ ᅵ ᄂ ᅳ ᆫ
보여야	ᄇ ᅩ ᄋ ᅧ ᄋ ᅣ
아닙니까	ᄋ ᅡ ᄂ ᅵ ᆷ ᄂ ᅵ ᄁ ᅡ
공금	ᄀ ᅩ ᆼ ᄀ ᅳ ᆷ
횡령에	ᄒ ᅬ ᆼ ᄂ ᅧ ᆼ ᄋ ᅦ
금품	ᄀ ᅳ ᆷ ᄑ ᅮ ᆷ
수수까지	ᄉ ᅮ ᄉ ᅮ ᄁ ᅡ ᄌ ᅵ
너무하네요	ᄂ ᅥ ᄆ ᅮ ᄒ ᅡ ᄂ ᅦ ᄋ ᅭ
보자	ᄇ ᅩ ᄌ ᅡ
싸우자는	ᄊ ᅡ ᄋ ᅮ ᄌ ᅡ ᄂ ᅳ ᆫ
거지	ᄀ ᅥ ᄌ ᅵ
좋으니까	ᄌ ᅩ ᄋ ᅳ ᄂ ᅵ ᄁ ᅡ
건드리지	ᄀ ᅥ ᆫ ᄃ ᅳ ᄅ ᅵ ᄌ ᅵ
마	ᄆ ᅡ
일만	ᄋ ᅵ ᆯ ᄆ ᅡ ᆫ
분통이	ᄇ ᅮ ᆫ ᄐ ᅩ ᆼ ᄋ ᅵ
터진다고요	ᄐ ᅥ ᄌ ᅵ ᆫ ᄃ ᅡ ᄀ ᅩ ᄋ ᅭ
화가	ᄒ ᅪ ᄀ ᅡ
나서	ᄂ ᅡ ᄉ ᅥ
가만히	ᄀ ᅡ ᄆ ᅡ ᆫ ᄒ ᅵ
어머니	ᄋ ᅥ ᄆ ᅥ ᄂ ᅵ
지긋지긋한	ᄌ ᅵ ᄀ ᅳ ᆮ ᄍ ᅵ ᄀ ᅳ ᄐ ᅡ ᆫ
잔소리	ᄌ ᅡ ᆫ ᄉ ᅩ ᄅ ᅵ
하세요	ᄒ ᅡ ᄉ ᅦ ᄋ ᅭ
저들의	ᄌ ᅥ ᄃ ᅳ ᄅ ᅴ
행태를	ᄒ ᅢ ᆼ ᄐ ᅢ ᄅ ᅳ ᆯ
보면	ᄇ ᅩ ᄆ ᅧ ᆫ
피가	ᄑ ᅵ ᄀ ᅡ
거꾸로	ᄀ ᅥ ᄁ ᅮ ᄅ ᅩ
솟아요	ᄉ ᅩ ᄉ ᅡ ᄋ ᅭ
배웠다는	ᄇ ᅢ ᄋ ᅯ ᆮ ᄄ ᅡ ᄂ ᅳ ᆫ
저러고	ᄌ ᅥ ᄅ ᅥ ᄀ ᅩ
한심합니다	ᄒ ᅡ ᆫ ᄉ ᅵ ᆷ ᄒ ᅡ ᆷ ᄂ ᅵ ᄃ ᅡ
미치지	ᄆ ᅵ ᄎ ᅵ ᄌ ᅵ
않고서야	ᄋ ᅡ ᆫ ᄏ ᅩ ᄉ ᅥ ᄋ ᅣ
인간이	ᄋ ᅵ ᆫ ᄀ ᅡ ᄂ ᅵ
그럴	ᄀ ᅳ ᄅ ᅥ ᆯ
겁니까	ᄀ ᅥ ᆷ ᄂ ᅵ ᄁ ᅡ
조언을	ᄌ ᅩ ᄋ ᅥ ᄂ ᅳ ᆯ
해줘도	ᄒ ᅢ ᄌ ᅯ ᄃ ᅩ
들은	ᄃ ᅳ ᄅ ᅳ ᆫ
척도	ᄎ ᅥ ᆨ ᄄ ᅩ
답답하다	ᄃ ᅡ ᆸ ᄄ ᅡ ᄑ ᅡ ᄃ ᅡ
무슨	ᄆ ᅮ ᄉ ᅳ ᆫ
생각으로	ᄉ ᅢ ᆼ ᄀ ᅡ ᄀ ᅳ ᄅ ᅩ
건지	ᄀ ᅥ ᆫ ᄌ ᅵ
한심하다	ᄒ ᅡ ᆫ ᄉ ᅵ ᆷ ᄒ ᅡ ᄃ ᅡ
한심해	ᄒ ᅡ ᆫ ᄉ ᅵ ᆷ ᄒ ᅢ
가증스러운	ᄀ ᅡ ᄌ ᅳ ᆼ ᄉ ᅳ ᄅ ᅥ ᄋ ᅮ ᆫ
미소가	ᄆ ᅵ ᄉ ᅩ ᄀ ᅡ
소름	ᄉ ᅩ ᄅ ᅳ ᆷ
끼치게	ᄁ ᅵ ᄎ ᅵ ᄀ ᅦ
싫어요	ᄉ ᅵ ᄅ ᅥ ᄋ ᅭ
말	ᄆ ᅡ ᆯ
한마디	ᄒ ᅡ ᆫ ᄆ ᅡ ᄃ ᅵ
꼴이	ᄁ ᅩ ᄅ ᅵ
우스워졌다고	ᄋ ᅮ ᄉ ᅳ ᄋ ᅯ ᄌ ᅥ ᆮ ᄄ ᅡ ᄀ ᅩ
알기나	ᄋ ᅡ ᆯ ᄀ ᅵ ᄂ ᅡ
공인이면	ᄀ ᅩ ᆼ ᄋ ᅵ ᄂ ᅵ ᄆ ᅧ ᆫ
공인답게	ᄀ ᅩ ᆼ ᄋ ᅵ ᆫ ᄃ ᅡ ᆸ ᄁ ᅦ
행동하셔야죠	ᄒ ᅢ ᆼ ᄃ ᅩ ᆼ ᄒ ᅡ ᄉ ᅧ ᄋ ᅣ ᄌ ᅭ
자기	ᄌ ᅡ ᄀ ᅵ
애를	ᄋ ᅢ ᄅ ᅳ ᆯ
때린다니	ᄄ ᅢ ᄅ ᅵ ᆫ ᄃ ᅡ ᄂ ᅵ
짐승만도	ᄌ ᅵ ᆷ ᄉ ᅳ ᆼ ᄆ ᅡ ᆫ ᄃ ᅩ
못한	ᄆ ᅩ ᄐ ᅡ ᆫ
사람들이네요	ᄉ ᅡ ᄅ ᅡ ᆷ ᄃ ᅳ ᄅ ᅵ ᄂ ᅦ ᄋ ᅭ
어쩜	ᄋ ᅥ ᄍ ᅥ ᆷ
뻔뻔한	ᄈ ᅥ ᆫ ᄈ ᅥ ᆫ ᄒ ᅡ ᆫ
태도로	ᄐ ᅢ ᄃ ᅩ ᄅ ᅩ
일관할	ᄋ ᅵ ᆯ ᄀ ᅪ ᆫ ᄒ ᅡ ᆯ
있죠	ᄋ ᅵ ᆮ ᄍ ᅭ
말해도	ᄆ ᅡ ᆯ ᄒ ᅢ ᄃ ᅩ
바뀌지	ᄇ ᅡ ᄁ ᅱ ᄌ ᅵ
않으니	ᄋ ᅡ ᄂ ᅳ ᄂ ᅵ
어떡해야	ᄋ ᅥ ᄄ ᅥ ᄏ ᅢ ᄋ ᅣ
합니까	ᄒ ᅡ ᆷ ᄂ ᅵ ᄁ ᅡ
사람에	ᄉ ᅡ ᄅ ᅡ ᄆ ᅦ
대한	ᄃ ᅢ ᄒ ᅡ ᆫ
얘기라면	ᄋ ᅤ ᄀ ᅵ ᄅ ᅡ ᄆ ᅧ ᆫ
별로	ᄇ ᅧ ᆯ ᄅ ᅩ
짜증	ᄍ ᅡ ᄌ ᅳ ᆼ
나게	ᄂ ᅡ ᄀ ᅦ
노트북이	ᄂ ᅩ ᄐ ᅳ ᄇ ᅮ ᄀ ᅵ
왜	ᄋ ᅫ
느리냐	ᄂ ᅳ ᄅ ᅵ ᄂ ᅣ
여기저기	ᄋ ᅧ ᄀ ᅵ ᄌ ᅥ ᄀ ᅵ
시비	ᄉ ᅵ ᄇ ᅵ
거는	ᄀ ᅥ ᄂ ᅳ ᆫ
놈들은	ᄂ ᅩ ᆷ ᄃ ᅳ ᄅ ᅳ ᆫ
아예	ᄋ ᅡ ᄋ ᅨ
상대하지	ᄉ ᅡ ᆼ ᄃ ᅢ ᄒ ᅡ ᄌ ᅵ
말아야	ᄆ ᅡ ᄅ ᅡ ᄋ ᅣ
해요	ᄒ ᅢ ᄋ ᅭ
동창회	ᄃ ᅩ ᆼ ᄎ ᅡ ᆼ ᄒ ᅬ
일은	ᄋ ᅵ ᄅ ᅳ ᆫ
생각할수록	ᄉ ᅢ ᆼ ᄀ ᅡ ᄏ ᅡ ᆯ ᄊ ᅮ ᄅ ᅩ ᆨ
신경질이	ᄉ ᅵ ᆫ ᄀ ᅧ ᆼ ᄌ ᅵ ᄅ ᅵ
너는	ᄂ ᅥ ᄂ ᅳ ᆫ
잘나서	ᄌ ᅡ ᆯ ᄅ ᅡ ᄉ ᅥ
멋대로야	ᄆ ᅥ ᆮ ᄄ ᅢ ᄅ ᅩ ᄋ ᅣ
한동안	ᄒ ᅡ ᆫ ᄃ ᅩ ᆼ ᄋ ᅡ ᆫ
자중하고	ᄌ ᅡ ᄌ ᅮ ᆼ ᄒ ᅡ ᄀ ᅩ
사나	ᄉ ᅡ ᄂ ᅡ
싶더니	ᄉ ᅵ ᆸ ᄄ ᅥ ᄂ ᅵ
또다시	ᄄ ᅩ ᄃ ᅡ ᄉ ᅵ
설치고	ᄉ ᅥ ᆯ ᄎ ᅵ ᄀ ᅩ
다니네	ᄃ ᅡ ᄂ ᅵ ᄂ ᅦ
남의	ᄂ ᅡ ᄆ ᅴ
영업장에서	ᄋ ᅧ ᆼ ᄋ ᅥ ᆸ ᄍ ᅡ ᆼ ᄋ ᅦ ᄉ ᅥ
뭐	ᄆ ᅯ
하시는	ᄒ ᅡ ᄉ ᅵ ᄂ ᅳ ᆫ
처리	ᄎ ᅥ ᄅ ᅵ
이딴	ᄋ ᅵ ᄄ ᅡ ᆫ
식으로	ᄉ ᅵ ᄀ ᅳ ᄅ ᅩ
거면	ᄀ ᅥ ᄆ ᅧ ᆫ
관두세요	ᄀ ᅪ ᆫ ᄃ ᅮ ᄉ ᅦ ᄋ ᅭ
방해하시면	ᄇ ᅡ ᆼ ᄒ ᅢ ᄒ ᅡ ᄉ ᅵ ᄆ ᅧ ᆫ
곤란합니다	ᄀ ᅩ ᆯ ᄅ ᅡ ᆫ ᄒ ᅡ ᆷ ᄂ ᅵ ᄃ ᅡ
이틀도	ᄋ ᅵ ᄐ ᅳ ᆯ ᄃ ᅩ
아니고	ᄋ ᅡ ᄂ ᅵ ᄀ ᅩ
상습범이네요	ᄉ ᅡ ᆼ ᄉ ᅳ ᆸ ᄈ ᅥ ᄆ ᅵ ᄂ ᅦ ᄋ ᅭ
폭언을	ᄑ ᅩ ᄀ ᅥ ᄂ ᅳ ᆯ
일삼는	ᄋ ᅵ ᆯ ᄉ ᅡ ᆷ ᄂ ᅳ ᆫ
당장	ᄃ ᅡ ᆼ ᄌ ᅡ ᆼ
잘라버려야	ᄌ ᅡ ᆯ ᄅ ᅡ ᄇ ᅥ ᄅ ᅧ ᄋ ᅣ
건물주의	ᄀ ᅥ ᆫ ᄆ ᅮ ᆯ ᄌ ᅮ ᄋ ᅴ
오만하고	ᄋ ᅩ ᄆ ᅡ ᆫ ᄒ ᅡ ᄀ ᅩ
태도에	ᄐ ᅢ ᄃ ᅩ ᄋ ᅦ
기가	ᄀ ᅵ ᄀ ᅡ
찹니다	ᄎ ᅡ ᆷ ᄂ ᅵ ᄃ ᅡ
말이	ᄆ ᅡ ᄅ ᅵ
사실이라면	ᄉ ᅡ ᄉ ᅵ ᄅ ᅵ ᄅ ᅡ ᄆ ᅧ ᆫ
가만	ᄀ ᅡ ᄆ ᅡ ᆫ
있지	ᄋ ᅵ ᆮ ᄍ ᅵ
않을	ᄋ ᅡ ᄂ ᅳ ᆯ
겁니다	ᄀ ᅥ ᆷ ᄂ ᅵ ᄃ ᅡ
정치인들을	ᄌ ᅥ ᆼ ᄎ ᅵ ᄋ ᅵ ᆫ ᄃ ᅳ ᄅ ᅳ ᆯ
다들	ᄃ ᅡ ᄃ ᅳ ᆯ
잘났다고	ᄌ ᅡ ᆯ ᄅ ᅡ ᆮ ᄄ ᅡ ᄀ ᅩ
저러고들	ᄌ ᅥ ᄅ ᅥ ᄀ ᅩ ᄃ ᅳ ᆯ
답이	ᄃ ᅡ ᄇ ᅵ
없네	ᄋ ᅥ ᆷ ᄂ ᅦ
층간	ᄎ ᅳ ᆼ ᄀ ᅡ ᆫ
소음	ᄉ ᅩ ᄋ ᅳ ᆷ
열불이	ᄋ ᅧ ᆯ ᄇ ᅮ ᄅ ᅵ
도저히	ᄃ ᅩ ᄌ ᅥ ᄒ ᅵ
더는	ᄃ ᅥ ᄂ ᅳ ᆫ
참겠어요	ᄎ ᅡ ᆷ ᄁ ᅦ ᄊ ᅥ ᄋ ᅭ
지난	ᄌ ᅵ ᄂ ᅡ ᆫ
여름	ᄋ ᅧ ᄅ ᅳ ᆷ
민박집에서	ᄆ ᅵ ᆫ ᄇ ᅡ ᆨ ᄍ ᅵ ᄇ ᅦ ᄉ ᅥ
바가지	ᄇ ᅡ ᄀ ᅡ ᄌ ᅵ
쓴	ᄊ ᅳ ᆫ
지금도	ᄌ ᅵ ᄀ ᅳ ᆷ ᄃ ᅩ
음주운전은	ᄋ ᅳ ᆷ ᄌ ᅮ ᄋ ᅮ ᆫ ᄌ ᅥ ᄂ ᅳ ᆫ
본인뿐	ᄇ ᅩ ᄂ ᅵ ᆫ ᄈ ᅮ ᆫ
타인에게까지	ᄐ ᅡ ᄋ ᅵ ᄂ ᅦ ᄀ ᅦ ᄁ ᅡ ᄌ ᅵ
피해를	ᄑ ᅵ ᄒ ᅢ ᄅ ᅳ ᆯ
주는	ᄌ ᅮ ᄂ ᅳ ᆫ
강력범죄야	ᄀ ᅡ ᆼ ᄂ ᅧ ᆨ ᄈ ᅥ ᆷ ᄌ ᅬ ᄋ ᅣ
클럽에	ᄏ ᅳ ᆯ ᄅ ᅥ ᄇ ᅦ
갔다는	ᄀ ᅡ ᆮ ᄄ ᅡ ᄂ ᅳ ᆫ
배신감을	ᄇ ᅢ ᄉ ᅵ ᆫ ᄀ ᅡ ᄆ ᅳ ᆯ
느꼈어	ᄂ ᅳ ᄁ ᅧ ᄊ ᅥ
옷	ᄋ ᅩ ᆮ
가게에	ᄀ ᅡ ᄀ ᅦ ᄋ ᅦ
갔는데	ᄀ ᅡ ᆫ ᄂ ᅳ ᆫ ᄃ ᅦ
육육	ᄋ ᅲ ᄀ ᅲ ᆨ
이상은	ᄋ ᅵ ᄉ ᅡ ᆼ ᄋ ᅳ ᆫ
없다고	ᄋ ᅥ ᆸ ᄄ ᅡ ᄀ ᅩ
해서	ᄒ ᅢ ᄉ ᅥ
상했어	ᄉ ᅡ ᆼ ᄒ ᅢ ᄊ ᅥ
외모지상주의에	ᄋ ᅬ ᄆ ᅩ ᄌ ᅵ ᄉ ᅡ ᆼ ᄌ ᅮ ᄋ ᅴ ᄋ ᅦ
빠진	ᄈ ᅡ ᄌ ᅵ ᆫ
현대사회의	ᄒ ᅧ ᆫ ᄃ ᅢ ᄉ ᅡ ᄒ ᅬ ᄋ ᅴ
병폐를	ᄇ ᅧ ᆼ ᄑ ᅨ ᄅ ᅳ ᆯ
강력히	ᄀ ᅡ ᆼ ᄂ ᅧ ᄏ ᅵ
규탄한다	ᄀ ᅲ ᄐ ᅡ ᆫ ᄒ ᅡ ᆫ ᄃ ᅡ
쓰레기	ᄊ ᅳ ᄅ ᅦ ᄀ ᅵ
분리	ᄇ ᅮ ᆯ ᄅ ᅵ
수거를	ᄉ ᅮ ᄀ ᅥ ᄅ ᅳ ᆯ
하지	ᄒ ᅡ ᄌ ᅵ
않는	ᄋ ᅡ ᆫ ᄂ ᅳ ᆫ
이웃들	ᄋ ᅵ ᄋ ᅮ ᆮ ᄄ ᅳ ᆯ
아동학대	ᄋ ᅡ ᄃ ᅩ ᆼ ᄒ ᅡ ᆨ ᄄ ᅢ
뉴스를	ᄂ ᅲ ᄉ ᅳ ᄅ ᅳ ᆯ
분노가	ᄇ ᅮ ᆫ ᄂ ᅩ ᄀ ᅡ
끓어오른다니까	ᄁ ᅳ ᄅ ᅥ ᄋ ᅩ ᄅ ᅳ ᆫ ᄃ ᅡ ᄂ ᅵ ᄁ ᅡ
기념일을	ᄀ ᅵ ᄂ ᅧ ᄆ ᅵ ᄅ ᅳ ᆯ
잊어버린	ᄋ ᅵ ᄌ ᅥ ᄇ ᅥ ᄅ ᅵ ᆫ
남자친구의	ᄂ ᅡ ᆷ ᄌ ᅡ ᄎ ᅵ ᆫ ᄀ ᅮ ᄋ ᅴ
괘씸죄를	ᄀ ᅫ ᄊ ᅵ ᆷ ᄌ ᅬ ᄅ ᅳ ᆯ
뉴스에서	ᄂ ᅲ ᄉ ᅳ ᄋ ᅦ ᄉ ᅥ
센터에	ᄉ ᅦ ᆫ ᄐ ᅥ ᄋ ᅦ
버려진	ᄇ ᅥ ᄅ ᅧ ᄌ ᅵ ᆫ
개들을	ᄀ ᅢ ᄃ ᅳ ᄅ ᅳ ᆯ
봤는데	ᄇ ᅪ ᆫ ᄂ ᅳ ᆫ ᄃ ᅦ
보기	ᄇ ᅩ ᄀ ᅵ
불편하더라	ᄇ ᅮ ᆯ ᄑ ᅧ ᆫ ᄒ ᅡ ᄃ ᅥ ᄅ ᅡ
공원에	ᄀ ᅩ ᆼ ᄋ ᅯ ᄂ ᅦ
목줄도	ᄆ ᅩ ᆨ ᄍ ᅮ ᆯ ᄃ ᅩ
않은	ᄋ ᅡ ᄂ ᅳ ᆫ
개들이	ᄀ ᅢ ᄃ ᅳ ᄅ ᅵ
돌아다니는	ᄃ ᅩ ᄅ ᅡ ᄃ ᅡ ᄂ ᅵ ᄂ ᅳ ᆫ
불쾌해	ᄇ ᅮ ᆯ ᄏ ᅫ ᄒ ᅢ
편의점에서	ᄑ ᅧ ᄂ ᅴ ᄌ ᅥ ᄆ ᅦ ᄉ ᅥ
교대	ᄀ ᅭ ᄃ ᅢ
시간마다	ᄉ ᅵ ᄀ ᅡ ᆫ ᄆ ᅡ ᄃ ᅡ
늦는	ᄂ ᅳ ᆫ ᄂ ᅳ ᆫ
동료에게	ᄃ ᅩ ᆼ ᄂ ᅭ ᄋ ᅦ ᄀ ᅦ
따끔하게	ᄄ ᅡ ᄁ ᅳ ᆷ ᄒ ᅡ ᄀ ᅦ
했어	ᄒ ᅢ ᄊ ᅥ
블로그에	ᄇ ᅳ ᆯ ᄅ ᅩ ᄀ ᅳ ᄋ ᅦ
나온	ᄂ ᅡ ᄋ ᅩ ᆫ
식당에	ᄉ ᅵ ᆨ ᄄ ᅡ ᆼ ᄋ ᅦ
갔다가	ᄀ ᅡ ᆮ ᄄ ᅡ ᄀ ᅡ
터무니없는	ᄐ ᅥ ᄆ ᅮ ᄂ ᅵ ᄋ ᅥ ᆷ ᄂ ᅳ ᆫ
비싼	ᄇ ᅵ ᄊ ᅡ ᆫ
가격을	ᄀ ᅡ ᄀ ᅧ ᄀ ᅳ ᆯ
어처구니가	ᄋ ᅥ ᄎ ᅥ ᄀ ᅮ ᄂ ᅵ ᄀ ᅡ
없었어	ᄋ ᅥ ᆸ ᄊ ᅥ ᄊ ᅥ
퇴근	ᄐ ᅬ ᄀ ᅳ ᆫ
후에도	ᄒ ᅮ ᄋ ᅦ ᄃ ᅩ
카톡으로	ᄏ ᅡ ᄐ ᅩ ᄀ ᅳ ᄅ ᅩ
업무지시를	ᄋ ᅥ ᆷ ᄆ ᅮ ᄌ ᅵ ᄉ ᅵ ᄅ ᅳ ᆯ
부장님	ᄇ ᅮ ᄌ ᅡ ᆼ ᄂ ᅵ ᆷ
폭발	ᄑ ᅩ ᆨ ᄈ ᅡ ᆯ
직전이야	ᄌ ᅵ ᆨ ᄍ ᅥ ᄂ ᅵ ᄋ ᅣ
소리를	ᄉ ᅩ ᄅ ᅵ ᄅ ᅳ ᆯ
얼마	ᄋ ᅥ ᆯ ᄆ ᅡ
전	ᄌ ᅥ ᆫ
소개팅에서	ᄉ ᅩ ᄀ ᅢ ᄐ ᅵ ᆼ ᄋ ᅦ ᄉ ᅥ
남자에게	ᄂ ᅡ ᆷ ᄌ ᅡ ᄋ ᅦ ᄀ ᅦ
거절	ᄀ ᅥ ᄌ ᅥ ᆯ
의사를	ᄋ ᅴ ᄉ ᅡ ᄅ ᅳ ᆯ
밝혔는데도	ᄇ ᅡ ᆯ ᄏ ᅧ ᆫ ᄂ ᅳ ᆫ ᄃ ᅦ ᄃ ᅩ
귀찮아	ᄀ ᅱ ᄎ ᅡ ᄂ ᅡ
극장에서	ᄀ ᅳ ᆨ ᄍ ᅡ ᆼ ᄋ ᅦ ᄉ ᅥ
영화를	ᄋ ᅧ ᆼ ᄒ ᅪ ᄅ ᅳ ᆯ
보는데	ᄇ ᅩ ᄂ ᅳ ᆫ ᄃ ᅦ
뒷좌석에서	ᄃ ᅱ ᆮ ᄍ ᅪ ᄉ ᅥ ᄀ ᅦ ᄉ ᅥ
다리를	ᄃ ᅡ ᄅ ᅵ ᄅ ᅳ ᆯ
떠는	ᄄ ᅥ ᄂ ᅳ ᆫ
바람에	ᄇ ᅡ ᄅ ᅡ ᄆ ᅦ
집중을	ᄌ ᅵ ᆸ ᄍ ᅮ ᆼ ᄋ ᅳ ᆯ
사촌	ᄉ ᅡ ᄎ ᅩ ᆫ
결혼식에	ᄀ ᅧ ᆯ ᄒ ᅩ ᆫ ᄉ ᅵ ᄀ ᅦ
친척들의	ᄎ ᅵ ᆫ ᄎ ᅥ ᆨ ᄄ ᅳ ᄅ ᅴ
성화에	ᄉ ᅥ ᆼ ᄒ ᅪ ᄋ ᅦ
비참했어	ᄇ ᅵ ᄎ ᅡ ᆷ ᄒ ᅢ ᄊ ᅥ
불금이면	ᄇ ᅮ ᆯ ᄀ ᅳ ᄆ ᅵ ᄆ ᅧ ᆫ
뭐하냐고	ᄆ ᅯ ᄒ ᅡ ᄂ ᅣ ᄀ ᅩ
오늘도	ᄋ ᅩ ᄂ ᅳ ᆯ ᄃ ᅩ
야근이라	ᄋ ᅣ ᄀ ᅳ ᄂ ᅵ ᄅ ᅡ
언제	ᄋ ᅥ ᆫ ᄌ ᅦ
집에	ᄌ ᅵ ᄇ ᅦ
있을지도	ᄋ ᅵ ᄊ ᅳ ᆯ ᄌ ᅵ ᄃ ᅩ
모르는데	ᄆ ᅩ ᄅ ᅳ ᄂ ᅳ ᆫ ᄃ ᅦ
술만	ᄉ ᅮ ᆯ ᄆ ᅡ ᆫ
끊기는	ᄁ ᅳ ᆫ ᄏ ᅵ ᄂ ᅳ ᆫ
남자친구에게	ᄂ ᅡ ᆷ ᄌ ᅡ ᄎ ᅵ ᆫ ᄀ ᅮ ᄋ ᅦ ᄀ ᅦ
최후	ᄎ ᅬ ᄒ ᅮ
통첩했어	ᄐ ᅩ ᆼ ᄎ ᅥ ᄑ ᅢ ᄊ ᅥ
고구마	ᄀ ᅩ ᄀ ᅮ ᄆ ᅡ
전개에	ᄌ ᅥ ᆫ ᄀ ᅢ ᄋ ᅦ
답답해	ᄃ ᅡ ᆸ ᄄ ᅡ ᄑ ᅢ
죽는	ᄌ ᅮ ᆼ ᄂ ᅳ ᆫ
알았다니까	ᄋ ᅡ ᄅ ᅡ ᆮ ᄄ ᅡ ᄂ ᅵ ᄁ ᅡ
다닐	ᄃ ᅡ ᄂ ᅵ ᆯ
나보다	ᄂ ᅡ ᄇ ᅩ ᄃ ᅡ
공부도	ᄀ ᅩ ᆼ ᄇ ᅮ ᄃ ᅩ
못했던	ᄆ ᅩ ᄐ ᅢ ᆮ ᄄ ᅥ ᆫ
친구가	ᄎ ᅵ ᆫ ᄀ ᅮ ᄀ ᅡ
대기업에	ᄃ ᅢ ᄀ ᅵ ᄋ ᅥ ᄇ ᅦ
다닌다는	ᄃ ᅡ ᄂ ᅵ ᆫ ᄃ ᅡ ᄂ ᅳ ᆫ
솔직히	ᄉ ᅩ ᆯ ᄌ ᅵ ᄏ ᅵ
아팠어	ᄋ ᅡ ᄑ ᅡ ᄊ ᅥ
헤어진	ᄒ ᅦ ᄋ ᅥ ᄌ ᅵ ᆫ
연락해서	ᄋ ᅧ ᆯ ᄅ ᅡ ᄏ ᅢ ᄉ ᅥ
짜증나	ᄍ ᅡ ᄌ ᅳ ᆼ ᄂ ᅡ
아파트	ᄋ ᅡ ᄑ ᅡ ᄐ ᅳ
베란다에서	ᄇ ᅦ ᄅ ᅡ ᆫ ᄃ ᅡ ᄋ ᅦ ᄉ ᅥ
담배	ᄃ ᅡ ᆷ ᄇ ᅢ
냄새가	ᄂ ᅢ ᆷ ᄉ ᅢ ᄀ ᅡ
올라오는	ᄋ ᅩ ᆯ ᄅ ᅡ ᄋ ᅩ ᄂ ᅳ ᆫ
신경이	ᄉ ᅵ ᆫ ᄀ ᅧ ᆼ ᄋ ᅵ
날카로워	ᄂ ᅡ ᆯ ᄏ ᅡ ᄅ ᅩ ᄋ ᅯ
후에	ᄒ ᅮ ᄋ ᅦ
연락도	ᄋ ᅧ ᆯ ᄅ ᅡ ᆨ ᄄ ᅩ
없던	ᄋ ᅥ ᆸ ᄄ ᅥ ᆫ
청첩장을	ᄎ ᅥ ᆼ ᄎ ᅥ ᆸ ᄍ ᅡ ᆼ ᄋ ᅳ ᆯ
보낸	ᄇ ᅩ ᄂ ᅢ ᆫ
얄밉던지	ᄋ ᅣ ᆯ ᄆ ᅵ ᆸ ᄄ ᅥ ᆫ ᄌ ᅵ
세상에서	ᄉ ᅦ ᄉ ᅡ ᆼ ᄋ ᅦ ᄉ ᅥ
갑질하는	ᄀ ᅡ ᆸ ᄍ ᅵ ᆯ ᄒ ᅡ ᄂ ᅳ ᆫ
싫어	ᄉ ᅵ ᄅ ᅥ
기분에	ᄀ ᅵ ᄇ ᅮ ᄂ ᅦ
따라	ᄄ ᅡ ᄅ ᅡ
부하직원들을	ᄇ ᅮ ᄒ ᅡ ᄌ ᅵ ᄀ ᅯ ᆫ ᄃ ᅳ ᄅ ᅳ ᆯ
평가하는	ᄑ ᅧ ᆼ ᄀ ᅡ ᄒ ᅡ ᄂ ᅳ ᆫ
상사랑	ᄉ ᅡ ᆼ ᄉ ᅡ ᄅ ᅡ ᆼ
일하는	ᄋ ᅵ ᆯ ᄒ ᅡ ᄂ ᅳ ᆫ
고역이야	ᄀ ᅩ ᄋ ᅧ ᄀ ᅵ ᄋ ᅣ
나랑	ᄂ ᅡ ᄅ ᅡ ᆼ
헤어지고	ᄒ ᅦ ᄋ ᅥ ᄌ ᅵ ᄀ ᅩ
달도	ᄃ ᅡ ᆯ ᄃ ᅩ
돼서	ᄃ ᅫ ᄉ ᅥ
여자랑	ᄋ ᅧ ᄌ ᅡ ᄅ ᅡ ᆼ
결혼이라니	ᄀ ᅧ ᆯ ᄒ ᅩ ᄂ ᅵ ᄅ ᅡ ᄂ ᅵ
복수할	ᄇ ᅩ ᆨ ᄊ ᅮ ᄒ ᅡ ᆯ
적반하장도	ᄌ ᅥ ᆨ ᄈ ᅡ ᆫ ᄒ ᅡ ᄌ ᅡ ᆼ ᄃ ᅩ
유분수지	ᄋ ᅲ ᄇ ᅮ ᆫ ᄉ ᅮ ᄌ ᅵ
불난	ᄇ ᅮ ᆯ ᄅ ᅡ ᆫ
부채질하냐	ᄇ ᅮ ᄎ ᅢ ᄌ ᅵ ᆯ ᄒ ᅡ ᄂ ᅣ
신입사원들한테	ᄉ ᅵ ᄂ ᅵ ᆸ ᄊ ᅡ ᄋ ᅯ ᆫ ᄃ ᅳ ᆯ ᄒ ᅡ ᆫ ᄐ ᅦ
잘해줬더니	ᄌ ᅡ ᆯ ᄒ ᅢ ᄌ ᅯ ᆮ ᄄ ᅥ ᄂ ᅵ
봤는지	ᄇ ᅪ ᆫ ᄂ ᅳ ᆫ ᄌ ᅵ
기어올라서	ᄀ ᅵ ᄋ ᅥ ᄋ ᅩ ᆯ ᄅ ᅡ ᄉ ᅥ
받아	ᄇ ᅡ ᄃ ᅡ
다이어트만	ᄃ ᅡ ᄋ ᅵ ᄋ ᅥ ᄐ ᅳ ᄆ ᅡ ᆫ
시작하면	ᄉ ᅵ ᄌ ᅡ ᄏ ᅡ ᄆ ᅧ ᆫ
야식을	ᄋ ᅣ ᄉ ᅵ ᄀ ᅳ ᆯ
시켜	ᄉ ᅵ ᄏ ᅧ
먹는다니까	ᄆ ᅥ ᆼ ᄂ ᅳ ᆫ ᄃ ᅡ ᄂ ᅵ ᄁ ᅡ
왠수가	ᄋ ᅫ ᆫ ᄉ ᅮ ᄀ ᅡ
신은	ᄉ ᅵ ᄂ ᅳ ᆫ
불공평해	ᄇ ᅮ ᆯ ᄀ ᅩ ᆼ ᄑ ᅧ ᆼ ᄒ ᅢ
물만	ᄆ ᅮ ᆯ ᄆ ᅡ ᆫ
먹어도	ᄆ ᅥ ᄀ ᅥ ᄃ ᅩ
살이	ᄉ ᅡ ᄅ ᅵ
찌는	ᄍ ᅵ ᄂ ᅳ ᆫ
소개팅남	ᄉ ᅩ ᄀ ᅢ ᄐ ᅵ ᆼ ᄂ ᅡ ᆷ
트림한	ᄐ ᅳ ᄅ ᅵ ᆷ ᄒ ᅡ ᆫ
창피하고	ᄎ ᅡ ᆼ ᄑ ᅵ ᄒ ᅡ ᄀ ᅩ
신경질	ᄉ ᅵ ᆫ ᄀ ᅧ ᆼ ᄌ ᅵ ᆯ
독박	ᄃ ᅩ ᆨ ᄈ ᅡ ᆨ
육아로	ᄋ ᅲ ᄀ ᅡ ᄅ ᅩ
힘들어하는	ᄒ ᅵ ᆷ ᄃ ᅳ ᄅ ᅥ ᄒ ᅡ ᄂ ᅳ ᆫ
보니까	ᄇ ᅩ ᄂ ᅵ ᄁ ᅡ
남	ᄂ ᅡ ᆷ
같지	ᄀ ᅡ ᆮ ᄍ ᅵ
선배라고	ᄉ ᅥ ᆫ ᄇ ᅢ ᄅ ᅡ ᄀ ᅩ
무조건	ᄆ ᅮ ᄌ ᅩ ᄀ ᅥ ᆫ
후배들에게	ᄒ ᅮ ᄇ ᅢ ᄃ ᅳ ᄅ ᅦ ᄀ ᅦ
밥	ᄇ ᅡ ᆸ
사주고	ᄉ ᅡ ᄌ ᅮ ᄀ ᅩ
술	ᄉ ᅮ ᆯ
사주는	ᄉ ᅡ ᄌ ᅮ ᄂ ᅳ ᆫ
아니라고	ᄋ ᅡ ᄂ ᅵ ᄅ ᅡ ᄀ ᅩ
화장실에서	ᄒ ᅪ ᄌ ᅡ ᆼ ᄉ ᅵ ᄅ ᅦ ᄉ ᅥ
뒷말	ᄃ ᅱ ᆫ ᄆ ᅡ ᆯ
들었어	ᄃ ᅳ ᄅ ᅥ ᄊ ᅥ
잡히면	ᄌ ᅡ ᄑ ᅵ ᄆ ᅧ ᆫ
가만두지	ᄀ ᅡ ᄆ ᅡ ᆫ ᄃ ᅮ ᄌ ᅵ
애지중지	ᄋ ᅢ ᄌ ᅵ ᄌ ᅮ ᆼ ᄌ ᅵ
모아온	ᄆ ᅩ ᄋ ᅡ ᄋ ᅩ ᆫ
피겨를	ᄑ ᅵ ᄀ ᅧ ᄅ ᅳ ᆯ
엄마가	ᄋ ᅥ ᆷ ᄆ ᅡ ᄀ ᅡ
조카에게	ᄌ ᅩ ᄏ ᅡ ᄋ ᅦ ᄀ ᅦ
줘버렸어	ᄌ ᅯ ᄇ ᅥ ᄅ ᅧ ᄊ ᅥ
회식	ᄒ ᅬ ᄉ ᅵ ᆨ
자리에서	ᄌ ᅡ ᄅ ᅵ ᄋ ᅦ ᄉ ᅥ
먹는	ᄆ ᅥ ᆼ ᄂ ᅳ ᆫ
억지로	ᄋ ᅥ ᆨ ᄍ ᅵ ᄅ ᅩ
권하는	ᄀ ᅯ ᆫ ᄒ ᅡ ᄂ ᅳ ᆫ
상사들은	ᄉ ᅡ ᆼ ᄉ ᅡ ᄃ ᅳ ᄅ ᅳ ᆫ
선거철만	ᄉ ᅥ ᆫ ᄀ ᅥ ᄎ ᅥ ᆯ ᄆ ᅡ ᆫ
간이고	ᄀ ᅡ ᄂ ᅵ ᄀ ᅩ
쓸개고	ᄊ ᅳ ᆯ ᄀ ᅢ ᄀ ᅩ
내줄	ᄂ ᅢ ᄌ ᅮ ᆯ
구는	ᄀ ᅮ ᄂ ᅳ ᆫ
꼴불견이야	ᄁ ᅩ ᆯ ᄇ ᅮ ᆯ ᄀ ᅧ ᄂ ᅵ ᄋ ᅣ
운전하는	ᄋ ᅮ ᆫ ᄌ ᅥ ᆫ ᄒ ᅡ ᄂ ᅳ ᆫ
무단횡단하는	ᄆ ᅮ ᄃ ᅡ ᆫ ᄒ ᅬ ᆼ ᄃ ᅡ ᆫ ᄒ ᅡ ᄂ ᅳ ᆫ
몰상식한	ᄆ ᅩ ᆯ ᄊ ᅡ ᆼ ᄉ ᅵ ᄏ ᅡ ᆫ
사람들	ᄉ ᅡ ᄅ ᅡ ᆷ ᄃ ᅳ ᆯ
감수했다니까	ᄀ ᅡ ᆷ ᄉ ᅮ ᄒ ᅢ ᆮ ᄄ ᅡ ᄂ ᅵ ᄁ ᅡ
초보	ᄎ ᅩ ᄇ ᅩ
운전자에	ᄋ ᅮ ᆫ ᄌ ᅥ ᆫ ᄌ ᅡ ᄋ ᅦ
배려는커녕	ᄇ ᅢ ᄅ ᅧ ᄂ ᅳ ᆫ ᄏ ᅥ ᄂ ᅧ ᆼ
난폭	ᄂ ᅡ ᆫ ᄑ ᅩ ᆨ
운전자들	ᄋ ᅮ ᆫ ᄌ ᅥ ᆫ ᄌ ᅡ ᄃ ᅳ ᆯ
운전대만	ᄋ ᅮ ᆫ ᄌ ᅥ ᆫ ᄃ ᅢ ᄆ ᅡ ᆫ
잡으면	ᄌ ᅡ ᄇ ᅳ ᄆ ᅧ ᆫ
흥분돼	ᄒ ᅳ ᆼ ᄇ ᅮ ᆫ ᄃ ᅫ
정규직이	ᄌ ᅥ ᆼ ᄀ ᅲ ᄌ ᅵ ᄀ ᅵ
못된	ᄆ ᅩ ᆮ ᄄ ᅬ ᆫ
미래를	ᄆ ᅵ ᄅ ᅢ ᄅ ᅳ ᆯ
고작	ᄀ ᅩ ᄌ ᅡ ᆨ
연봉을	ᄋ ᅧ ᆫ ᄇ ᅩ ᆼ ᄋ ᅳ ᆯ
받으려고	ᄇ ᅡ ᄃ ᅳ ᄅ ᅧ ᄀ ᅩ
고생했었나	ᄀ ᅩ ᄉ ᅢ ᆼ ᄒ ᅢ ᄊ ᅥ ᆫ ᄂ ᅡ
억울하고	ᄋ ᅥ ᄀ ᅮ ᆯ ᄒ ᅡ ᄀ ᅩ
메뉴를	ᄆ ᅦ ᄂ ᅲ ᄅ ᅳ ᆯ
본인	ᄇ ᅩ ᄂ ᅵ ᆫ
마음대로	ᄆ ᅡ ᄋ ᅳ ᆷ ᄃ ᅢ ᄅ ᅩ
결정하는	ᄀ ᅧ ᆯ ᄌ ᅥ ᆼ ᄒ ᅡ ᄂ ᅳ ᆫ
상사를	ᄉ ᅡ ᆼ ᄉ ᅡ ᄅ ᅳ ᆯ
못마땅해	ᄆ ᅩ ᆫ ᄆ ᅡ ᄄ ᅡ ᆼ ᄒ ᅢ
단골집이	ᄃ ᅡ ᆫ ᄀ ᅩ ᆯ ᄌ ᅵ ᄇ ᅵ
뉴스에	ᄂ ᅲ ᄉ ᅳ ᄋ ᅦ
불결한	ᄇ ᅮ ᆯ ᄀ ᅧ ᆯ ᄒ ᅡ ᆫ
식당이었다니	ᄉ ᅵ ᆨ ᄄ ᅡ ᆼ ᄋ ᅵ ᄋ ᅥ ᆮ ᄄ ᅡ ᄂ ᅵ
해도	ᄒ ᅢ ᄃ ᅩ
끼쳐	ᄁ ᅵ ᄎ ᅥ
바쁜	ᄇ ᅡ ᄈ ᅳ ᆫ
시간에	ᄉ ᅵ ᄀ ᅡ ᄂ ᅦ
보험	ᄇ ᅩ ᄒ ᅥ ᆷ
판매	ᄑ ᅡ ᆫ ᄆ ᅢ
전화가	ᄌ ᅥ ᆫ ᄒ ᅪ ᄀ ᅡ
구내식당은	ᄀ ᅮ ᄂ ᅢ ᄉ ᅵ ᆨ ᄄ ᅡ ᆼ ᄋ ᅳ ᆫ
저렴하고	ᄌ ᅥ ᄅ ᅧ ᆷ ᄒ ᅡ ᄀ ᅩ
깨끗해서	ᄁ ᅢ ᄁ ᅳ ᄐ ᅢ ᄉ ᅥ
좋지만	ᄌ ᅩ ᄎ ᅵ ᄆ ᅡ ᆫ
메뉴가	ᄆ ᅦ ᄂ ᅲ ᄀ ᅡ
한결같아서	ᄒ ᅡ ᆫ ᄀ ᅧ ᆯ ᄀ ᅡ ᄐ ᅡ ᄉ ᅥ
지겨워	ᄌ ᅵ ᄀ ᅧ ᄋ ᅯ
시간인데도	ᄉ ᅵ ᄀ ᅡ ᄂ ᅵ ᆫ ᄃ ᅦ ᄃ ᅩ
자리만	ᄌ ᅡ ᄅ ᅵ ᄆ ᅡ ᆫ
지키고	ᄌ ᅵ ᄏ ᅵ ᄀ ᅩ
부장님이	ᄇ ᅮ ᄌ ᅡ ᆼ ᄂ ᅵ ᄆ ᅵ
야속해	ᄋ ᅣ ᄉ ᅩ ᄏ ᅢ
동생이	ᄃ ᅩ ᆼ ᄉ ᅢ ᆼ ᄋ ᅵ
구두	ᄀ ᅮ ᄃ ᅮ
신었다고	ᄉ ᅵ ᄂ ᅥ ᆮ ᄄ ᅡ ᄀ ᅩ
난리를	ᄂ ᅡ ᆯ ᄅ ᅵ ᄅ ᅳ ᆯ
치는	ᄎ ᅵ ᄂ ᅳ ᆫ
얄밉더라	ᄋ ᅣ ᆯ ᄆ ᅵ ᆸ ᄄ ᅥ ᄅ ᅡ
이건	ᄋ ᅵ ᄀ ᅥ ᆫ
명백한	ᄆ ᅧ ᆼ ᄇ ᅢ ᄏ ᅡ ᆫ
살인	ᄉ ᅡ ᄅ ᅵ ᆫ
미수인데	ᄆ ᅵ ᄉ ᅮ ᄋ ᅵ ᆫ ᄃ ᅦ
처벌이	ᄎ ᅥ ᄇ ᅥ ᄅ ᅵ
약한	ᄋ ᅣ ᄏ ᅡ ᆫ
얘기만	ᄋ ᅤ ᄀ ᅵ ᄆ ᅡ ᆫ
나오면	ᄂ ᅡ ᄋ ᅩ ᄆ ᅧ ᆫ
꽁무니를	ᄁ ᅩ ᆼ ᄆ ᅮ ᄂ ᅵ ᄅ ᅳ ᆯ
빼는	ᄈ ᅢ ᄂ ᅳ ᆫ
남자친구	ᄂ ᅡ ᆷ ᄌ ᅡ ᄎ ᅵ ᆫ ᄀ ᅮ
미치겠어	ᄆ ᅵ ᄎ ᅵ ᄀ ᅦ ᄊ ᅥ
한정판	ᄒ ᅡ ᆫ ᄌ ᅥ ᆼ ᄑ ᅡ ᆫ
가방을	ᄀ ᅡ ᄇ ᅡ ᆼ ᄋ ᅳ ᆯ
샀다고	ᄉ ᅡ ᆮ ᄄ ᅡ ᄀ ᅩ
여자친구가	ᄋ ᅧ ᄌ ᅡ ᄎ ᅵ ᆫ ᄀ ᅮ ᄀ ᅡ
헤어지자고	ᄒ ᅦ ᄋ ᅥ ᄌ ᅵ ᄌ ᅡ ᄀ ᅩ
넘어	ᄂ ᅥ ᄆ ᅥ
산이라더니	ᄉ ᅡ ᄂ ᅵ ᄅ ᅡ ᄃ ᅥ ᄂ ᅵ
대출	ᄃ ᅢ ᄎ ᅮ ᆯ
끝나고	ᄁ ᅳ ᆫ ᄂ ᅡ ᄀ ᅩ
결혼자금이	ᄀ ᅧ ᆯ ᄒ ᅩ ᆫ ᄌ ᅡ ᄀ ᅳ ᄆ ᅵ
써온	ᄊ ᅥ ᄋ ᅩ ᆫ
이력서만	ᄋ ᅵ ᄅ ᅧ ᆨ ᄊ ᅥ ᄆ ᅡ ᆫ
백장이	ᄇ ᅢ ᆨ ᄍ ᅡ ᆼ ᄋ ᅵ
넘는다구	ᄂ ᅥ ᆷ ᄂ ᅳ ᆫ ᄃ ᅡ ᄀ ᅮ
동창회에	ᄃ ᅩ ᆼ ᄎ ᅡ ᆼ ᄒ ᅬ ᄋ ᅦ
나밖에	ᄂ ᅡ ᄇ ᅡ ᄁ ᅦ
없더라구	ᄋ ᅥ ᆸ ᄄ ᅥ ᄅ ᅡ ᄀ ᅮ
젊어서	ᄌ ᅥ ᆯ ᄆ ᅥ ᄉ ᅥ
고생은	ᄀ ᅩ ᄉ ᅢ ᆼ ᄋ ᅳ ᆫ
사서도	ᄉ ᅡ ᄉ ᅥ ᄃ ᅩ
한다고	ᄒ ᅡ ᆫ ᄃ ᅡ ᄀ ᅩ
고생	ᄀ ᅩ ᄉ ᅢ ᆼ
끝이냐고	ᄁ ᅳ ᄉ ᅵ ᄂ ᅣ ᄀ ᅩ
만나서	ᄆ ᅡ ᆫ ᄂ ᅡ ᄉ ᅥ
묻고	ᄆ ᅮ ᆮ ᄁ ᅩ
형편	ᄒ ᅧ ᆼ ᄑ ᅧ ᆫ
알면서	ᄋ ᅡ ᆯ ᄆ ᅧ ᆫ ᄉ ᅥ
신혼살림을	ᄉ ᅵ ᆫ ᄒ ᅩ ᆫ ᄉ ᅡ ᆯ ᄅ ᅵ ᄆ ᅳ ᆯ
아파트에서	ᄋ ᅡ ᄑ ᅡ ᄐ ᅳ ᄋ ᅦ ᄉ ᅥ
시작해야	ᄉ ᅵ ᄌ ᅡ ᄏ ᅢ ᄋ ᅣ
고집을	ᄀ ᅩ ᄌ ᅵ ᄇ ᅳ ᆯ
피우는	ᄑ ᅵ ᄋ ᅮ ᄂ ᅳ ᆫ
호감을	ᄒ ᅩ ᄀ ᅡ ᄆ ᅳ ᆯ
느끼고	ᄂ ᅳ ᄁ ᅵ ᄀ ᅩ
만나는	ᄆ ᅡ ᆫ ᄂ ᅡ ᄂ ᅳ ᆫ
직장	ᄌ ᅵ ᆨ ᄍ ᅡ ᆼ
동료가	ᄃ ᅩ ᆼ ᄂ ᅭ ᄀ ᅡ
있는데	ᄋ ᅵ ᆫ ᄂ ᅳ ᆫ ᄃ ᅦ
진심을	ᄌ ᅵ ᆫ ᄉ ᅵ ᄆ ᅳ ᆯ
모르겠어	ᄆ ᅩ ᄅ ᅳ ᄀ ᅦ ᄊ ᅥ
겉모습만	ᄀ ᅥ ᆫ ᄆ ᅩ ᄉ ᅳ ᆷ ᄆ ᅡ ᆫ
번지르르하면	ᄇ ᅥ ᆫ ᄌ ᅵ ᄅ ᅳ ᄅ ᅳ ᄒ ᅡ ᄆ ᅧ ᆫ
공중	ᄀ ᅩ ᆼ ᄌ ᅮ ᆼ
도덕도	ᄃ ᅩ ᄃ ᅥ ᆨ ᄄ ᅩ
지키는데	ᄌ ᅵ ᄏ ᅵ ᄂ ᅳ ᆫ ᄃ ᅦ
말초	ᄆ ᅡ ᆯ ᄎ ᅩ
신경계는	ᄉ ᅵ ᆫ ᄀ ᅧ ᆼ ᄀ ᅨ ᄂ ᅳ ᆫ
신경계와	ᄉ ᅵ ᆫ ᄀ ᅧ ᆼ ᄀ ᅨ ᄋ ᅪ
자율신경계로	ᄌ ᅡ ᄋ ᅲ ᆯ ᄉ ᅵ ᆫ ᄀ ᅧ ᆼ ᄀ ᅨ ᄅ ᅩ
나뉩니다	ᄂ ᅡ ᄂ ᅱ ᆷ ᄂ ᅵ ᄃ ᅡ
두산	ᄃ ᅮ ᄉ ᅡ ᆫ
베어스	ᄇ ᅦ ᄋ ᅥ ᄉ ᅳ
선수단이	ᄉ ᅥ ᆫ ᄉ ᅮ ᄃ ᅡ ᄂ ᅵ
호주로	ᄒ ᅩ ᄌ ᅮ ᄅ ᅩ
전지	ᄌ ᅥ ᆫ ᄌ ᅵ
훈련을	ᄒ ᅮ ᆯ ᄅ ᅧ ᄂ ᅳ ᆯ
떠날	ᄄ ᅥ ᄂ ᅡ ᆯ
알구	ᄋ ᅡ ᆯ ᄀ ᅮ
비닐봉지	ᄇ ᅵ ᄂ ᅵ ᆯ ᄇ ᅩ ᆼ ᄌ ᅵ
건강검진이	ᄀ ᅥ ᆫ ᄀ ᅡ ᆼ ᄀ ᅥ ᆷ ᄌ ᅵ ᄂ ᅵ
증명서를	ᄌ ᅳ ᆼ ᄆ ᅧ ᆼ ᄉ ᅥ ᄅ ᅳ ᆯ
주시구	ᄌ ᅮ ᄉ ᅵ ᄀ ᅮ
중에서	ᄌ ᅮ ᆼ ᄋ ᅦ ᄉ ᅥ
몰라두	ᄆ ᅩ ᆯ ᄅ ᅡ ᄃ ᅮ
쥐구멍에	ᄌ ᅱ ᄀ ᅮ ᄆ ᅥ ᆼ ᄋ ᅦ
그치구	ᄀ ᅳ ᄎ ᅵ ᄀ ᅮ
무너지는	ᄆ ᅮ ᄂ ᅥ ᄌ ᅵ ᄂ ᅳ ᆫ
니가	ᄂ ᅵ ᄀ ᅡ
정신이	ᄌ ᅥ ᆼ ᄉ ᅵ ᄂ ᅵ
지하철에서	ᄌ ᅵ ᄒ ᅡ ᄎ ᅥ ᄅ ᅦ ᄉ ᅥ
터진다구요	ᄐ ᅥ ᄌ ᅵ ᆫ ᄃ ᅡ ᄀ ᅮ ᄋ ᅭ
니	ᄂ ᅵ
설치구	ᄉ ᅥ ᆯ ᄎ ᅵ ᄀ ᅮ
아니구	ᄋ ᅡ ᄂ ᅵ ᄀ ᅮ
헤어지구	ᄒ ᅦ ᄋ ᅥ ᄌ ᅵ ᄀ ᅮ
적반하장	ᄌ ᅥ ᆨ ᄈ ᅡ ᆫ ᄒ ᅡ ᄌ ᅡ ᆼ
같지가	ᄀ ᅡ ᆮ ᄍ ᅵ ᄀ ᅡ
신었다구	ᄉ ᅵ ᄂ ᅥ ᆮ ᄄ ᅡ ᄀ ᅮ
해두	ᄒ ᅢ ᄃ ᅮ
넘는다고	ᄂ ᅥ ᆷ ᄂ ᅳ ᆫ ᄃ ᅡ ᄀ ᅩ
없더라고	ᄋ ᅥ ᆸ ᄄ ᅥ ᄅ ᅡ ᄀ ᅩ
오월	ᄋ ᅩ ᄋ ᅯ ᆯ
십칠일	ᄉ ᅵ ᆸ ᄎ ᅵ ᄅ ᅵ ᆯ
기준	ᄀ ᅵ ᄌ ᅮ ᆫ
홍수로	ᄒ ᅩ ᆼ ᄉ ᅮ ᄅ ᅩ
최소	ᄎ ᅬ ᄉ ᅩ
이십	ᄋ ᅵ ᄉ ᅵ ᆸ
명이	ᄆ ᅧ ᆼ ᄋ ᅵ
사망했고	ᄉ ᅡ ᄆ ᅡ ᆼ ᄒ ᅢ ᆮ ᄁ ᅩ
만육천	ᄆ ᅡ ᄂ ᅲ ᆨ ᄎ ᅥ ᆫ
명	ᄆ ᅧ ᆼ
이상이	ᄋ ᅵ ᄉ ᅡ ᆼ ᄋ ᅵ
대피하였습니다	ᄃ ᅢ ᄑ ᅵ ᄒ ᅡ ᄋ ᅧ ᆮ ᄊ ᅳ ᆷ ᄂ ᅵ ᄃ ᅡ
또한	ᄄ ᅩ ᄒ ᅡ ᆫ
경찰은	ᄀ ᅧ ᆼ ᄎ ᅡ ᄅ ᅳ ᆫ
테러	ᄐ ᅦ ᄅ ᅥ
과정에서	ᄀ ᅪ ᄌ ᅥ ᆼ ᄋ ᅦ ᄉ ᅥ
두건	ᄃ ᅮ ᄀ ᅥ ᆫ
이상의	ᄋ ᅵ ᄉ ᅡ ᆼ ᄋ ᅴ
자살	ᄌ ᅡ ᄉ ᅡ ᆯ
폭탄	ᄑ ᅩ ᆨ ᄐ ᅡ ᆫ
테러가	ᄐ ᅦ ᄅ ᅥ ᄀ ᅡ
밝혔습니다	ᄇ ᅡ ᆯ ᄏ ᅧ ᆮ ᄊ ᅳ ᆷ ᄂ ᅵ ᄃ ᅡ
값이	ᄀ ᅡ ᆸ ᄊ ᅵ
실제	ᄉ ᅵ ᆯ ᄌ ᅦ
질량이라고	ᄌ ᅵ ᆯ ᄅ ᅣ ᆼ ᄋ ᅵ ᄅ ᅡ ᄀ ᅩ
가정하면	ᄀ ᅡ ᄌ ᅥ ᆼ ᄒ ᅡ ᄆ ᅧ ᆫ
토성보다도	ᄐ ᅩ ᄉ ᅥ ᆼ ᄇ ᅩ ᄃ ᅡ ᄃ ᅩ
가볍습니다	ᄀ ᅡ ᄇ ᅧ ᆸ ᄊ ᅳ ᆷ ᄂ ᅵ ᄃ ᅡ
오닉스	ᄋ ᅩ ᄂ ᅵ ᆨ ᄊ ᅳ
스톤과	ᄉ ᅳ ᄐ ᅩ ᆫ ᄀ ᅪ
호텔이	ᄒ ᅩ ᄐ ᅦ ᄅ ᅵ
혼합된	ᄒ ᅩ ᆫ ᄒ ᅡ ᆸ ᄄ ᅬ ᆫ
개념에서	ᄀ ᅢ ᄂ ᅧ ᄆ ᅦ ᄉ ᅥ
영감을	ᄋ ᅧ ᆼ ᄀ ᅡ ᄆ ᅳ ᆯ
얻어	ᄋ ᅥ ᄃ ᅥ
지었다	ᄌ ᅵ ᄋ ᅥ ᆮ ᄄ ᅡ
골드	ᄀ ᅩ ᆯ ᄃ ᅳ
바는	ᄇ ᅡ ᄂ ᅳ ᆫ
보통	ᄇ ᅩ ᄐ ᅩ ᆼ
막대	ᄆ ᅡ ᆨ ᄄ ᅢ
모양의	ᄆ ᅩ ᄋ ᅣ ᆼ ᄋ ᅴ
금괴를	ᄀ ᅳ ᆷ ᄀ ᅬ ᄅ ᅳ ᆯ
말하며	ᄆ ᅡ ᆯ ᄒ ᅡ ᄆ ᅧ
종류	ᄌ ᅩ ᆼ ᄂ ᅲ
무게	ᄆ ᅮ ᄀ ᅦ
모양	ᄆ ᅩ ᄋ ᅣ ᆼ
순도	ᄉ ᅮ ᆫ ᄃ ᅩ
등	ᄃ ᅳ ᆼ
다양하다	ᄃ ᅡ ᄋ ᅣ ᆼ ᄒ ᅡ ᄃ ᅡ
국제	ᄀ ᅮ ᆨ ᄍ ᅦ
연맹은	ᄋ ᅧ ᆫ ᄆ ᅢ ᆼ ᄋ ᅳ ᆫ
수학의	ᄉ ᅮ ᄒ ᅡ ᄀ ᅴ
발전을	ᄇ ᅡ ᆯ ᄍ ᅥ ᄂ ᅳ ᆯ
만들어진	ᄆ ᅡ ᆫ ᄃ ᅳ ᄅ ᅥ ᄌ ᅵ ᆫ
비정부	ᄇ ᅵ ᄌ ᅥ ᆼ ᄇ ᅮ
협력	ᄒ ᅧ ᆷ ᄂ ᅧ ᆨ
단체이다	ᄃ ᅡ ᆫ ᄎ ᅦ ᄋ ᅵ ᄃ ᅡ
인간	ᄋ ᅵ ᆫ ᄀ ᅡ ᆫ
연대의	ᄋ ᅧ ᆫ ᄃ ᅢ ᄋ ᅴ
날은	ᄂ ᅡ ᄅ ᅳ ᆫ
중요성을	ᄌ ᅮ ᆼ ᄋ ᅭ ᄉ ᅥ ᆼ ᄋ ᅳ ᆯ
인식하기	ᄋ ᅵ ᆫ ᄉ ᅵ ᄏ ᅡ ᄀ ᅵ
유엔에서	ᄋ ᅲ ᄋ ᅦ ᄂ ᅦ ᄉ ᅥ
제정하였습니다	ᄌ ᅦ ᄌ ᅥ ᆼ ᄒ ᅡ ᄋ ᅧ ᆮ ᄊ ᅳ ᆷ ᄂ ᅵ ᄃ ᅡ
이사금은	ᄋ ᅵ ᄉ ᅡ ᄀ ᅳ ᄆ ᅳ ᆫ
밤에	ᄇ ᅡ ᄆ ᅦ
서쪽	ᄉ ᅥ ᄍ ᅩ ᆨ
계림의	ᄀ ᅨ ᄅ ᅵ ᄆ ᅴ
숲에서	ᄉ ᅮ ᄑ ᅦ ᄉ ᅥ
닭	ᄃ ᅡ ᆨ
우는	ᄋ ᅮ ᄂ ᅳ ᆫ
들었다	ᄃ ᅳ ᄅ ᅥ ᆮ ᄄ ᅡ
이때부터	ᄋ ᅵ ᄄ ᅢ ᄇ ᅮ ᄐ ᅥ
그는	ᄀ ᅳ ᄂ ᅳ ᆫ
직접	ᄌ ᅵ ᆨ ᄍ ᅥ ᆸ
관찰한	ᄀ ᅪ ᆫ ᄎ ᅡ ᆯ ᄒ ᅡ ᆫ
바탕으로	ᄇ ᅡ ᄐ ᅡ ᆼ ᄋ ᅳ ᄅ ᅩ
이론을	ᄋ ᅵ ᄅ ᅩ ᄂ ᅳ ᆯ
수립하였다	ᄉ ᅮ ᄅ ᅵ ᄑ ᅡ ᄋ ᅧ ᆮ ᄄ ᅡ
대전차	ᄃ ᅢ ᄌ ᅥ ᆫ ᄎ ᅡ
방호벽은	ᄇ ᅡ ᆼ ᄒ ᅩ ᄇ ᅧ ᄀ ᅳ ᆫ
콘크리트	ᄏ ᅩ ᆫ ᄏ ᅳ ᄅ ᅵ ᄐ ᅳ
구조물로	ᄀ ᅮ ᄌ ᅩ ᄆ ᅮ ᆯ ᄅ ᅩ
있으며	ᄋ ᅵ ᄊ ᅳ ᄆ ᅧ
여러	ᄋ ᅧ ᄅ ᅥ
가지	ᄀ ᅡ ᄌ ᅵ
모양이	ᄆ ᅩ ᄋ ᅣ ᆼ ᄋ ᅵ
초기에는	ᄎ ᅩ ᄀ ᅵ ᄋ ᅦ ᄂ ᅳ ᆫ
도화원이라	ᄃ ᅩ ᄒ ᅪ ᄋ ᅯ ᄂ ᅵ ᄅ ᅡ
하였으나	ᄒ ᅡ ᄋ ᅧ ᄊ ᅳ ᄂ ᅡ
그림	ᄀ ᅳ ᄅ ᅵ ᆷ
그리는	ᄀ ᅳ ᄅ ᅵ ᄂ ᅳ ᆫ
일의	ᄋ ᅵ ᄅ ᅴ
격을	ᄀ ᅧ ᄀ ᅳ ᆯ
낮추어	ᄂ ᅡ ᆮ ᄎ ᅮ ᄋ ᅥ
도화서로	ᄃ ᅩ ᄒ ᅪ ᄉ ᅥ ᄅ ᅩ
개칭하였다	ᄀ ᅢ ᄎ ᅵ ᆼ ᄒ ᅡ ᄋ ᅧ ᆮ ᄄ ᅡ
청설모는	ᄎ ᅥ ᆼ ᄉ ᅥ ᆯ ᄆ ᅩ ᄂ ᅳ ᆫ
도시	ᄃ ᅩ ᄉ ᅵ
환경에서도	ᄒ ᅪ ᆫ ᄀ ᅧ ᆼ ᄋ ᅦ ᄉ ᅥ ᄃ ᅩ
적응했기	ᄌ ᅥ ᄀ ᅳ ᆼ ᄒ ᅢ ᆮ ᄁ ᅵ
미국이나	ᄆ ᅵ ᄀ ᅮ ᄀ ᅵ ᄂ ᅡ
캐나다의	ᄏ ᅢ ᄂ ᅡ ᄃ ᅡ ᄋ ᅴ
공원에서	ᄀ ᅩ ᆼ ᄋ ᅯ ᄂ ᅦ ᄉ ᅥ
흔히	ᄒ ᅳ ᆫ ᄒ ᅵ
있다	ᄋ ᅵ ᆮ ᄄ ᅡ
대구의	ᄃ ᅢ ᄀ ᅮ ᄋ ᅴ
랜드마크로	ᄅ ᅢ ᆫ ᄃ ᅳ ᄆ ᅡ ᄏ ᅳ ᄅ ᅩ
전국에	ᄌ ᅥ ᆫ ᄀ ᅮ ᄀ ᅦ
위치한	ᄋ ᅱ ᄎ ᅵ ᄒ ᅡ ᆫ
위브	ᄋ ᅱ ᄇ ᅳ
착공하였으며	ᄎ ᅡ ᆨ ᄁ ᅩ ᆼ ᄒ ᅡ ᄋ ᅧ ᄊ ᅳ ᄆ ᅧ
완공되었다	ᄋ ᅪ ᆫ ᄀ ᅩ ᆼ ᄃ ᅬ ᄋ ᅥ ᆮ ᄄ ᅡ
예를	ᄋ ᅨ ᄅ ᅳ ᆯ
딴	ᄄ ᅡ ᆫ
손잡이는	ᄉ ᅩ ᆫ ᄌ ᅡ ᄇ ᅵ ᄂ ᅳ ᆫ
오른손으로	ᄋ ᅩ ᄅ ᅳ ᆫ ᄉ ᅩ ᄂ ᅳ ᄅ ᅩ
글씨를	ᄀ ᅳ ᆯ ᄊ ᅵ ᄅ ᅳ ᆯ
왼손으로	ᄋ ᅬ ᆫ ᄉ ᅩ ᄂ ᅳ ᄅ ᅩ
그림을	ᄀ ᅳ ᄅ ᅵ ᄆ ᅳ ᆯ
그립니다	ᄀ ᅳ ᄅ ᅵ ᆷ ᄂ ᅵ ᄃ ᅡ
라이거는	ᄅ ᅡ ᄋ ᅵ ᄀ ᅥ ᄂ ᅳ ᆫ
호랑이의	ᄒ ᅩ ᄅ ᅡ ᆼ ᄋ ᅵ ᄋ ᅴ
특징을	ᄐ ᅳ ᆨ ᄍ ᅵ ᆼ ᄋ ᅳ ᆯ
닮아	ᄃ ᅡ ᆯ ᄆ ᅡ
헤엄을	ᄒ ᅦ ᄋ ᅥ ᄆ ᅳ ᆯ
즐기며	ᄌ ᅳ ᆯ ᄀ ᅵ ᄆ ᅧ
사자처럼	ᄉ ᅡ ᄌ ᅡ ᄎ ᅥ ᄅ ᅥ ᆷ
너울	ᄂ ᅥ ᄋ ᅮ ᆯ
가지가	ᄀ ᅡ ᄌ ᅵ ᄀ ᅡ
매우	ᄆ ᅢ ᄋ ᅮ
좋다	ᄌ ᅩ ᄐ ᅡ
루터는	ᄅ ᅮ ᄐ ᅥ ᄂ ᅳ ᆫ
이단으로	ᄋ ᅵ ᄃ ᅡ ᄂ ᅳ ᄅ ᅩ
낙인찍히면서	ᄂ ᅡ ᄀ ᅵ ᆫ ᄍ ᅵ ᄏ ᅵ ᄆ ᅧ ᆫ ᄉ ᅥ
루터	ᄅ ᅮ ᄐ ᅥ
종교개혁의	ᄌ ᅩ ᆼ ᄀ ᅭ ᄀ ᅢ ᄒ ᅧ ᄀ ᅴ
도화선이	ᄃ ᅩ ᄒ ᅪ ᄉ ᅥ ᄂ ᅵ
되었다	ᄃ ᅬ ᄋ ᅥ ᆮ ᄄ ᅡ
팝업	ᄑ ᅡ ᄇ ᅥ ᆸ
전조	ᄌ ᅥ ᆫ ᄌ ᅩ
등이	ᄃ ᅳ ᆼ ᄋ ᅵ
구비된	ᄀ ᅮ ᄇ ᅵ ᄃ ᅬ ᆫ
차량은	ᄎ ᅡ ᄅ ᅣ ᆼ ᄋ ᅳ ᆫ
일세대이며	ᄋ ᅵ ᆯ ᄉ ᅦ ᄃ ᅢ ᄋ ᅵ ᄆ ᅧ
개방형	ᄀ ᅢ ᄇ ᅡ ᆼ ᄒ ᅧ ᆼ
세대입니다	ᄉ ᅦ ᄃ ᅢ ᄋ ᅵ ᆷ ᄂ ᅵ ᄃ ᅡ
레아는	ᄅ ᅦ ᄋ ᅡ ᄂ ᅳ ᆫ
그리스	ᄀ ᅳ ᄅ ᅵ ᄉ ᅳ
신화에	ᄉ ᅵ ᆫ ᄒ ᅪ ᄋ ᅦ
나오는	ᄂ ᅡ ᄋ ᅩ ᄂ ᅳ ᆫ
거인족	ᄀ ᅥ ᄋ ᅵ ᆫ ᄌ ᅩ ᆨ
티탄인	ᄐ ᅵ ᄐ ᅡ ᄂ ᅵ ᆫ
레아에서	ᄅ ᅦ ᄋ ᅡ ᄋ ᅦ ᄉ ᅥ
유래했으며	ᄋ ᅲ ᄅ ᅢ ᄒ ᅢ ᄊ ᅳ ᄆ ᅧ
태양계의	ᄐ ᅢ ᄋ ᅣ ᆼ ᄀ ᅨ ᄋ ᅴ
위성	ᄋ ᅱ ᄉ ᅥ ᆼ
번째로	ᄇ ᅥ ᆫ ᄍ ᅢ ᄅ ᅩ
큽니다	ᄏ ᅳ ᆷ ᄂ ᅵ ᄃ ᅡ
집시는	ᄌ ᅵ ᆸ ᄊ ᅵ ᄂ ᅳ ᆫ
나치	ᄂ ᅡ ᄎ ᅵ
독일의	ᄃ ᅩ ᄀ ᅵ ᄅ ᅴ
홀로코스트와	ᄒ ᅩ ᆯ ᄅ ᅩ ᄏ ᅩ ᄉ ᅳ ᄐ ᅳ ᄋ ᅪ
강제	ᄀ ᅡ ᆼ ᄌ ᅦ
노역으로	ᄂ ᅩ ᄋ ᅧ ᄀ ᅳ ᄅ ᅩ
팔십만	ᄑ ᅡ ᆯ ᄉ ᅵ ᆷ ᄆ ᅡ ᆫ
비극의	ᄇ ᅵ ᄀ ᅳ ᄀ ᅴ
갖고	ᄀ ᅡ ᆮ ᄁ ᅩ
무덤이	ᄆ ᅮ ᄃ ᅥ ᄆ ᅵ
일기만	ᄋ ᅵ ᆯ ᄀ ᅵ ᄆ ᅡ ᆫ
있다면	ᄋ ᅵ ᆮ ᄄ ᅡ ᄆ ᅧ ᆫ
묘지와	ᄆ ᅭ ᄌ ᅵ ᄋ ᅪ
묘역은	ᄆ ᅭ ᄋ ᅧ ᄀ ᅳ ᆫ
동일한	ᄃ ᅩ ᆼ ᄋ ᅵ ᆯ ᄒ ᅡ ᆫ
영역을	ᄋ ᅧ ᆼ ᄋ ᅧ ᄀ ᅳ ᆯ
나타낸다	ᄂ ᅡ ᄐ ᅡ ᄂ ᅢ ᆫ ᄃ ᅡ
교황청의	ᄀ ᅭ ᄒ ᅪ ᆼ ᄎ ᅥ ᆼ ᄋ ᅴ
보안	ᄇ ᅩ ᄋ ᅡ ᆫ
문제를	ᄆ ᅮ ᆫ ᄌ ᅦ ᄅ ᅳ ᆯ
책임지고	ᄎ ᅢ ᄀ ᅵ ᆷ ᄌ ᅵ ᄀ ᅩ
기타	ᄀ ᅵ ᄐ ᅡ
바티칸	ᄇ ᅡ ᄐ ᅵ ᄏ ᅡ ᆫ
시국에서의	ᄉ ᅵ ᄀ ᅮ ᄀ ᅦ ᄉ ᅥ ᄋ ᅴ
일상적인	ᄋ ᅵ ᆯ ᄉ ᅡ ᆼ ᄌ ᅥ ᄀ ᅵ ᆫ
경찰	ᄀ ᅧ ᆼ ᄎ ᅡ ᆯ
임무를	ᄋ ᅵ ᆷ ᄆ ᅮ ᄅ ᅳ ᆯ
맡고	ᄆ ᅡ ᆮ ᄁ ᅩ
봄에	ᄇ ᅩ ᄆ ᅦ
종업식	ᄌ ᅩ ᆼ ᄋ ᅥ ᆸ ᄊ ᅵ ᆨ
대략	ᄃ ᅢ ᄅ ᅣ ᆨ
주일간	ᄌ ᅮ ᄋ ᅵ ᆯ ᄀ ᅡ ᆫ
학년	ᄒ ᅡ ᆼ ᄂ ᅧ ᆫ
방학을	ᄇ ᅡ ᆼ ᄒ ᅡ ᄀ ᅳ ᆯ
한다	ᄒ ᅡ ᆫ ᄃ ᅡ
브래지어는	ᄇ ᅳ ᄅ ᅢ ᄌ ᅵ ᄋ ᅥ ᄂ ᅳ ᆫ
브라라고	ᄇ ᅳ ᄅ ᅡ ᄅ ᅡ ᄀ ᅩ
일컬으며	ᄋ ᅵ ᆯ ᄏ ᅥ ᄅ ᅳ ᄆ ᅧ
유방을	ᄋ ᅲ ᄇ ᅡ ᆼ ᄋ ᅳ ᆯ
가리고	ᄀ ᅡ ᄅ ᅵ ᄀ ᅩ
지탱해	ᄌ ᅵ ᄐ ᅢ ᆼ ᄒ ᅢ
옷의	ᄋ ᅩ ᄉ ᅴ
형태이다	ᄒ ᅧ ᆼ ᄐ ᅢ ᄋ ᅵ ᄃ ᅡ
환자의	ᄒ ᅪ ᆫ ᄌ ᅡ ᄋ ᅴ
수면	ᄉ ᅮ ᄆ ᅧ ᆫ
발생하는	ᄇ ᅡ ᆯ ᄉ ᅢ ᆼ ᄒ ᅡ ᄂ ᅳ ᆫ
질환의	ᄌ ᅵ ᆯ ᄒ ᅪ ᄂ ᅴ
원인을	ᄋ ᅯ ᄂ ᅵ ᄂ ᅳ ᆯ
알아내기	ᄋ ᅡ ᄅ ᅡ ᄂ ᅢ ᄀ ᅵ
다원	ᄃ ᅡ ᄋ ᅯ ᆫ
검사를	ᄀ ᅥ ᆷ ᄉ ᅡ ᄅ ᅳ ᆯ
진행했다	ᄌ ᅵ ᆫ ᄒ ᅢ ᆼ ᄒ ᅢ ᆮ ᄄ ᅡ
상자들과	ᄉ ᅡ ᆼ ᄌ ᅡ ᄃ ᅳ ᆯ ᄀ ᅪ
조작의	ᄌ ᅩ ᄌ ᅡ ᄀ ᅴ
흐름을	ᄒ ᅳ ᄅ ᅳ ᄆ ᅳ ᆯ
나타내는	ᄂ ᅡ ᄐ ᅡ ᄂ ᅢ ᄂ ᅳ ᆫ
화살표	ᄒ ᅪ ᄉ ᅡ ᆯ ᄑ ᅭ
연결로	ᄋ ᅧ ᆫ ᄀ ᅧ ᆯ ᄅ ᅩ
프로세스	ᄑ ᅳ ᄅ ᅩ ᄉ ᅦ ᄉ ᅳ
작용을	ᄌ ᅡ ᄀ ᅭ ᆼ ᄋ ᅳ ᆯ
나타냈다	ᄂ ᅡ ᄐ ᅡ ᄂ ᅢ ᆮ ᄄ ᅡ
개인용	ᄀ ᅢ ᄋ ᅵ ᄂ ᅭ ᆼ
컴퓨터	ᄏ ᅥ ᆷ ᄑ ᅲ ᄐ ᅥ
애호가들이	ᄋ ᅢ ᄒ ᅩ ᄀ ᅡ ᄃ ᅳ ᄅ ᅵ
그들의	ᄀ ᅳ ᄃ ᅳ ᄅ ᅴ
성능을	ᄉ ᅥ ᆼ ᄂ ᅳ ᆼ ᄋ ᅳ ᆯ
높이기	ᄂ ᅩ ᄑ ᅵ ᄀ ᅵ
주로	ᄌ ᅮ ᄅ ᅩ
클럭을	ᄏ ᅳ ᆯ ᄅ ᅥ ᄀ ᅳ ᆯ
높이기도	ᄂ ᅩ ᄑ ᅵ ᄀ ᅵ ᄃ ᅩ
음악	ᄋ ᅳ ᄆ ᅡ ᆨ
치료사들은	ᄎ ᅵ ᄅ ᅭ ᄉ ᅡ ᄃ ᅳ ᄅ ᅳ ᆫ
치매	ᄎ ᅵ ᄆ ᅢ
환자나	ᄒ ᅪ ᆫ ᄌ ᅡ ᄂ ᅡ
어린아이들의	ᄋ ᅥ ᄅ ᅵ ᄂ ᅡ ᄋ ᅵ ᄃ ᅳ ᄅ ᅴ
몸과	ᄆ ᅩ ᆷ ᄀ ᅪ
치료하는	ᄎ ᅵ ᄅ ᅭ ᄒ ᅡ ᄂ ᅳ ᆫ
차	ᄎ ᅡ
세계대전	ᄉ ᅦ ᄀ ᅨ ᄃ ᅢ ᄌ ᅥ ᆫ
직후인	ᄌ ᅵ ᄏ ᅮ ᄋ ᅵ ᆫ
천구백십구년에	ᄎ ᅥ ᆫ ᄀ ᅮ ᄇ ᅢ ᆨ ᄊ ᅵ ᆸ ᄁ ᅮ ᄂ ᅧ ᄂ ᅦ
폴란드	ᄑ ᅩ ᆯ ᄅ ᅡ ᆫ ᄃ ᅳ
공화국의	ᄀ ᅩ ᆼ ᄒ ᅪ ᄀ ᅮ ᄀ ᅴ
탄생과	ᄐ ᅡ ᆫ ᄉ ᅢ ᆼ ᄀ ᅪ
동시에	ᄃ ᅩ ᆼ ᄉ ᅵ ᄋ ᅦ
초대	ᄎ ᅩ ᄃ ᅢ
수상이	ᄉ ᅮ ᄉ ᅡ ᆼ ᄋ ᅵ
호수에서	ᄒ ᅩ ᄉ ᅮ ᄋ ᅦ ᄉ ᅥ
물고기를	ᄆ ᅮ ᆯ ᄀ ᅩ ᄀ ᅵ ᄅ ᅳ ᆯ
잡거나	ᄌ ᅡ ᆸ ᄁ ᅥ ᄂ ᅡ
수경	ᄉ ᅮ ᄀ ᅧ ᆼ
재배로	ᄌ ᅢ ᄇ ᅢ ᄅ ᅩ
야채나	ᄋ ᅣ ᄎ ᅢ ᄂ ᅡ
방울토마토를	ᄇ ᅡ ᆼ ᄋ ᅮ ᆯ ᄐ ᅩ ᄆ ᅡ ᄐ ᅩ ᄅ ᅳ ᆯ
생산합니다	ᄉ ᅢ ᆼ ᄉ ᅡ ᆫ ᄒ ᅡ ᆷ ᄂ ᅵ ᄃ ᅡ
말해서	ᄆ ᅡ ᆯ ᄒ ᅢ ᄉ ᅥ
결과값이	ᄀ ᅧ ᆯ ᄀ ᅪ ᄀ ᅡ ᆸ ᄊ ᅵ
주어졌을	ᄌ ᅮ ᄋ ᅥ ᄌ ᅥ ᄊ ᅳ ᆯ
입력값을	ᄋ ᅵ ᆷ ᄂ ᅧ ᆨ ᄁ ᅡ ᆸ ᄊ ᅳ ᆯ
구하는	ᄀ ᅮ ᄒ ᅡ ᄂ ᅳ ᆫ
것이	ᄀ ᅥ ᄉ ᅵ
어려운	ᄋ ᅥ ᄅ ᅧ ᄋ ᅮ ᆫ
함수이다	ᄒ ᅡ ᆷ ᄉ ᅮ ᄋ ᅵ ᄃ ᅡ
열매가	ᄋ ᅧ ᆯ ᄆ ᅢ ᄀ ᅡ
익으면	ᄋ ᅵ ᄀ ᅳ ᄆ ᅧ ᆫ
마디	ᄆ ᅡ ᄃ ᅵ
사이의	ᄉ ᅡ ᄋ ᅵ ᄋ ᅴ
양쪽에	ᄋ ᅣ ᆼ ᄍ ᅩ ᄀ ᅦ
주름이	ᄌ ᅮ ᄅ ᅳ ᄆ ᅵ
생기며	ᄉ ᅢ ᆼ ᄀ ᅵ ᄆ ᅧ
각	ᄀ ᅡ ᆨ
마디에	ᄆ ᅡ ᄃ ᅵ ᄋ ᅦ
개의	ᄀ ᅢ ᄋ ᅴ
종자가	ᄌ ᅩ ᆼ ᄌ ᅡ ᄀ ᅡ
나온다	ᄂ ᅡ ᄋ ᅩ ᆫ ᄃ ᅡ
신축성이	ᄉ ᅵ ᆫ ᄎ ᅮ ᆨ ᄊ ᅥ ᆼ ᄋ ᅵ
강하고	ᄀ ᅡ ᆼ ᄒ ᅡ ᄀ ᅩ
긴	ᄀ ᅵ ᆫ
장대를	ᄌ ᅡ ᆼ ᄃ ᅢ ᄅ ᅳ ᆯ
쥐고	ᄌ ᅱ ᄀ ᅩ
도움닫기를	ᄃ ᅩ ᄋ ᅮ ᆷ ᄃ ᅡ ᆮ ᄁ ᅵ ᄅ ᅳ ᆯ
하여	ᄒ ᅡ ᄋ ᅧ
가로대를	ᄀ ᅡ ᄅ ᅩ ᄃ ᅢ ᄅ ᅳ ᆯ
넘는	ᄂ ᅥ ᆷ ᄂ ᅳ ᆫ
종목이	ᄌ ᅩ ᆼ ᄆ ᅩ ᄀ ᅵ
체중이	ᄎ ᅦ ᄌ ᅮ ᆼ ᄋ ᅵ
적어	ᄌ ᅥ ᄀ ᅥ
건강한	ᄀ ᅥ ᆫ ᄀ ᅡ ᆼ ᄒ ᅡ ᆫ
표준	ᄑ ᅭ ᄌ ᅮ ᆫ
체중보다	ᄎ ᅦ ᄌ ᅮ ᆼ ᄇ ᅩ ᄃ ᅡ
적은	ᄌ ᅥ ᄀ ᅳ ᆫ
상태를	ᄉ ᅡ ᆼ ᄐ ᅢ ᄅ ᅳ ᆯ
말한다	ᄆ ᅡ ᆯ ᄒ ᅡ ᆫ ᄃ ᅡ
보통은	ᄇ ᅩ ᄐ ᅩ ᆼ ᄋ ᅳ ᆫ
법원이나	ᄇ ᅥ ᄇ ᅯ ᄂ ᅵ ᄂ ᅡ
정부	ᄌ ᅥ ᆼ ᄇ ᅮ
기관에서	ᄀ ᅵ ᄀ ᅪ ᄂ ᅦ ᄉ ᅥ
정지	ᄌ ᅥ ᆼ ᄌ ᅵ
명령을	ᄆ ᅧ ᆼ ᄂ ᅧ ᆼ ᄋ ᅳ ᆯ
내릴	ᄂ ᅢ ᄅ ᅵ ᆯ
특수한	ᄐ ᅳ ᆨ ᄊ ᅮ ᄒ ᅡ ᆫ
개인도	ᄀ ᅢ ᄋ ᅵ ᆫ ᄃ ᅩ
생후	ᄉ ᅢ ᆼ ᄒ ᅮ
오일	ᄋ ᅩ ᄋ ᅵ ᆯ
만에	ᄆ ᅡ ᄂ ᅦ
사망하여	ᄉ ᅡ ᄆ ᅡ ᆼ ᄒ ᅡ ᄋ ᅧ
생전에	ᄉ ᅢ ᆼ ᄌ ᅥ ᄂ ᅦ
친왕	ᄎ ᅵ ᄂ ᅪ ᆼ
등의	ᄃ ᅳ ᆼ ᄋ ᅴ
작위를	ᄌ ᅡ ᄀ ᅱ ᄅ ᅳ ᆯ
봉작	ᄇ ᅩ ᆼ ᄌ ᅡ ᆨ
받지	ᄇ ᅡ ᆮ ᄍ ᅵ
못했다	ᄆ ᅩ ᄐ ᅢ ᆮ ᄄ ᅡ
중성미자의	ᄌ ᅮ ᆼ ᄉ ᅥ ᆼ ᄆ ᅵ ᄌ ᅡ ᄋ ᅴ
맛깔이	ᄆ ᅡ ᆮ ᄁ ᅡ ᄅ ᅵ
흐름에	ᄒ ᅳ ᄅ ᅳ ᄆ ᅦ
변하는	ᄇ ᅧ ᆫ ᄒ ᅡ ᄂ ᅳ ᆫ
양자	ᄋ ᅣ ᆼ ᄌ ᅡ
역학	ᄋ ᅧ ᄏ ᅡ ᆨ
현상이	ᄒ ᅧ ᆫ ᄉ ᅡ ᆼ ᄋ ᅵ
모습은	ᄆ ᅩ ᄉ ᅳ ᄇ ᅳ ᆫ
일반	ᄋ ᅵ ᆯ ᄇ ᅡ ᆫ
용과	ᄋ ᅭ ᆼ ᄀ ᅪ
다를	ᄃ ᅡ ᄅ ᅳ ᆯ
하나도	ᄒ ᅡ ᄂ ᅡ ᄃ ᅩ
없지만	ᄋ ᅥ ᆸ ᄍ ᅵ ᄆ ᅡ ᆫ
이름	ᄋ ᅵ ᄅ ᅳ ᆷ
그대로	ᄀ ᅳ ᄃ ᅢ ᄅ ᅩ
푸른색을	ᄑ ᅮ ᄅ ᅳ ᆫ ᄉ ᅢ ᄀ ᅳ ᆯ
띠고	ᄄ ᅵ ᄀ ᅩ
과정이	ᄀ ᅪ ᄌ ᅥ ᆼ ᄋ ᅵ
심화되면	ᄉ ᅵ ᆷ ᄒ ᅪ ᄃ ᅬ ᄆ ᅧ ᆫ
소행성이	ᄉ ᅩ ᄒ ᅢ ᆼ ᄉ ᅥ ᆼ ᄋ ᅵ
되며	ᄃ ᅬ ᄆ ᅧ
진화를	ᄌ ᅵ ᆫ ᄒ ᅪ ᄅ ᅳ ᆯ
겪으면	ᄀ ᅧ ᄁ ᅳ ᄆ ᅧ ᆫ
행성으로	ᄒ ᅢ ᆼ ᄉ ᅥ ᆼ ᄋ ᅳ ᄅ ᅩ
자라나게	ᄌ ᅡ ᄅ ᅡ ᄂ ᅡ ᄀ ᅦ
된다	ᄃ ᅬ ᆫ ᄃ ᅡ
판의	ᄑ ᅡ ᄂ ᅴ
경계에서는	ᄀ ᅧ ᆼ ᄀ ᅨ ᄋ ᅦ ᄉ ᅥ ᄂ ᅳ ᆫ
지진과	ᄌ ᅵ ᄌ ᅵ ᆫ ᄀ ᅪ
화산활동이	ᄒ ᅪ ᄉ ᅡ ᆫ ᄒ ᅪ ᆯ ᄃ ᅩ ᆼ ᄋ ᅵ
잦으며	ᄌ ᅡ ᄌ ᅳ ᄆ ᅧ
대부분의	ᄃ ᅢ ᄇ ᅮ ᄇ ᅮ ᄂ ᅴ
화산은	ᄒ ᅪ ᄉ ᅡ ᄂ ᅳ ᆫ
경계에	ᄀ ᅧ ᆼ ᄀ ᅨ ᄋ ᅦ
항공기	ᄒ ᅡ ᆼ ᄀ ᅩ ᆼ ᄀ ᅵ
날개에	ᄂ ᅡ ᆯ ᄀ ᅢ ᄋ ᅦ
걸리는	ᄀ ᅥ ᆯ ᄅ ᅵ ᄂ ᅳ ᆫ
하중의	ᄒ ᅡ ᄌ ᅮ ᆼ ᄋ ᅴ
크기를	ᄏ ᅳ ᄀ ᅵ ᄅ ᅳ ᆯ
기본하중으로	ᄀ ᅵ ᄇ ᅩ ᆫ ᄒ ᅡ ᄌ ᅮ ᆼ ᄋ ᅳ ᄅ ᅩ
나눈다	ᄂ ᅡ ᄂ ᅮ ᆫ ᄃ ᅡ
오른쪽	ᄋ ᅩ ᄅ ᅳ ᆫ ᄍ ᅩ ᆨ
눈은	ᄂ ᅮ ᄂ ᅳ ᆫ
라의	ᄅ ᅡ ᄋ ᅴ
눈으로	ᄂ ᅮ ᄂ ᅳ ᄅ ᅩ
태양을	ᄐ ᅢ ᄋ ᅣ ᆼ ᄋ ᅳ ᆯ
상징하고	ᄉ ᅡ ᆼ ᄌ ᅵ ᆼ ᄒ ᅡ ᄀ ᅩ
왼쪽	ᄋ ᅬ ᆫ ᄍ ᅩ ᆨ
토트의	ᄐ ᅩ ᄐ ᅳ ᄋ ᅴ
달을	ᄃ ᅡ ᄅ ᅳ ᆯ
상징한다	ᄉ ᅡ ᆼ ᄌ ᅵ ᆼ ᄒ ᅡ ᆫ ᄃ ᅡ
암컷은	ᄋ ᅡ ᆷ ᄏ ᅥ ᄉ ᅳ ᆫ
눈썹	ᄂ ᅮ ᆫ ᄊ ᅥ ᆸ
선도	ᄉ ᅥ ᆫ ᄃ ᅩ
배는	ᄇ ᅢ ᄂ ᅳ ᆫ
대체로	ᄃ ᅢ ᄎ ᅦ ᄅ ᅩ
흰색을	ᄒ ᅵ ᆫ ᄉ ᅢ ᄀ ᅳ ᆯ
띠며	ᄄ ᅵ ᄆ ᅧ
위는	ᄋ ᅱ ᄂ ᅳ ᆫ
갈색을	ᄀ ᅡ ᆯ ᄉ ᅢ ᄀ ᅳ ᆯ
띤다	ᄄ ᅵ ᆫ ᄃ ᅡ
특히	ᄐ ᅳ ᄏ ᅵ
빛의	ᄇ ᅵ ᄎ ᅴ
수면에	ᄉ ᅮ ᄆ ᅧ ᄂ ᅦ
빼놓을	ᄈ ᅢ ᄂ ᅩ ᄋ ᅳ ᆯ
중요한	ᄌ ᅮ ᆼ ᄋ ᅭ ᄒ ᅡ ᆫ
역할을	ᄋ ᅧ ᄏ ᅡ ᄅ ᅳ ᆯ
오징어나	ᄋ ᅩ ᄌ ᅵ ᆼ ᄋ ᅥ ᄂ ᅡ
노가리를	ᄂ ᅩ ᄀ ᅡ ᄅ ᅵ ᄅ ᅳ ᆯ
불에	ᄇ ᅮ ᄅ ᅦ
구워서	ᄀ ᅮ ᄋ ᅯ ᄉ ᅥ
고추장이나	ᄀ ᅩ ᄎ ᅮ ᄌ ᅡ ᆼ ᄋ ᅵ ᄂ ᅡ
마요네즈에	ᄆ ᅡ ᄋ ᅭ ᄂ ᅦ ᄌ ᅳ ᄋ ᅦ
찍어	ᄍ ᅵ ᄀ ᅥ
먹는다	ᄆ ᅥ ᆼ ᄂ ᅳ ᆫ ᄃ ᅡ
담근	ᄃ ᅡ ᆷ ᄀ ᅳ ᆫ
된	ᄃ ᅬ ᆫ
사용하면	ᄉ ᅡ ᄋ ᅭ ᆼ ᄒ ᅡ ᄆ ᅧ ᆫ
특유의	ᄐ ᅳ ᄀ ᅲ ᄋ ᅴ
않기	ᄋ ᅡ ᆫ ᄏ ᅵ
때문입니다	ᄄ ᅢ ᄆ ᅮ ᄂ ᅵ ᆷ ᄂ ᅵ ᄃ ᅡ
질량에	ᄌ ᅵ ᆯ ᄅ ᅣ ᆼ ᄋ ᅦ
근거하여	ᄀ ᅳ ᆫ ᄀ ᅥ ᄒ ᅡ ᄋ ᅧ
행성은	ᄒ ᅢ ᆼ ᄉ ᅥ ᆼ ᄋ ᅳ ᆫ
딱딱한	ᄄ ᅡ ᆨ ᄄ ᅡ ᄏ ᅡ ᆫ
표면이	ᄑ ᅭ ᄆ ᅧ ᄂ ᅵ
가스	ᄀ ᅡ ᄉ ᅳ
행성일	ᄒ ᅢ ᆼ ᄉ ᅥ ᆼ ᄋ ᅵ ᆯ
것으로	ᄀ ᅥ ᄉ ᅳ ᄅ ᅩ
추측되고	ᄎ ᅮ ᄎ ᅳ ᆨ ᄄ ᅬ ᄀ ᅩ
앨범은	ᄋ ᅢ ᆯ ᄇ ᅥ ᄆ ᅳ ᆫ
대중적이라기보다는	ᄃ ᅢ ᄌ ᅮ ᆼ ᄌ ᅥ ᄀ ᅵ ᄅ ᅡ ᄀ ᅵ ᄇ ᅩ ᄃ ᅡ ᄂ ᅳ ᆫ
예술적인	ᄋ ᅨ ᄉ ᅮ ᆯ ᄌ ᅥ ᄀ ᅵ ᆫ
측면이	ᄎ ᅳ ᆼ ᄆ ᅧ ᄂ ᅵ
강함을	ᄀ ᅡ ᆼ ᄒ ᅡ ᄆ ᅳ ᆯ
느낄	ᄂ ᅳ ᄁ ᅵ ᆯ
풍뎅이와	ᄑ ᅮ ᆼ ᄃ ᅦ ᆼ ᄋ ᅵ ᄋ ᅪ
달리	ᄃ ᅡ ᆯ ᄅ ᅵ
앞날개를	ᄋ ᅡ ᆷ ᄂ ᅡ ᆯ ᄀ ᅢ ᄅ ᅳ ᆯ
살짝	ᄉ ᅡ ᆯ ᄍ ᅡ ᆨ
뒤	ᄃ ᅱ
뒷날개만	ᄃ ᅱ ᆫ ᄂ ᅡ ᆯ ᄀ ᅢ ᄆ ᅡ ᆫ
완전히	ᄋ ᅪ ᆫ ᄌ ᅥ ᆫ ᄒ ᅵ
펴서	ᄑ ᅧ ᄉ ᅥ
비행한다	ᄇ ᅵ ᄒ ᅢ ᆼ ᄒ ᅡ ᆫ ᄃ ᅡ
지방마다	ᄌ ᅵ ᄇ ᅡ ᆼ ᄆ ᅡ ᄃ ᅡ
상황에	ᄉ ᅡ ᆼ ᄒ ᅪ ᆼ ᄋ ᅦ
요리의	ᄋ ᅭ ᄅ ᅵ ᄋ ᅴ
특성이	ᄐ ᅳ ᆨ ᄊ ᅥ ᆼ ᄋ ᅵ
두드러지게	ᄃ ᅮ ᄃ ᅳ ᄅ ᅥ ᄌ ᅵ ᄀ ᅦ
나타난다	ᄂ ᅡ ᄐ ᅡ ᄂ ᅡ ᆫ ᄃ ᅡ
보이는	ᄇ ᅩ ᄋ ᅵ ᄂ ᅳ ᆫ
손님들이	ᄉ ᅩ ᆫ ᄂ ᅵ ᆷ ᄃ ᅳ ᄅ ᅵ
도착할	ᄃ ᅩ ᄎ ᅡ ᄏ ᅡ ᆯ
맞이하며	ᄆ ᅡ ᄌ ᅵ ᄒ ᅡ ᄆ ᅧ
문이나	ᄆ ᅮ ᄂ ᅵ ᄂ ᅡ
열어	ᄋ ᅧ ᄅ ᅥ
준다	ᄌ ᅮ ᆫ ᄃ ᅡ
세계적으로	ᄉ ᅦ ᄀ ᅨ ᄌ ᅥ ᄀ ᅳ ᄅ ᅩ
대중적인	ᄃ ᅢ ᄌ ᅮ ᆼ ᄌ ᅥ ᄀ ᅵ ᆫ
인기를	ᄋ ᅵ ᆫ ᄀ ᅵ ᄅ ᅳ ᆯ
얻게	ᄋ ᅥ ᆮ ᄁ ᅦ
계기는	ᄀ ᅨ ᄀ ᅵ ᄂ ᅳ ᆫ
칠십년대	ᄎ ᅵ ᆯ ᄉ ᅵ ᆷ ᄂ ᅧ ᆫ ᄃ ᅢ
후반	ᄒ ᅮ ᄇ ᅡ ᆫ
뉴욕의	ᄂ ᅲ ᄋ ᅭ ᄀ ᅴ
디스코	ᄃ ᅵ ᄉ ᅳ ᄏ ᅩ
열풍이	ᄋ ᅧ ᆯ ᄑ ᅮ ᆼ ᄋ ᅵ
불면서였다	ᄇ ᅮ ᆯ ᄆ ᅧ ᆫ ᄉ ᅥ ᄋ ᅧ ᆮ ᄄ ᅡ
승패가	ᄉ ᅳ ᆼ ᄑ ᅢ ᄀ ᅡ
결정되면	ᄀ ᅧ ᆯ ᄌ ᅥ ᆼ ᄃ ᅬ ᄆ ᅧ ᆫ
결과에	ᄀ ᅧ ᆯ ᄀ ᅪ ᄋ ᅦ
상관없이	ᄉ ᅡ ᆼ ᄀ ᅪ ᄂ ᅥ ᆸ ᄊ ᅵ
인정을	ᄋ ᅵ ᆫ ᄌ ᅥ ᆼ ᄋ ᅳ ᆯ
베풀어	ᄇ ᅦ ᄑ ᅮ ᄅ ᅥ
화합하며	ᄒ ᅪ ᄒ ᅡ ᄑ ᅡ ᄆ ᅧ
즐겼다	ᄌ ᅳ ᆯ ᄀ ᅧ ᆮ ᄄ ᅡ
올림픽	ᄋ ᅩ ᆯ ᄅ ᅵ ᆷ ᄑ ᅵ ᆨ
대회에서	ᄃ ᅢ ᄒ ᅬ ᄋ ᅦ ᄉ ᅥ
금메달	ᄀ ᅳ ᆷ ᄆ ᅦ ᄃ ᅡ ᆯ
세	ᄉ ᅦ
개를	ᄀ ᅢ ᄅ ᅳ ᆯ
유일한	ᄋ ᅲ ᄋ ᅵ ᆯ ᄒ ᅡ ᆫ
스키점프	ᄉ ᅳ ᄏ ᅵ ᄌ ᅥ ᆷ ᄑ ᅳ
선수이다	ᄉ ᅥ ᆫ ᄉ ᅮ ᄋ ᅵ ᄃ ᅡ
효과로	ᄒ ᅭ ᄀ ᅪ ᄅ ᅩ
천문학	ᄎ ᅥ ᆫ ᄆ ᅮ ᆫ ᄒ ᅡ ᆨ
역사상	ᄋ ᅧ ᆨ ᄊ ᅡ ᄉ ᅡ ᆼ
많은	ᄆ ᅡ ᄂ ᅳ ᆫ
발견들이	ᄇ ᅡ ᆯ ᄀ ᅧ ᆫ ᄃ ᅳ ᄅ ᅵ
사실	ᄉ ᅡ ᄉ ᅵ ᆯ
잘못된	ᄌ ᅡ ᆯ ᄆ ᅩ ᆮ ᄄ ᅬ ᆫ
것이었음이	ᄀ ᅥ ᄉ ᅵ ᄋ ᅥ ᄊ ᅳ ᄆ ᅵ
밝혀졌다	ᄇ ᅡ ᆯ ᄏ ᅧ ᄌ ᅥ ᆮ ᄄ ᅡ
모낭	ᄆ ᅩ ᄂ ᅡ ᆼ
내에	ᄂ ᅢ ᄋ ᅦ
각질이	ᄀ ᅡ ᆨ ᄍ ᅵ ᄅ ᅵ
채워져	ᄎ ᅢ ᄋ ᅯ ᄌ ᅥ
있기	ᄋ ᅵ ᆮ ᄁ ᅵ
털은	ᄐ ᅥ ᄅ ᅳ ᆫ
각질	ᄀ ᅡ ᆨ ᄍ ᅵ ᆯ
박혀	ᄇ ᅡ ᄏ ᅧ
기름이	ᄀ ᅵ ᄅ ᅳ ᄆ ᅵ
적으면	ᄌ ᅥ ᄀ ᅳ ᄆ ᅧ ᆫ
재료가	ᄌ ᅢ ᄅ ᅭ ᄀ ᅡ
타기	ᄐ ᅡ ᄀ ᅵ
쉽고	ᄉ ᅱ ᆸ ᄁ ᅩ
많으면	ᄆ ᅡ ᄂ ᅳ ᄆ ᅧ ᆫ
음식이	ᄋ ᅳ ᆷ ᄉ ᅵ ᄀ ᅵ
깔끔하지	ᄁ ᅡ ᆯ ᄁ ᅳ ᆷ ᄒ ᅡ ᄌ ᅵ
주의해야	ᄌ ᅮ ᄋ ᅴ ᄒ ᅢ ᄋ ᅣ
물체를	ᄆ ᅮ ᆯ ᄎ ᅦ ᄅ ᅳ ᆯ
액체	ᄋ ᅢ ᆨ ᄎ ᅦ
넣으면	ᄂ ᅥ ᄋ ᅳ ᄆ ᅧ ᆫ
중력	ᄌ ᅮ ᆼ ᄂ ᅧ ᆨ
위로	ᄋ ᅱ ᄅ ᅩ
밀어	ᄆ ᅵ ᄅ ᅥ
올려	ᄋ ᅩ ᆯ ᄅ ᅧ
떠오르게	ᄄ ᅥ ᄋ ᅩ ᄅ ᅳ ᄀ ᅦ
평탄한	ᄑ ᅧ ᆼ ᄐ ᅡ ᆫ ᄒ ᅡ ᆫ
지형	ᄌ ᅵ ᄒ ᅧ ᆼ
갑문이	ᄀ ᅡ ᆷ ᄆ ᅮ ᄂ ᅵ
없으며	ᄋ ᅥ ᆸ ᄊ ᅳ ᄆ ᅧ
운하	ᄋ ᅮ ᆫ ᄒ ᅡ
끝의	ᄁ ᅳ ᄉ ᅴ
바닷물이	ᄇ ᅡ ᄃ ᅡ ᆫ ᄆ ᅮ ᄅ ᅵ
자유로이	ᄌ ᅡ ᄋ ᅲ ᄅ ᅩ ᄋ ᅵ
흘러들어	ᄒ ᅳ ᆯ ᄅ ᅥ ᄃ ᅳ ᄅ ᅥ
온다	ᄋ ᅩ ᆫ ᄃ ᅡ
밥솥	ᄇ ᅡ ᆸ ᄊ ᅩ ᆮ
바닥에	ᄇ ᅡ ᄃ ᅡ ᄀ ᅦ
눌어붙은	ᄂ ᅮ ᄅ ᅥ ᄇ ᅮ ᄐ ᅳ ᆫ
누룽지에	ᄂ ᅮ ᄅ ᅮ ᆼ ᄌ ᅵ ᄋ ᅦ
붓고	ᄇ ᅮ ᆮ ᄁ ᅩ
한소끔	ᄒ ᅡ ᆫ ᄉ ᅩ ᄁ ᅳ ᆷ
끓여	ᄁ ᅳ ᄅ ᅧ
내놓았다	ᄂ ᅢ ᄂ ᅩ ᄋ ᅡ ᆮ ᄄ ᅡ
액체와	ᄋ ᅢ ᆨ ᄎ ᅦ ᄋ ᅪ
고체가	ᄀ ᅩ ᄎ ᅦ ᄀ ᅡ
물질을	ᄆ ᅮ ᆯ ᄍ ᅵ ᄅ ᅳ ᆯ
입자의	ᄋ ᅵ ᆸ ᄍ ᅡ ᄋ ᅴ
크기	ᄏ ᅳ ᄀ ᅵ
차이를	ᄎ ᅡ ᄋ ᅵ ᄅ ᅳ ᆯ
이용해	ᄋ ᅵ ᄋ ᅭ ᆼ ᄒ ᅢ
분리한다	ᄇ ᅮ ᆯ ᄅ ᅵ ᄒ ᅡ ᆫ ᄃ ᅡ
피사체에	ᄑ ᅵ ᄉ ᅡ ᄎ ᅦ ᄋ ᅦ
초점을	ᄎ ᅩ ᄌ ᅥ ᄆ ᅳ ᆯ
자동으로	ᄌ ᅡ ᄃ ᅩ ᆼ ᄋ ᅳ ᄅ ᅩ
맞추는	ᄆ ᅡ ᆮ ᄎ ᅮ ᄂ ᅳ ᆫ
광학	ᄀ ᅪ ᆼ ᄒ ᅡ ᆨ
시스템의	ᄉ ᅵ ᄉ ᅳ ᄐ ᅦ ᄆ ᅴ
기능도	ᄀ ᅵ ᄂ ᅳ ᆼ ᄃ ᅩ
타인이	ᄐ ᅡ ᄋ ᅵ ᄂ ᅵ
잃어버린	ᄋ ᅵ ᄅ ᅥ ᄇ ᅥ ᄅ ᅵ ᆫ
돈을	ᄃ ᅩ ᄂ ᅳ ᆯ
주워서	ᄌ ᅮ ᄋ ᅯ ᄉ ᅥ
임의로	ᄋ ᅵ ᄆ ᅴ ᄅ ᅩ
처분했다면	ᄎ ᅥ ᄇ ᅮ ᆫ ᄒ ᅢ ᆮ ᄄ ᅡ ᄆ ᅧ ᆫ
범죄가	ᄇ ᅥ ᆷ ᄌ ᅬ ᄀ ᅡ
천구백사십사년	ᄎ ᅥ ᆫ ᄀ ᅮ ᄇ ᅢ ᆨ ᄊ ᅡ ᄉ ᅵ ᆸ ᄊ ᅡ ᄂ ᅧ ᆫ
여름까지	ᄋ ᅧ ᄅ ᅳ ᆷ ᄁ ᅡ ᄌ ᅵ
영국에서	ᄋ ᅧ ᆼ ᄀ ᅮ ᄀ ᅦ ᄉ ᅥ
받았으며	ᄇ ᅡ ᄃ ᅡ ᄊ ᅳ ᄆ ᅧ
병력은	ᄇ ᅧ ᆼ ᄂ ᅧ ᄀ ᅳ ᆫ
약	ᄋ ᅣ ᆨ
사천	ᄉ ᅡ ᄎ ᅥ ᆫ
명까지	ᄆ ᅧ ᆼ ᄁ ᅡ ᄌ ᅵ
늘어났다	ᄂ ᅳ ᄅ ᅥ ᄂ ᅡ ᆮ ᄄ ᅡ
메기는	ᄆ ᅦ ᄀ ᅵ ᄂ ᅳ ᆫ
움직이지	ᄋ ᅮ ᆷ ᄌ ᅵ ᄀ ᅵ ᄌ ᅵ
생활하는	ᄉ ᅢ ᆼ ᄒ ᅪ ᆯ ᄒ ᅡ ᄂ ᅳ ᆫ
흔치	ᄒ ᅳ ᆫ ᄎ ᅵ
어류입니다	ᄋ ᅥ ᄅ ᅲ ᄋ ᅵ ᆷ ᄂ ᅵ ᄃ ᅡ
그곳의	ᄀ ᅳ ᄀ ᅩ ᄉ ᅴ
아이들은	ᄋ ᅡ ᄋ ᅵ ᄃ ᅳ ᄅ ᅳ ᆫ
비석	ᄇ ᅵ ᄉ ᅥ ᆨ
돌을	ᄃ ᅩ ᄅ ᅳ ᆯ
세워	ᄉ ᅦ ᄋ ᅯ
놓고	ᄂ ᅩ ᄏ ᅩ
맞혀	ᄆ ᅡ ᄎ ᅧ
쓰러뜨리면서	ᄊ ᅳ ᄅ ᅥ ᄄ ᅳ ᄅ ᅵ ᄆ ᅧ ᆫ ᄉ ᅥ
놀고	ᄂ ᅩ ᆯ ᄀ ᅩ
있었다	ᄋ ᅵ ᄊ ᅥ ᆮ ᄄ ᅡ
마그마	ᄆ ᅡ ᄀ ᅳ ᄆ ᅡ
물질이	ᄆ ᅮ ᆯ ᄍ ᅵ ᄅ ᅵ
행성	ᄒ ᅢ ᆼ ᄉ ᅥ ᆼ
표면을	ᄑ ᅭ ᄆ ᅧ ᄂ ᅳ ᆯ
뚫고	ᄄ ᅮ ᆯ ᄏ ᅩ
분출하여	ᄇ ᅮ ᆫ ᄎ ᅮ ᆯ ᄒ ᅡ ᄋ ᅧ
꿀이나	ᄁ ᅮ ᄅ ᅵ ᄂ ᅡ
설탕에	ᄉ ᅥ ᆯ ᄐ ᅡ ᆼ ᄋ ᅦ
재운	ᄌ ᅢ ᄋ ᅮ ᆫ
오미자	ᄋ ᅩ ᄆ ᅵ ᄌ ᅡ
청과	ᄎ ᅥ ᆼ ᄀ ᅪ
과일	ᄀ ᅪ ᄋ ᅵ ᆯ
꽃잎이나	ᄁ ᅩ ᆫ ᄂ ᅵ ᄇ ᅵ ᄂ ᅡ
실백을	ᄉ ᅵ ᆯ ᄇ ᅢ ᄀ ᅳ ᆯ
띄워	ᄄ ᅵ ᄋ ᅯ
곁들여	ᄀ ᅧ ᆮ ᄄ ᅳ ᄅ ᅧ
마시는	ᄆ ᅡ ᄉ ᅵ ᄂ ᅳ ᆫ
추천합니다	ᄎ ᅮ ᄎ ᅥ ᆫ ᄒ ᅡ ᆷ ᄂ ᅵ ᄃ ᅡ
스트레스를	ᄉ ᅳ ᄐ ᅳ ᄅ ᅦ ᄉ ᅳ ᄅ ᅳ ᆯ
그때그때	ᄀ ᅳ ᄄ ᅢ ᄀ ᅳ ᄄ ᅢ
불쾌감	ᄇ ᅮ ᆯ ᄏ ᅫ ᄀ ᅡ ᆷ
짜증이	ᄍ ᅡ ᄌ ᅳ ᆼ ᄋ ᅵ
생기면서	ᄉ ᅢ ᆼ ᄀ ᅵ ᄆ ᅧ ᆫ ᄉ ᅥ
긍정적인	ᄀ ᅳ ᆼ ᄌ ᅥ ᆼ ᄌ ᅥ ᄀ ᅵ ᆫ
하기	ᄒ ᅡ ᄀ ᅵ
어려워진다	ᄋ ᅥ ᄅ ᅧ ᄋ ᅯ ᄌ ᅵ ᆫ ᄃ ᅡ
화폐가	ᄒ ᅪ ᄑ ᅨ ᄀ ᅡ
각자	ᄀ ᅡ ᆨ ᄍ ᅡ
가지고	ᄀ ᅡ ᄌ ᅵ ᄀ ᅩ
서로	ᄉ ᅥ ᄅ ᅩ
교환하여	ᄀ ᅭ ᄒ ᅪ ᆫ ᄒ ᅡ ᄋ ᅧ
거래하였다	ᄀ ᅥ ᄅ ᅢ ᄒ ᅡ ᄋ ᅧ ᆮ ᄄ ᅡ
야생화는	ᄋ ᅣ ᄉ ᅢ ᆼ ᄒ ᅪ ᄂ ᅳ ᆫ
호주가	ᄒ ᅩ ᄌ ᅮ ᄀ ᅡ
원산이며	ᄋ ᅯ ᆫ ᄉ ᅡ ᄂ ᅵ ᄆ ᅧ
특이한	ᄐ ᅳ ᄀ ᅵ ᄒ ᅡ ᆫ
꽃과	ᄁ ᅩ ᆮ ᄁ ᅪ
열매	ᄋ ᅧ ᆯ ᄆ ᅢ
원예	ᄋ ᅯ ᄂ ᅨ
식물로	ᄉ ᅵ ᆼ ᄆ ᅮ ᆯ ᄅ ᅩ
인기가	ᄋ ᅵ ᆫ ᄀ ᅵ ᄀ ᅡ
많습니다	ᄆ ᅡ ᆫ ᄊ ᅳ ᆷ ᄂ ᅵ ᄃ ᅡ
물이	ᄆ ᅮ ᄅ ᅵ
서식하며	ᄉ ᅥ ᄉ ᅵ ᄏ ᅡ ᄆ ᅧ
밤에는	ᄇ ᅡ ᄆ ᅦ ᄂ ᅳ ᆫ
물고기나	ᄆ ᅮ ᆯ ᄀ ᅩ ᄀ ᅵ ᄂ ᅡ
수생곤충	ᄉ ᅮ ᄉ ᅢ ᆼ ᄀ ᅩ ᆫ ᄎ ᅮ ᆼ
등을	ᄃ ᅳ ᆼ ᄋ ᅳ ᆯ
잡아먹습니다	ᄌ ᅡ ᄇ ᅡ ᄆ ᅥ ᆨ ᄊ ᅳ ᆷ ᄂ ᅵ ᄃ ᅡ
무거운	ᄆ ᅮ ᄀ ᅥ ᄋ ᅮ ᆫ
화물을	ᄒ ᅪ ᄆ ᅮ ᄅ ᅳ ᆯ
궤도로	ᄀ ᅰ ᄃ ᅩ ᄅ ᅩ
올리는	ᄋ ᅩ ᆯ ᄅ ᅵ ᄂ ᅳ ᆫ
것은	ᄀ ᅥ ᄉ ᅳ ᆫ
어렵고	ᄋ ᅥ ᄅ ᅧ ᆸ ᄁ ᅩ
비용이	ᄇ ᅵ ᄋ ᅭ ᆼ ᄋ ᅵ
듭니다	ᄃ ᅳ ᆷ ᄂ ᅵ ᄃ ᅡ
선발	ᄉ ᅥ ᆫ ᄇ ᅡ ᆯ
투수가	ᄐ ᅮ ᄉ ᅮ ᄀ ᅡ
승리투수가	ᄉ ᅳ ᆼ ᄂ ᅵ ᄐ ᅮ ᄉ ᅮ ᄀ ᅡ
되는	ᄃ ᅬ ᄂ ᅳ ᆫ
요건은	ᄋ ᅭ ᄀ ᅥ ᄂ ᅳ ᆫ
오이닝	ᄋ ᅩ ᄋ ᅵ ᄂ ᅵ ᆼ
이상	ᄋ ᅵ ᄉ ᅡ ᆼ
투구해야	ᄐ ᅮ ᄀ ᅮ ᄒ ᅢ ᄋ ᅣ
구매자가	ᄀ ᅮ ᄆ ᅢ ᄌ ᅡ ᄀ ᅡ
장물임을	ᄌ ᅡ ᆼ ᄆ ᅮ ᄅ ᅵ ᄆ ᅳ ᆯ
샀을	ᄉ ᅡ ᄊ ᅳ ᆯ
경우에는	ᄀ ᅧ ᆼ ᄋ ᅮ ᄋ ᅦ ᄂ ᅳ ᆫ
적용되며	ᄌ ᅥ ᄀ ᅭ ᆼ ᄃ ᅬ ᄆ ᅧ
물건은	ᄆ ᅮ ᆯ ᄀ ᅥ ᄂ ᅳ ᆫ
원소유자에게	ᄋ ᅯ ᆫ ᄉ ᅩ ᄋ ᅲ ᄌ ᅡ ᄋ ᅦ ᄀ ᅦ
귀속된다	ᄀ ᅱ ᄉ ᅩ ᆨ ᄄ ᅬ ᆫ ᄃ ᅡ
관이	ᄀ ᅪ ᄂ ᅵ
달려	ᄃ ᅡ ᆯ ᄅ ᅧ
있고	ᄋ ᅵ ᆮ ᄁ ᅩ
바람을	ᄇ ᅡ ᄅ ᅡ ᄆ ᅳ ᆯ
넣을	ᄂ ᅥ ᄋ ᅳ ᆯ
있도록	ᄋ ᅵ ᆮ ᄄ ᅩ ᄅ ᅩ ᆨ
풀무가	ᄑ ᅮ ᆯ ᄆ ᅮ ᄀ ᅡ
정보를	ᄌ ᅥ ᆼ ᄇ ᅩ ᄅ ᅳ ᆯ
주지	ᄌ ᅮ ᄌ ᅵ
않으려는	ᄋ ᅡ ᄂ ᅳ ᄅ ᅧ ᄂ ᅳ ᆫ
러시아와	ᄅ ᅥ ᄉ ᅵ ᄋ ᅡ ᄋ ᅪ
입수하려는	ᄋ ᅵ ᆸ ᄊ ᅮ ᄒ ᅡ ᄅ ᅧ ᄂ ᅳ ᆫ
한국의	ᄒ ᅡ ᆫ ᄀ ᅮ ᄀ ᅴ
치열한	ᄎ ᅵ ᄋ ᅧ ᆯ ᄒ ᅡ ᆫ
기	ᄀ ᅵ
싸움이	ᄊ ᅡ ᄋ ᅮ ᄆ ᅵ
벌어졌다	ᄇ ᅥ ᄅ ᅥ ᄌ ᅥ ᆮ ᄄ ᅡ
일반적으로	ᄋ ᅵ ᆯ ᄇ ᅡ ᆫ ᄌ ᅥ ᄀ ᅳ ᄅ ᅩ
색온도가	ᄉ ᅢ ᄀ ᅩ ᆫ ᄃ ᅩ ᄀ ᅡ
높을수록	ᄂ ᅩ ᄑ ᅳ ᆯ ᄊ ᅮ ᄅ ᅩ ᆨ
집중력이	ᄌ ᅵ ᆸ ᄍ ᅮ ᆼ ᄂ ᅧ ᄀ ᅵ
상승하며	ᄉ ᅡ ᆼ ᄉ ᅳ ᆼ ᄒ ᅡ ᄆ ᅧ
낮을수록	ᄂ ᅡ ᄌ ᅳ ᆯ ᄊ ᅮ ᄅ ᅩ ᆨ
피로도가	ᄑ ᅵ ᄅ ᅩ ᄃ ᅩ ᄀ ᅡ
감소한다	ᄀ ᅡ ᆷ ᄉ ᅩ ᄒ ᅡ ᆫ ᄃ ᅡ
두꺼운	ᄃ ᅮ ᄁ ᅥ ᄋ ᅮ ᆫ
유리로	ᄋ ᅲ ᄅ ᅵ ᄅ ᅩ
세균을	ᄉ ᅦ ᄀ ᅲ ᄂ ᅳ ᆯ
배양하여	ᄇ ᅢ ᄋ ᅣ ᆼ ᄒ ᅡ ᄋ ᅧ
관찰하는	ᄀ ᅪ ᆫ ᄎ ᅡ ᆯ ᄒ ᅡ ᄂ ᅳ ᆫ
사용됩니다	ᄉ ᅡ ᄋ ᅭ ᆼ ᄃ ᅬ ᆷ ᄂ ᅵ ᄃ ᅡ
젊은	ᄌ ᅥ ᆯ ᄆ ᅳ ᆫ
여성을	ᄋ ᅧ ᄉ ᅥ ᆼ ᄋ ᅳ ᆯ
골라	ᄀ ᅩ ᆯ ᄅ ᅡ
하얀색	ᄒ ᅡ ᄋ ᅣ ᆫ ᄉ ᅢ ᆨ
옷을	ᄋ ᅩ ᄉ ᅳ ᆯ
입히고	ᄋ ᅵ ᄑ ᅵ ᄀ ᅩ
피를	ᄑ ᅵ ᄅ ᅳ ᆯ
붉은	ᄇ ᅮ ᆯ ᄀ ᅳ ᆫ
허리띠를	ᄒ ᅥ ᄅ ᅵ ᄄ ᅵ ᄅ ᅳ ᆯ
두르게	ᄃ ᅮ ᄅ ᅳ ᄀ ᅦ
하였다	ᄒ ᅡ ᄋ ᅧ ᆮ ᄄ ᅡ
성능만이	ᄉ ᅥ ᆼ ᄂ ᅳ ᆼ ᄆ ᅡ ᄂ ᅵ
슈퍼카라	ᄉ ᅲ ᄑ ᅥ ᄏ ᅡ ᄅ ᅡ
부를	ᄇ ᅮ ᄅ ᅳ ᆯ
차의	ᄎ ᅡ ᄋ ᅴ
인지도라든지	ᄋ ᅵ ᆫ ᄌ ᅵ ᄃ ᅩ ᄅ ᅡ ᄃ ᅳ ᆫ ᄌ ᅵ
브랜드	ᄇ ᅳ ᄅ ᅢ ᆫ ᄃ ᅳ
가치를	ᄀ ᅡ ᄎ ᅵ ᄅ ᅳ ᆯ
중요시	ᄌ ᅮ ᆼ ᄋ ᅭ ᄉ ᅵ
윈도	ᄋ ᅱ ᆫ ᄃ ᅩ
비스타부터	ᄇ ᅵ ᄉ ᅳ ᄐ ᅡ ᄇ ᅮ ᄐ ᅥ
화려한	ᄒ ᅪ ᄅ ᅧ ᄒ ᅡ ᆫ
그래픽	ᄀ ᅳ ᄅ ᅢ ᄑ ᅵ ᆨ
효과가	ᄒ ᅭ ᄀ ᅪ ᄀ ᅡ
추가되어	ᄎ ᅮ ᄀ ᅡ ᄃ ᅬ ᄋ ᅥ
화려하게	ᄒ ᅪ ᄅ ᅧ ᄒ ᅡ ᄀ ᅦ
이슬람의	ᄋ ᅵ ᄉ ᅳ ᆯ ᄅ ᅡ ᄆ ᅴ
숙원사업을	ᄉ ᅮ ᄀ ᅯ ᆫ ᄉ ᅡ ᄋ ᅥ ᄇ ᅳ ᆯ
재빠르게	ᄌ ᅢ ᄈ ᅡ ᄅ ᅳ ᄀ ᅦ
자신의	ᄌ ᅡ ᄉ ᅵ ᄂ ᅴ
이룩하고	ᄋ ᅵ ᄅ ᅮ ᄏ ᅡ ᄀ ᅩ
싶었기	ᄉ ᅵ ᄑ ᅥ ᆮ ᄁ ᅵ
욕실에서	ᄋ ᅭ ᆨ ᄊ ᅵ ᄅ ᅦ ᄉ ᅥ
미끄러져	ᄆ ᅵ ᄁ ᅳ ᄅ ᅥ ᄌ ᅥ
머리를	ᄆ ᅥ ᄅ ᅵ ᄅ ᅳ ᆯ
다치면서	ᄃ ᅡ ᄎ ᅵ ᄆ ᅧ ᆫ ᄉ ᅥ
급사하였습니다	ᄀ ᅳ ᆸ ᄊ ᅡ ᄒ ᅡ ᄋ ᅧ ᆮ ᄊ ᅳ ᆷ ᄂ ᅵ ᄃ ᅡ
술탄의	ᄉ ᅮ ᆯ ᄐ ᅡ ᄂ ᅴ
외우게	ᄋ ᅬ ᄋ ᅮ ᄀ ᅦ
난처한	ᄂ ᅡ ᆫ ᄎ ᅥ ᄒ ᅡ ᆫ
일이어서	ᄋ ᅵ ᄅ ᅵ ᄋ ᅥ ᄉ ᅥ
거두어	ᄀ ᅥ ᄃ ᅮ ᄋ ᅥ
달라고	ᄃ ᅡ ᆯ ᄅ ᅡ ᄀ ᅩ
간청하였습니다	ᄀ ᅡ ᆫ ᄎ ᅥ ᆼ ᄒ ᅡ ᄋ ᅧ ᆮ ᄊ ᅳ ᆷ ᄂ ᅵ ᄃ ᅡ
좀처럼	ᄌ ᅩ ᆷ ᄎ ᅥ ᄅ ᅥ ᆷ
만족하지	ᄆ ᅡ ᆫ ᄌ ᅩ ᄏ ᅡ ᄌ ᅵ
못했고	ᄆ ᅩ ᄐ ᅢ ᆮ ᄁ ᅩ
권력을	ᄀ ᅯ ᆯ ᄅ ᅧ ᄀ ᅳ ᆯ
얻기	ᄋ ᅥ ᆮ ᄁ ᅵ
음모를	ᄋ ᅳ ᆷ ᄆ ᅩ ᄅ ᅳ ᆯ
꾸미고	ᄁ ᅮ ᄆ ᅵ ᄀ ᅩ
형태로	ᄒ ᅧ ᆼ ᄐ ᅢ ᄅ ᅩ
마실	ᄆ ᅡ ᄉ ᅵ ᆯ
먹습니다	ᄆ ᅥ ᆨ ᄊ ᅳ ᆷ ᄂ ᅵ ᄃ ᅡ
괜히	ᄀ ᅫ ᆫ ᄒ ᅵ
안주	ᄋ ᅡ ᆫ ᄌ ᅮ
마시게	ᄆ ᅡ ᄉ ᅵ ᄀ ᅦ
취하게	ᄎ ᅱ ᄒ ᅡ ᄀ ᅦ
되므로	ᄃ ᅬ ᄆ ᅳ ᄅ ᅩ
쇠고기는	ᄉ ᅬ ᄀ ᅩ ᄀ ᅵ ᄂ ᅳ ᆫ
쉽게	ᄉ ᅱ ᆸ ᄁ ᅦ
질겨져	ᄌ ᅵ ᆯ ᄀ ᅧ ᄌ ᅥ
일반적으론	ᄋ ᅵ ᆯ ᄇ ᅡ ᆫ ᄌ ᅥ ᄀ ᅳ ᄅ ᅩ ᆫ
사용하지	ᄉ ᅡ ᄋ ᅭ ᆼ ᄒ ᅡ ᄌ ᅵ
않는다	ᄋ ᅡ ᆫ ᄂ ᅳ ᆫ ᄃ ᅡ
김치는	ᄀ ᅵ ᆷ ᄎ ᅵ ᄂ ᅳ ᆫ
높은	ᄂ ᅩ ᄑ ᅳ ᆫ
온도로	ᄋ ᅩ ᆫ ᄃ ᅩ ᄅ ᅩ
끓일	ᄁ ᅳ ᄅ ᅵ ᆯ
유산균이	ᄋ ᅲ ᄉ ᅡ ᆫ ᄀ ᅲ ᄂ ᅵ
파괴되므로	ᄑ ᅡ ᄀ ᅬ ᄃ ᅬ ᄆ ᅳ ᄅ ᅩ
조리하지	ᄌ ᅩ ᄅ ᅵ ᄒ ᅡ ᄌ ᅵ
몸에	ᄆ ᅩ ᄆ ᅦ
볶을	ᄇ ᅩ ᄁ ᅳ ᆯ
사용되는	ᄉ ᅡ ᄋ ᅭ ᆼ ᄃ ᅬ ᄂ ᅳ ᆫ
기름	ᄀ ᅵ ᄅ ᅳ ᆷ
지방	ᄌ ᅵ ᄇ ᅡ ᆼ
함량도	ᄒ ᅡ ᆷ ᄂ ᅣ ᆼ ᄃ ᅩ
편입니다	ᄑ ᅧ ᄂ ᅵ ᆷ ᄂ ᅵ ᄃ ᅡ
생산권	ᄉ ᅢ ᆼ ᄉ ᅡ ᆫ ᄀ ᅯ ᆫ
확보와	ᄒ ᅪ ᆨ ᄈ ᅩ ᄋ ᅪ
유통을	ᄋ ᅲ ᄐ ᅩ ᆼ ᄋ ᅳ ᆯ
장악하기	ᄌ ᅡ ᆼ ᄋ ᅡ ᄏ ᅡ ᄀ ᅵ
온갖	ᄋ ᅩ ᆫ ᄀ ᅡ ᆮ
지혜를	ᄌ ᅵ ᄒ ᅨ ᄅ ᅳ ᆯ
짜내느라	ᄍ ᅡ ᄂ ᅢ ᄂ ᅳ ᄅ ᅡ
고심했다	ᄀ ᅩ ᄉ ᅵ ᆷ ᄒ ᅢ ᆮ ᄄ ᅡ
처음에는	ᄎ ᅥ ᄋ ᅳ ᄆ ᅦ ᄂ ᅳ ᆫ
많지도	ᄆ ᅡ ᆫ ᄎ ᅵ ᄃ ᅩ
싸지도	ᄊ ᅡ ᄌ ᅵ ᄃ ᅩ
않아서	ᄋ ᅡ ᄂ ᅡ ᄉ ᅥ
세계	ᄉ ᅦ ᄀ ᅨ
곳에서는	ᄀ ᅩ ᄉ ᅦ ᄉ ᅥ ᄂ ᅳ ᆫ
꿀을	ᄁ ᅮ ᄅ ᅳ ᆯ
애용하였다	ᄋ ᅢ ᄋ ᅭ ᆼ ᄒ ᅡ ᄋ ᅧ ᆮ ᄄ ᅡ
수많은	ᄉ ᅮ ᄆ ᅡ ᄂ ᅳ ᆫ
초기	ᄎ ᅩ ᄀ ᅵ
사회들은	ᄉ ᅡ ᄒ ᅬ ᄃ ᅳ ᄅ ᅳ ᆫ
신들이	ᄉ ᅵ ᆫ ᄃ ᅳ ᄅ ᅵ
내려준	ᄂ ᅢ ᄅ ᅧ ᄌ ᅮ ᆫ
생각하였다	ᄉ ᅢ ᆼ ᄀ ᅡ ᄏ ᅡ ᄋ ᅧ ᆮ ᄄ ᅡ
빠져나오는	ᄈ ᅡ ᄌ ᅥ ᄂ ᅡ ᄋ ᅩ ᄂ ᅳ ᆫ
탈수	ᄐ ᅡ ᆯ ᄉ ᅮ
반응이	ᄇ ᅡ ᄂ ᅳ ᆼ ᄋ ᅵ
진행되어	ᄌ ᅵ ᆫ ᄒ ᅢ ᆼ ᄃ ᅬ ᄋ ᅥ
미라가	ᄆ ᅵ ᄅ ᅡ ᄀ ᅡ
구소련이	ᄀ ᅮ ᄉ ᅩ ᄅ ᅧ ᄂ ᅵ
해체될	ᄒ ᅢ ᄎ ᅦ ᄃ ᅬ ᆯ
공화국	ᄀ ᅩ ᆼ ᄒ ᅪ ᄀ ᅮ ᆨ
경계대로	ᄀ ᅧ ᆼ ᄀ ᅨ ᄃ ᅢ ᄅ ᅩ
신생	ᄉ ᅵ ᆫ ᄉ ᅢ ᆼ
주권	ᄌ ᅮ ᄀ ᅯ ᆫ
국가들이	ᄀ ᅮ ᆨ ᄁ ᅡ ᄃ ᅳ ᄅ ᅵ
출범하였다	ᄎ ᅮ ᆯ ᄇ ᅥ ᆷ ᄒ ᅡ ᄋ ᅧ ᆮ ᄄ ᅡ
검색을	ᄀ ᅥ ᆷ ᄉ ᅢ ᄀ ᅳ ᆯ
때도	ᄄ ᅢ ᄃ ᅩ
넣어야	ᄂ ᅥ ᄋ ᅥ ᄋ ᅣ
하며	ᄒ ᅡ ᄆ ᅧ
결과	ᄀ ᅧ ᆯ ᄀ ᅪ
글자가	ᄀ ᅳ ᆯ ᄌ ᅡ ᄀ ᅡ
배열된다	ᄇ ᅢ ᄋ ᅧ ᆯ ᄃ ᅬ ᆫ ᄃ ᅡ
과학자들이	ᄀ ᅪ ᄒ ᅡ ᆨ ᄍ ᅡ ᄃ ᅳ ᄅ ᅵ
유전자	ᄋ ᅲ ᄌ ᅥ ᆫ ᄌ ᅡ
조작을	ᄌ ᅩ ᄌ ᅡ ᄀ ᅳ ᆯ
배아를	ᄇ ᅢ ᄋ ᅡ ᄅ ᅳ ᆯ
만들었다고	ᄆ ᅡ ᆫ ᄃ ᅳ ᄅ ᅥ ᆮ ᄄ ᅡ ᄀ ᅩ
발표했다	ᄇ ᅡ ᆯ ᄑ ᅭ ᄒ ᅢ ᆮ ᄄ ᅡ
그녀는	ᄀ ᅳ ᄂ ᅧ ᄂ ᅳ ᆫ
정신을	ᄌ ᅥ ᆼ ᄉ ᅵ ᄂ ᅳ ᆯ
바짝	ᄇ ᅡ ᄍ ᅡ ᆨ
차리고	ᄎ ᅡ ᄅ ᅵ ᄀ ᅩ
조작이라고	ᄌ ᅩ ᄌ ᅡ ᄀ ᅵ ᄅ ᅡ ᄀ ᅩ
이야기하라고	ᄋ ᅵ ᄋ ᅣ ᄀ ᅵ ᄒ ᅡ ᄅ ᅡ ᄀ ᅩ
지시했다	ᄌ ᅵ ᄉ ᅵ ᄒ ᅢ ᆮ ᄄ ᅡ
조작하는	ᄌ ᅩ ᄌ ᅡ ᄏ ᅡ ᄂ ᅳ ᆫ
발생할	ᄇ ᅡ ᆯ ᄉ ᅢ ᆼ ᄒ ᅡ ᆯ
상황을	ᄉ ᅡ ᆼ ᄒ ᅪ ᆼ ᄋ ᅳ ᆯ
설명해	ᄉ ᅥ ᆯ ᄆ ᅧ ᆼ ᄒ ᅢ
놓았다	ᄂ ᅩ ᄋ ᅡ ᆮ ᄄ ᅡ
스토리의	ᄉ ᅳ ᄐ ᅩ ᄅ ᅵ ᄋ ᅴ
흐름과는	ᄒ ᅳ ᄅ ᅳ ᆷ ᄀ ᅪ ᄂ ᅳ ᆫ
연관성이	ᄋ ᅧ ᆫ ᄀ ᅪ ᆫ ᄉ ᅥ ᆼ ᄋ ᅵ
보였다	ᄇ ᅩ ᄋ ᅧ ᆮ ᄄ ᅡ
스무	ᄉ ᅳ ᄆ ᅮ
한기만	ᄒ ᅡ ᆫ ᄀ ᅵ ᄆ ᅡ ᆫ
일에서	ᄋ ᅵ ᄅ ᅦ ᄉ ᅥ
이주일간	ᄋ ᅵ ᄌ ᅮ ᄋ ᅵ ᆯ ᄀ ᅡ ᆫ
강한	ᄀ ᅡ ᆼ ᄒ ᅡ ᆫ
윈도우	ᄋ ᅱ ᆫ ᄃ ᅩ ᄋ ᅮ
곳에서	ᄀ ᅩ ᄉ ᅦ ᄉ ᅥ
회의에	ᄒ ᅬ ᄋ ᅴ ᄋ ᅦ
했데	ᄒ ᅢ ᆮ ᄄ ᅦ
이번엔	ᄋ ᅵ ᄇ ᅥ ᄂ ᅦ ᆫ
플러쓰	ᄑ ᅳ ᆯ ᄅ ᅥ ᄊ ᅳ
족하다구	ᄌ ᅩ ᄏ ᅡ ᄃ ᅡ ᄀ ᅮ
끝이냐구	ᄁ ᅳ ᄉ ᅵ ᄂ ᅣ ᄀ ᅮ
연락주세요	ᄋ ᅧ ᆯ ᄅ ᅡ ᆨ ᄍ ᅮ ᄉ ᅦ ᄋ ᅭ
들릴	ᄃ ᅳ ᆯ ᄅ ᅵ ᆯ
포식자라고	ᄑ ᅩ ᄉ ᅵ ᆨ ᄍ ᅡ ᄅ ᅡ ᄀ ᅩ
일곱에서	ᄋ ᅵ ᆯ ᄀ ᅩ ᄇ ᅦ ᄉ ᅥ
경치도	ᄀ ᅧ ᆼ ᄎ ᅵ ᄃ ᅩ
누굴	ᄂ ᅮ ᄀ ᅮ ᆯ
재미있게	ᄌ ᅢ ᄆ ᅵ ᄋ ᅵ ᆮ ᄁ ᅦ
찬	ᄎ ᅡ ᆫ
먹먹해져	ᄆ ᅥ ᆼ ᄆ ᅥ ᄏ ᅢ ᄌ ᅥ
나이를	ᄂ ᅡ ᄋ ᅵ ᄅ ᅳ ᆯ
그리워하는	ᄀ ᅳ ᄅ ᅵ ᄋ ᅯ ᄒ ᅡ ᄂ ᅳ ᆫ
가증스런	ᄀ ᅡ ᄌ ᅳ ᆼ ᄉ ᅳ ᄅ ᅥ ᆫ
있을지	ᄋ ᅵ ᄊ ᅳ ᆯ ᄌ ᅵ
뵙지요	ᄇ ᅬ ᆸ ᄍ ᅵ ᄋ ᅭ
낼	ᄂ ᅢ ᆯ
아기가	ᄋ ᅡ ᄀ ᅵ ᄀ ᅡ
풀죽은	ᄑ ᅮ ᆯ ᄌ ᅮ ᄀ ᅳ ᆫ
하실	ᄒ ᅡ ᄉ ᅵ ᆯ
시간에서	ᄉ ᅵ ᄀ ᅡ ᄂ ᅦ ᄉ ᅥ
죽구	ᄌ ᅮ ᆨ ᄁ ᅮ
사주구	ᄉ ᅡ ᄌ ᅮ ᄀ ᅮ
들었다구요	ᄃ ᅳ ᄅ ᅥ ᆮ ᄄ ᅡ ᄀ ᅮ ᄋ ᅭ
당첨됐다구요	ᄃ ᅡ ᆼ ᄎ ᅥ ᆷ ᄃ ᅫ ᆮ ᄄ ᅡ ᄀ ᅮ ᄋ ᅭ
정치인들	ᄌ ᅥ ᆼ ᄎ ᅵ ᄋ ᅵ ᆫ ᄃ ᅳ ᆯ
손님은	ᄉ ᅩ ᆫ ᄂ ᅵ ᄆ ᅳ ᆫ
아버님의	ᄋ ᅡ ᄇ ᅥ ᄂ ᅵ ᄆ ᅴ
것두	ᄀ ᅥ ᆮ ᄄ ᅮ
싶지만	ᄉ ᅵ ᆸ ᄍ ᅵ ᄆ ᅡ ᆫ
에이	ᄋ ᅦ ᄋ ᅵ
공공일	ᄀ ᅩ ᆼ ᄀ ᅩ ᆼ ᄋ ᅵ ᆯ
헤드	ᄒ ᅦ ᄃ ᅳ
경제	ᄀ ᅧ ᆼ ᄌ ᅦ
어린이	ᄋ ᅥ ᄅ ᅵ ᄂ ᅵ
금융	ᄀ ᅳ ᆷ ᄂ ᅲ ᆼ
외환	ᄋ ᅬ ᄒ ᅪ ᆫ
예금에서	ᄋ ᅨ ᄀ ᅳ ᄆ ᅦ ᄉ ᅥ
투자로	ᄐ ᅮ ᄌ ᅡ ᄅ ᅩ
올해부터	ᄋ ᅩ ᆯ ᄒ ᅢ ᄇ ᅮ ᄐ ᅥ
본격적으로	ᄇ ᅩ ᆫ ᄀ ᅧ ᆨ ᄍ ᅥ ᄀ ᅳ ᄅ ᅩ
주식투자를	ᄌ ᅮ ᄉ ᅵ ᆨ ᄐ ᅮ ᄌ ᅡ ᄅ ᅳ ᆯ
시작	ᄉ ᅵ ᄌ ᅡ ᆨ
했어요	ᄒ ᅢ ᄊ ᅥ ᄋ ᅭ
바이오	ᄇ ᅡ ᄋ ᅵ ᄋ ᅩ
자동차	ᄌ ᅡ ᄃ ᅩ ᆼ ᄎ ᅡ
엔터테인먼트	ᄋ ᅦ ᆫ ᄐ ᅥ ᄐ ᅦ ᄋ ᅵ ᆫ ᄆ ᅥ ᆫ ᄐ ᅳ
종목에	ᄌ ᅩ ᆼ ᄆ ᅩ ᄀ ᅦ
투자했고	ᄐ ᅮ ᄌ ᅡ ᄒ ᅢ ᆮ ᄁ ᅩ
월	ᄋ ᅯ ᆯ
삼	ᄉ ᅡ ᆷ
일부터	ᄋ ᅵ ᆯ ᄇ ᅮ ᄐ ᅥ
팔	ᄑ ᅡ ᆯ
삼십일	ᄉ ᅡ ᆷ ᄉ ᅵ ᄇ ᅵ ᆯ
일까지	ᄋ ᅵ ᆯ ᄁ ᅡ ᄌ ᅵ
칠	ᄎ ᅵ ᆯ
쩜	ᄍ ᅥ ᆷ
퍼센트	ᄑ ᅥ ᄉ ᅦ ᆫ ᄐ ᅳ
에	ᄋ ᅦ
수익률을	ᄉ ᅮ ᄋ ᅵ ᆼ ᄂ ᅲ ᄅ ᅳ ᆯ
올렸어요	ᄋ ᅩ ᆯ ᄅ ᅧ ᄊ ᅥ ᄋ ᅭ
코로나	ᄏ ᅩ ᄅ ᅩ ᄂ ᅡ
십구로	ᄉ ᅵ ᆸ ᄁ ᅮ ᄅ ᅩ
올해	ᄋ ᅩ ᆯ ᄒ ᅢ
고전한	ᄀ ᅩ ᄌ ᅥ ᆫ ᄒ ᅡ ᆫ
치고는	ᄎ ᅵ ᄀ ᅩ ᄂ ᅳ ᆫ
좋아요	ᄌ ᅩ ᄋ ᅡ ᄋ ᅭ
지금은	ᄌ ᅵ ᄀ ᅳ ᄆ ᅳ ᆫ
테슬라	ᄐ ᅦ ᄉ ᅳ ᆯ ᄅ ᅡ
구글	ᄀ ᅮ ᄀ ᅳ ᆯ
알파벳	ᄋ ᅡ ᆯ ᄑ ᅡ ᄇ ᅦ ᆮ
애플을	ᄋ ᅢ ᄑ ᅳ ᄅ ᅳ ᆯ
하지만	ᄒ ᅡ ᄌ ᅵ ᄆ ᅡ ᆫ
투자	ᄐ ᅮ ᄌ ᅡ
여윳돈이	ᄋ ᅧ ᄋ ᅲ ᆮ ᄄ ᅩ ᄂ ᅵ
없어서	ᄋ ᅥ ᆸ ᄊ ᅥ ᄉ ᅥ
아쉬워	ᄋ ᅡ ᄉ ᅱ ᄋ ᅯ
이예요	ᄋ ᅵ ᄋ ᅨ ᄋ ᅭ
어른	ᄋ ᅥ ᄅ ᅳ ᆫ
이야기가	ᄋ ᅵ ᄋ ᅣ ᄀ ᅵ ᄀ ᅡ
아니다	ᄋ ᅡ ᄂ ᅵ ᄃ ᅡ
초등학교	ᄎ ᅩ ᄃ ᅳ ᆼ ᄒ ᅡ ᆨ ᄁ ᅭ
사	ᄉ ᅡ
아들의	ᄋ ᅡ ᄃ ᅳ ᄅ ᅴ
투자를	ᄐ ᅮ ᄌ ᅡ ᄅ ᅳ ᆯ
설명	ᄉ ᅥ ᆯ ᄆ ᅧ ᆼ
이다	ᄋ ᅵ ᄃ ᅡ
자녀에게	ᄌ ᅡ ᄂ ᅧ ᄋ ᅦ ᄀ ᅦ
통해	ᄐ ᅩ ᆼ ᄒ ᅢ
경제와	ᄀ ᅧ ᆼ ᄌ ᅦ ᄋ ᅪ
금융을	ᄀ ᅳ ᆷ ᄂ ᅲ ᆼ ᄋ ᅳ ᆯ
가르치는	ᄀ ᅡ ᄅ ᅳ ᄎ ᅵ ᄂ ᅳ ᆫ
부모가	ᄇ ᅮ ᄆ ᅩ ᄀ ᅡ
늘고	ᄂ ᅳ ᆯ ᄀ ᅩ
예금	ᄋ ᅨ ᄀ ᅳ ᆷ
중심의	ᄌ ᅮ ᆼ ᄉ ᅵ ᄆ ᅴ
금융교육	ᄀ ᅳ ᆷ ᄂ ᅲ ᆼ ᄀ ᅭ ᄋ ᅲ ᆨ
에서	ᄋ ᅦ ᄉ ᅥ
중심	ᄌ ᅮ ᆼ ᄉ ᅵ ᆷ
금융으로의	ᄀ ᅳ ᆷ ᄂ ᅲ ᆼ ᄋ ᅳ ᄅ ᅩ ᄋ ᅴ
전환	ᄌ ᅥ ᆫ ᄒ ᅪ ᆫ
모습일까	ᄆ ᅩ ᄉ ᅳ ᄇ ᅵ ᆯ ᄁ ᅡ
교육	ᄀ ᅭ ᄋ ᅲ ᆨ
획기적	ᄒ ᅬ ᆨ ᄁ ᅵ ᄌ ᅥ ᆨ
변화	ᄇ ᅧ ᆫ ᄒ ᅪ
움직임을	ᄋ ᅮ ᆷ ᄌ ᅵ ᄀ ᅵ ᄆ ᅳ ᆯ
앞으로의	ᄋ ᅡ ᄑ ᅳ ᄅ ᅩ ᄋ ᅴ
변화를	ᄇ ᅧ ᆫ ᄒ ᅪ ᄅ ᅳ ᆯ
살펴보자	ᄉ ᅡ ᆯ ᄑ ᅧ ᄇ ᅩ ᄌ ᅡ
동학개미	ᄃ ᅩ ᆼ ᄒ ᅡ ᆨ ᄁ ᅢ ᄆ ᅵ
개인투자자	ᄀ ᅢ ᄋ ᅵ ᆫ ᄐ ᅮ ᄌ ᅡ ᄌ ᅡ
증가로	ᄌ ᅳ ᆼ ᄀ ᅡ ᄅ ᅩ
국민	ᄀ ᅮ ᆼ ᄆ ᅵ ᆫ
시대가	ᄉ ᅵ ᄃ ᅢ ᄀ ᅡ
열리면서	ᄋ ᅧ ᆯ ᄅ ᅵ ᄆ ᅧ ᆫ ᄉ ᅥ
투자에	ᄐ ᅮ ᄌ ᅡ ᄋ ᅦ
부모의	ᄇ ᅮ ᄆ ᅩ ᄋ ᅴ
관심이	ᄀ ᅪ ᆫ ᄉ ᅵ ᄆ ᅵ
크게	ᄏ ᅳ ᄀ ᅦ
늘었고	ᄂ ᅳ ᄅ ᅥ ᆮ ᄁ ᅩ
이는	ᄋ ᅵ ᄂ ᅳ ᆫ
교육과	ᄀ ᅭ ᄋ ᅲ ᆨ ᄁ ᅪ
체험의	ᄎ ᅦ ᄒ ᅥ ᄆ ᅴ
온라인	ᄋ ᅩ ᆯ ᄅ ᅡ ᄋ ᅵ ᆫ
유료	ᄋ ᅲ ᄅ ᅭ
교육은	ᄀ ᅭ ᄋ ᅲ ᄀ ᅳ ᆫ
정원	ᄌ ᅥ ᆼ ᄋ ᅯ ᆫ
열다섯	ᄋ ᅧ ᆯ ᄃ ᅡ ᄉ ᅥ ᆮ
내외를	ᄂ ᅢ ᄋ ᅬ ᄅ ᅳ ᆯ
채운다며	ᄎ ᅢ ᄋ ᅮ ᆫ ᄃ ᅡ ᄆ ᅧ
이러한	ᄋ ᅵ ᄅ ᅥ ᄒ ᅡ ᆫ
관심은	ᄀ ᅪ ᆫ ᄉ ᅵ ᄆ ᅳ ᆫ
재테크를	ᄌ ᅢ ᄐ ᅦ ᄏ ᅳ ᄅ ᅳ ᆯ
위한	ᄋ ᅱ ᄒ ᅡ ᆫ
전문	ᄌ ᅥ ᆫ ᄆ ᅮ ᆫ
교육이	ᄀ ᅭ ᄋ ᅲ ᄀ ᅵ
자녀	ᄌ ᅡ ᄂ ᅧ
전달하기	ᄌ ᅥ ᆫ ᄃ ᅡ ᆯ ᄒ ᅡ ᄀ ᅵ
때문이라고	ᄄ ᅢ ᄆ ᅮ ᄂ ᅵ ᄅ ᅡ ᄀ ᅩ
설명했다	ᄉ ᅥ ᆯ ᄆ ᅧ ᆼ ᄒ ᅢ ᆮ ᄄ ᅡ
금융당국이	ᄀ ᅳ ᆷ ᄂ ᅲ ᆼ ᄃ ᅡ ᆼ ᄀ ᅮ ᄀ ᅵ
안에	ᄋ ᅡ ᄂ ᅦ
도입하기로	ᄃ ᅩ ᄋ ᅵ ᄑ ᅡ ᄀ ᅵ ᄅ ᅩ
소숫점	ᄉ ᅩ ᄉ ᅮ ᆮ ᄍ ᅥ ᆷ
교육에	ᄀ ᅭ ᄋ ᅲ ᄀ ᅦ
기점이	ᄀ ᅵ ᄌ ᅥ ᄆ ᅵ
것이라는	ᄀ ᅥ ᄉ ᅵ ᄅ ᅡ ᄂ ᅳ ᆫ
분석이	ᄇ ᅮ ᆫ ᄉ ᅥ ᄀ ᅵ
많다	ᄆ ᅡ ᆫ ᄐ ᅡ
투자가	ᄐ ᅮ ᄌ ᅡ ᄀ ᅡ
가능한	ᄀ ᅡ ᄂ ᅳ ᆼ ᄒ ᅡ ᆫ
주식을	ᄌ ᅮ ᄉ ᅵ ᄀ ᅳ ᆯ
교육을	ᄀ ᅭ ᄋ ᅲ ᄀ ᅳ ᆯ
실시하고	ᄉ ᅵ ᆯ ᄉ ᅵ ᄒ ᅡ ᄀ ᅩ
더욱	ᄃ ᅥ ᄋ ᅮ ᆨ
활성화	ᄒ ᅪ ᆯ ᄉ ᅥ ᆼ ᄒ ᅪ
것이다	ᄀ ᅥ ᄉ ᅵ ᄃ ᅡ
소수점	ᄉ ᅩ ᄉ ᅮ ᄌ ᅥ ᆷ
지금처럼	ᄌ ᅵ ᄀ ᅳ ᆷ ᄎ ᅥ ᄅ ᅥ ᆷ
단위로	ᄃ ᅡ ᄂ ᅱ ᄅ ᅩ
구입	ᄀ ᅮ ᄋ ᅵ ᆸ
예금처럼	ᄋ ᅨ ᄀ ᅳ ᆷ ᄎ ᅥ ᄅ ᅥ ᆷ
천	ᄎ ᅥ ᆫ
만원	ᄆ ᅡ ᄂ ᅯ ᆫ
금액	ᄀ ᅳ ᄆ ᅢ ᆨ
기준으로	ᄀ ᅵ ᄌ ᅮ ᄂ ᅳ ᄅ ᅩ
국내에서	ᄀ ᅮ ᆼ ᄂ ᅢ ᄋ ᅦ ᄉ ᅥ
영	ᄋ ᅧ ᆼ
까지	ᄁ ᅡ ᄌ ᅵ
이름이	ᄋ ᅵ ᄅ ᅳ ᄆ ᅵ
붙었다	ᄇ ᅮ ᄐ ᅥ ᆮ ᄄ ᅡ
투자는	ᄐ ᅮ ᄌ ᅡ ᄂ ᅳ ᆫ
이천십팔년	ᄋ ᅵ ᄎ ᅥ ᆫ ᄉ ᅵ ᆸ ᄑ ᅡ ᆯ ᄅ ᅧ ᆫ
신한	ᄉ ᅵ ᆫ ᄒ ᅡ ᆫ
금융투자가	ᄀ ᅳ ᆷ ᄂ ᅲ ᆼ ᄐ ᅮ ᄌ ᅡ ᄀ ᅡ
국내	ᄀ ᅮ ᆼ ᄂ ᅢ
최초로	ᄎ ᅬ ᄎ ᅩ ᄅ ᅩ
도입	ᄃ ᅩ ᄋ ᅵ ᆸ
최근	ᄎ ᅬ ᄀ ᅳ ᆫ
투자자의	ᄐ ᅮ ᄌ ᅡ ᄌ ᅡ ᄋ ᅴ
늘자	ᄂ ᅳ ᆯ ᄌ ᅡ
한국투자증권	ᄒ ᅡ ᆫ ᄀ ᅮ ᆨ ᄐ ᅮ ᄌ ᅡ ᄌ ᅳ ᆼ ᄀ ᅯ ᆫ
대형	ᄃ ᅢ ᄒ ᅧ ᆼ
우량주	ᄋ ᅮ ᄅ ᅣ ᆼ ᄌ ᅮ
육십	ᄋ ᅲ ᆨ ᄊ ᅵ ᆸ
여종을	ᄋ ᅧ ᄌ ᅩ ᆼ ᄋ ᅳ ᆯ
매매	ᄆ ᅢ ᄆ ᅢ
비슷한	ᄇ ᅵ ᄉ ᅳ ᄐ ᅡ ᆫ
서비스를	ᄉ ᅥ ᄇ ᅵ ᄉ ᅳ ᄅ ᅳ ᆯ
선보였고	ᄉ ᅥ ᆫ ᄇ ᅩ ᄋ ᅧ ᆮ ᄁ ᅩ
미래에셋	ᄆ ᅵ ᄅ ᅢ ᄋ ᅦ ᄉ ᅦ ᆮ
대우	ᄃ ᅢ ᄋ ᅮ
삼성증권도	ᄉ ᅡ ᆷ ᄉ ᅥ ᆼ ᄌ ᅳ ᆼ ᄀ ᅯ ᆫ ᄃ ᅩ
통한	ᄐ ᅩ ᆼ ᄒ ᅡ ᆫ
빠르게	ᄈ ᅡ ᄅ ᅳ ᄀ ᅦ
늘어날	ᄂ ᅳ ᄅ ᅥ ᄂ ᅡ ᆯ
예상했다	ᄋ ᅨ ᄉ ᅡ ᆼ ᄒ ᅢ ᆮ ᄄ ᅡ
기업의	ᄀ ᅵ ᄋ ᅥ ᄇ ᅴ
하면서	ᄒ ᅡ ᄆ ᅧ ᆫ ᄉ ᅥ
자녀와	ᄌ ᅡ ᄂ ᅧ ᄋ ᅪ
투자하고	ᄐ ᅮ ᄌ ᅡ ᄒ ᅡ ᄀ ᅩ
주부는	ᄌ ᅮ ᄇ ᅮ ᄂ ᅳ ᆫ
장기투자에	ᄌ ᅡ ᆼ ᄀ ᅵ ᄐ ᅮ ᄌ ᅡ ᄋ ᅦ
중심으로	ᄌ ᅮ ᆼ ᄉ ᅵ ᄆ ᅳ ᄅ ᅩ
진행해야	ᄌ ᅵ ᆫ ᄒ ᅢ ᆼ ᄒ ᅢ ᄋ ᅣ
주식	ᄌ ᅮ ᄉ ᅵ ᆨ
가격은	ᄀ ᅡ ᄀ ᅧ ᄀ ᅳ ᆫ
해소	ᄒ ᅢ ᄉ ᅩ
언급했다	ᄋ ᅥ ᆫ ᄀ ᅳ ᄑ ᅢ ᆮ ᄄ ᅡ
한편	ᄒ ᅡ ᆫ ᄑ ᅧ ᆫ
가능해지면	ᄀ ᅡ ᄂ ᅳ ᆼ ᄒ ᅢ ᄌ ᅵ ᄆ ᅧ ᆫ
용돈은	ᄋ ᅭ ᆼ ᄃ ᅩ ᄂ ᅳ ᆫ
예금이라는	ᄋ ᅨ ᄀ ᅳ ᄆ ᅵ ᄅ ᅡ ᄂ ᅳ ᆫ
년간	ᄂ ᅧ ᆫ ᄀ ᅡ ᆫ
형성된	ᄒ ᅧ ᆼ ᄉ ᅥ ᆼ ᄃ ᅬ ᆫ
고정관념이	ᄀ ᅩ ᄌ ᅥ ᆼ ᄀ ᅪ ᆫ ᄂ ᅧ ᄆ ᅵ
용도은	ᄋ ᅭ ᆼ ᄃ ᅩ ᄋ ᅳ ᆫ
바뀔	ᄇ ᅡ ᄁ ᅱ ᆯ
내다봤다	ᄂ ᅢ ᄃ ᅡ ᄇ ᅪ ᆮ ᄄ ᅡ
전망에는	ᄌ ᅥ ᆫ ᄆ ᅡ ᆼ ᄋ ᅦ ᄂ ᅳ ᆫ
금리가	ᄀ ᅳ ᆷ ᄂ ᅵ ᄀ ᅡ
낮아지면서	ᄂ ᅡ ᄌ ᅡ ᄌ ᅵ ᄆ ᅧ ᆫ ᄉ ᅥ
과	ᄀ ᅪ
동학혁명을	ᄃ ᅩ ᆼ ᄒ ᅡ ᄏ ᅧ ᆼ ᄆ ᅧ ᆼ ᄋ ᅳ ᆯ
주도한	ᄌ ᅮ ᄃ ᅩ ᄒ ᅡ ᆫ
전봉준	ᄌ ᅥ ᆫ ᄇ ᅩ ᆼ ᄌ ᅮ ᆫ
녹두장군의	ᄂ ᅩ ᆨ ᄄ ᅮ ᄌ ᅡ ᆼ ᄀ ᅮ ᄂ ᅴ
합성어로	ᄒ ᅡ ᆸ ᄊ ᅥ ᆼ ᄋ ᅥ ᄅ ᅩ
존리	ᄌ ᅩ ᆯ ᄅ ᅵ
메리츠	ᄆ ᅦ ᄅ ᅵ ᄎ ᅳ
자산운용	ᄌ ᅡ ᄉ ᅡ ᄂ ᅮ ᄂ ᅭ ᆼ
대표는	ᄃ ᅢ ᄑ ᅭ ᄂ ᅳ ᆫ
기자와	ᄀ ᅵ ᄌ ᅡ ᄋ ᅪ
인터뷰에서	ᄋ ᅵ ᆫ ᄐ ᅥ ᄇ ᅲ ᄋ ᅦ ᄉ ᅥ
주식하면	ᄌ ᅮ ᄉ ᅵ ᄏ ᅡ ᄆ ᅧ ᆫ
망한다는	ᄆ ᅡ ᆼ ᄒ ᅡ ᆫ ᄃ ᅡ ᄂ ᅳ ᆫ
주식투자	ᄌ ᅮ ᄉ ᅵ ᆨ ᄐ ᅮ ᄌ ᅡ
망한다로	ᄆ ᅡ ᆼ ᄒ ᅡ ᆫ ᄃ ᅡ ᄅ ᅩ
바뀌어야	ᄇ ᅡ ᄁ ᅱ ᄋ ᅥ ᄋ ᅣ
한다며	ᄒ ᅡ ᆫ ᄃ ᅡ ᄆ ᅧ
말에	ᄆ ᅡ ᄅ ᅦ
부정적인	ᄇ ᅮ ᄌ ᅥ ᆼ ᄌ ᅥ ᄀ ᅵ ᆫ
댓글이	ᄃ ᅢ ᆮ ᄁ ᅳ ᄅ ᅵ
줄어드는	ᄌ ᅮ ᄅ ᅥ ᄃ ᅳ ᄂ ᅳ ᆫ
주식에	ᄌ ᅮ ᄉ ᅵ ᄀ ᅦ
인식이	ᄋ ᅵ ᆫ ᄉ ᅵ ᄀ ᅵ
바뀌는	ᄇ ᅡ ᄁ ᅱ ᄂ ᅳ ᆫ
실감한다고	ᄉ ᅵ ᆯ ᄀ ᅡ ᆷ ᄒ ᅡ ᆫ ᄃ ᅡ ᄀ ᅩ
말했다	ᄆ ᅡ ᆯ ᄒ ᅢ ᆮ ᄄ ᅡ
처럼	ᄎ ᅥ ᄅ ᅥ ᆷ
앞으로	ᄋ ᅡ ᄑ ᅳ ᄅ ᅩ
증권회사를	ᄌ ᅳ ᆼ ᄀ ᅯ ᆫ ᄒ ᅬ ᄉ ᅡ ᄅ ᅳ ᆯ
비롯해	ᄇ ᅵ ᄅ ᅩ ᄐ ᅢ
자산	ᄌ ᅡ ᄉ ᅡ ᆫ
운용사	ᄋ ᅮ ᄂ ᅭ ᆼ ᄉ ᅡ
기업에	ᄀ ᅵ ᄋ ᅥ ᄇ ᅦ
방법으로	ᄇ ᅡ ᆼ ᄇ ᅥ ᄇ ᅳ ᄅ ᅩ
떠오를	ᄄ ᅥ ᄋ ᅩ ᄅ ᅳ ᆯ
펀드를	ᄑ ᅥ ᆫ ᄃ ᅳ ᄅ ᅳ ᆯ
분기별	ᄇ ᅮ ᆫ ᄀ ᅵ ᄇ ᅧ ᆯ
결과를	ᄀ ᅧ ᆯ ᄀ ᅪ ᄅ ᅳ ᆯ
아이들이	ᄋ ᅡ ᄋ ᅵ ᄃ ᅳ ᄅ ᅵ
이해	ᄋ ᅵ ᄒ ᅢ
만들어주거나	ᄆ ᅡ ᆫ ᄃ ᅳ ᄅ ᅥ ᄌ ᅮ ᄀ ᅥ ᄂ ᅡ
소규모	ᄉ ᅩ ᄀ ᅲ ᄆ ᅩ
캠프에	ᄏ ᅢ ᆷ ᄑ ᅳ ᄋ ᅦ
머물러	ᄆ ᅥ ᄆ ᅮ ᆯ ᄅ ᅥ
가정에서	ᄀ ᅡ ᄌ ᅥ ᆼ ᄋ ᅦ ᄉ ᅥ
당장이라도	ᄃ ᅡ ᆼ ᄌ ᅡ ᆼ ᄋ ᅵ ᄅ ᅡ ᄃ ᅩ
가능하다	ᄀ ᅡ ᄂ ᅳ ᆼ ᄒ ᅡ ᄃ ᅡ
자녀에	ᄌ ᅡ ᄂ ᅧ ᄋ ᅦ
경제신문과	ᄀ ᅧ ᆼ ᄌ ᅦ ᄉ ᅵ ᆫ ᄆ ᅮ ᆫ ᄀ ᅪ
독립	ᄃ ᅩ ᆼ ᄂ ᅵ ᆸ
만세	ᄆ ᅡ ᆫ ᄉ ᅦ
운동을	ᄋ ᅮ ᆫ ᄃ ᅩ ᆼ ᄋ ᅳ ᆯ
전개하고	ᄌ ᅥ ᆫ ᄀ ᅢ ᄒ ᅡ ᄀ ᅩ
권	ᄀ ᅯ ᆫ
부현	ᄇ ᅮ ᄒ ᅧ ᆫ
강사를	ᄀ ᅡ ᆼ ᄉ ᅡ ᄅ ᅳ ᆯ
내용을	ᄂ ᅢ ᄋ ᅭ ᆼ ᄋ ᅳ ᆯ
들어본다	ᄃ ᅳ ᄅ ᅥ ᄇ ᅩ ᆫ ᄃ ᅡ
용돈	ᄋ ᅭ ᆼ ᄃ ᅩ ᆫ
활용으로	ᄒ ᅪ ᄅ ᅭ ᆼ ᄋ ᅳ ᄅ ᅩ
관심	ᄀ ᅪ ᆫ ᄉ ᅵ ᆷ
유도	ᄋ ᅲ ᄃ ᅩ
양육자인	ᄋ ᅣ ᆼ ᄋ ᅲ ᆨ ᄍ ᅡ ᄋ ᅵ ᆫ
엄마의	ᄋ ᅥ ᆷ ᄆ ᅡ ᄋ ᅴ
태도입니다	ᄐ ᅢ ᄃ ᅩ ᄋ ᅵ ᆷ ᄂ ᅵ ᄃ ᅡ
시장	ᄉ ᅵ ᄌ ᅡ ᆼ
배우고	ᄇ ᅢ ᄋ ᅮ ᄀ ᅩ
생각하고	ᄉ ᅢ ᆼ ᄀ ᅡ ᄏ ᅡ ᄀ ᅩ
포함한	ᄑ ᅩ ᄒ ᅡ ᆷ ᄒ ᅡ ᆫ
가족	ᄀ ᅡ ᄌ ᅩ ᆨ
구성원의	ᄀ ᅮ ᄉ ᅥ ᆼ ᄋ ᅯ ᄂ ᅴ
이야기	ᄋ ᅵ ᄋ ᅣ ᄀ ᅵ
소재로	ᄉ ᅩ ᄌ ᅢ ᄅ ᅩ
삼아	ᄉ ᅡ ᄆ ᅡ
자연스럽게	ᄌ ᅡ ᄋ ᅧ ᆫ ᄉ ᅳ ᄅ ᅥ ᆸ ᄁ ᅦ
가정	ᄀ ᅡ ᄌ ᅥ ᆼ
문화로	ᄆ ᅮ ᆫ ᄒ ᅪ ᄅ ᅩ
자리잡게	ᄌ ᅡ ᄅ ᅵ ᄌ ᅡ ᆸ ᄁ ᅦ
책을	ᄎ ᅢ ᄀ ᅳ ᆯ
읽으면	ᄋ ᅵ ᆯ ᄀ ᅳ ᄆ ᅧ ᆫ
아이도	ᄋ ᅡ ᄋ ᅵ ᄃ ᅩ
자연스레	ᄌ ᅡ ᄋ ᅧ ᆫ ᄉ ᅳ ᄅ ᅦ
책	ᄎ ᅢ ᆨ
읽는	ᄋ ᅵ ᆼ ᄂ ᅳ ᆫ
것과	ᄀ ᅥ ᆮ ᄁ ᅪ
마찬가지	ᄆ ᅡ ᄎ ᅡ ᆫ ᄀ ᅡ ᄌ ᅵ
라고	ᄅ ᅡ ᄀ ᅩ
생각합니다	ᄉ ᅢ ᆼ ᄀ ᅡ ᄏ ᅡ ᆷ ᄂ ᅵ ᄃ ᅡ
번째는	ᄇ ᅥ ᆫ ᄍ ᅢ ᄂ ᅳ ᆫ
아이의	ᄋ ᅡ ᄋ ᅵ ᄋ ᅴ
피부에	ᄑ ᅵ ᄇ ᅮ ᄋ ᅦ
닿는	ᄃ ᅡ ᆫ ᄂ ᅳ ᆫ
질문을	ᄌ ᅵ ᆯ ᄆ ᅮ ᄂ ᅳ ᆯ
입니다	ᄋ ᅵ ᆷ ᄂ ᅵ ᄃ ᅡ
매일	ᄆ ᅢ ᄋ ᅵ ᆯ
신문을	ᄉ ᅵ ᆫ ᄆ ᅮ ᄂ ᅳ ᆯ
읽습니다	ᄋ ᅵ ᆨ ᄊ ᅳ ᆷ ᄂ ᅵ ᄃ ᅡ
도중에	ᄃ ᅩ ᄌ ᅮ ᆼ ᄋ ᅦ
읽다가	ᄋ ᅵ ᆨ ᄄ ᅡ ᄀ ᅡ
아들이	ᄋ ᅡ ᄃ ᅳ ᄅ ᅵ
종목	ᄌ ᅩ ᆼ ᄆ ᅩ ᆨ
용어나	ᄋ ᅭ ᆼ ᄋ ᅥ ᄂ ᅡ
원리를	ᄋ ᅯ ᆯ ᄅ ᅵ ᄅ ᅳ ᆯ
줍니다	ᄌ ᅮ ᆷ ᄂ ᅵ ᄃ ᅡ
투입해서	ᄐ ᅮ ᄋ ᅵ ᄑ ᅢ ᄉ ᅥ
실전에서	ᄉ ᅵ ᆯ ᄌ ᅥ ᄂ ᅦ ᄉ ᅥ
배우게	ᄇ ᅢ ᄋ ᅮ ᄀ ᅦ
아직	ᄋ ᅡ ᄌ ᅵ ᆨ
직	ᄌ ᅵ ᆨ
공공이	ᄀ ᅩ ᆼ ᄀ ᅩ ᆼ ᄋ ᅵ
활동	ᄒ ᅪ ᆯ ᄃ ᅩ ᆼ
마스크가	ᄆ ᅡ ᄉ ᅳ ᄏ ᅳ ᄀ ᅡ
팔리잖아	ᄑ ᅡ ᆯ ᄅ ᅵ ᄌ ᅡ ᄂ ᅡ
마스크	ᄆ ᅡ ᄉ ᅳ ᄏ ᅳ
회사에	ᄒ ᅬ ᄉ ᅡ ᄋ ᅦ
투자하면	ᄐ ᅮ ᄌ ᅡ ᄒ ᅡ ᄆ ᅧ ᆫ
사태	ᄉ ᅡ ᄐ ᅢ
초기에	ᄎ ᅩ ᄀ ᅵ ᄋ ᅦ
학년인	ᄒ ᅡ ᆼ ᄂ ᅧ ᄂ ᅵ ᆫ
첫째가	ᄎ ᅥ ᆮ ᄍ ᅢ ᄀ ᅡ
말이에요	ᄆ ᅡ ᄅ ᅵ ᄋ ᅦ ᄋ ᅭ
회사는	ᄒ ᅬ ᄉ ᅡ ᄂ ᅳ ᆫ
오를	ᄋ ᅩ ᄅ ᅳ ᆯ
올랐다며	ᄋ ᅩ ᆯ ᄅ ᅡ ᆮ ᄄ ᅡ ᄆ ᅧ
의견에	ᄋ ᅴ ᄀ ᅧ ᄂ ᅦ
반대	ᄇ ᅡ ᆫ ᄃ ᅢ
후회	ᄒ ᅮ ᄒ ᅬ
때문이	ᄄ ᅢ ᄆ ᅮ ᄂ ᅵ
의견을	ᄋ ᅴ ᄀ ᅧ ᄂ ᅳ ᆯ
받아들이고	ᄇ ᅡ ᄃ ᅡ ᄃ ᅳ ᄅ ᅵ ᄀ ᅩ
관찰	ᄀ ᅪ ᆫ ᄎ ᅡ ᆯ
했으면	ᄒ ᅢ ᄊ ᅳ ᄆ ᅧ ᆫ
좋았을	ᄌ ᅩ ᄋ ᅡ ᄊ ᅳ ᆯ
꿈	ᄁ ᅮ ᆷ
꿨	ᄁ ᅯ ᆮ
선	ᄉ ᅥ ᆫ
이룰	ᄋ ᅵ ᄅ ᅮ ᆯ
주식투자하는	ᄌ ᅮ ᄉ ᅵ ᆨ ᄐ ᅮ ᄌ ᅡ ᄒ ᅡ ᄂ ᅳ ᆫ
사십	ᄉ ᅡ ᄉ ᅵ ᆸ
만남에	ᄆ ᅡ ᆫ ᄂ ᅡ ᄆ ᅦ
빠져	ᄈ ᅡ ᄌ ᅥ
결정하며	ᄀ ᅧ ᆯ ᄌ ᅥ ᆼ ᄒ ᅡ ᄆ ᅧ
기업과	ᄀ ᅵ ᄋ ᅥ ᆸ ᄁ ᅪ
시장의	ᄉ ᅵ ᄌ ᅡ ᆼ ᄋ ᅴ
토론한다	ᄐ ᅩ ᄅ ᅩ ᆫ ᄒ ᅡ ᆫ ᄃ ᅡ
경제신문에서	ᄀ ᅧ ᆼ ᄌ ᅦ ᄉ ᅵ ᆫ ᄆ ᅮ ᄂ ᅦ ᄉ ᅥ
지면을	ᄌ ᅵ ᄆ ᅧ ᄂ ᅳ ᆯ
읽고	ᄋ ᅵ ᆯ ᄁ ᅩ
본다	ᄇ ᅩ ᆫ ᄃ ᅡ
권부영	ᄀ ᅯ ᆫ ᄇ ᅮ ᄋ ᅧ ᆼ
씨는	ᄊ ᅵ ᄂ ᅳ ᆫ
배움에	ᄇ ᅢ ᄋ ᅮ ᄆ ᅦ
열심이다	ᄋ ᅧ ᆯ ᄉ ᅵ ᄆ ᅵ ᄃ ᅡ
영화사에서	ᄋ ᅧ ᆼ ᄒ ᅪ ᄉ ᅡ ᄋ ᅦ ᄉ ᅥ
일하다	ᄋ ᅵ ᆯ ᄒ ᅡ ᄃ ᅡ
방송통신대	ᄇ ᅡ ᆼ ᄉ ᅩ ᆼ ᄐ ᅩ ᆼ ᄉ ᅵ ᆫ ᄃ ᅢ
대학원	ᄃ ᅢ ᄒ ᅡ ᄀ ᅯ ᆫ
문예창작	ᄆ ᅮ ᄂ ᅨ ᄎ ᅡ ᆼ ᄌ ᅡ ᆨ
콘텐츠에서	ᄏ ᅩ ᆫ ᄐ ᅦ ᆫ ᄎ ᅳ ᄋ ᅦ ᄉ ᅥ
학위를	ᄒ ᅡ ᄀ ᅱ ᄅ ᅳ ᆯ
받았다	ᄇ ᅡ ᄃ ᅡ ᆮ ᄄ ᅡ
공부	ᄀ ᅩ ᆼ ᄇ ᅮ
했지만	ᄒ ᅢ ᆮ ᄍ ᅵ ᄆ ᅡ ᆫ
돈에	ᄃ ᅩ ᄂ ᅦ
알아야	ᄋ ᅡ ᄅ ᅡ ᄋ ᅣ
한다는	ᄒ ᅡ ᆫ ᄃ ᅡ ᄂ ᅳ ᆫ
절감	ᄌ ᅥ ᆯ ᄀ ᅡ ᆷ
주식시장에서	ᄌ ᅮ ᄉ ᅵ ᆨ ᄊ ᅵ ᄌ ᅡ ᆼ ᄋ ᅦ ᄉ ᅥ
시련을	ᄉ ᅵ ᄅ ᅧ ᄂ ᅳ ᆯ
겪기도	ᄀ ᅧ ᆨ ᄁ ᅵ ᄃ ᅩ
했고요	ᄒ ᅢ ᆮ ᄁ ᅩ ᄋ ᅭ
됐다	ᄃ ᅫ ᆮ ᄄ ᅡ
기자	ᄀ ᅵ ᄌ ᅡ
생각하는지	ᄉ ᅢ ᆼ ᄀ ᅡ ᄏ ᅡ ᄂ ᅳ ᆫ ᄌ ᅵ
요	ᄋ ᅭ
시간	ᄉ ᅵ ᄀ ᅡ ᆫ
노력	ᄂ ᅩ ᄅ ᅧ ᆨ
끈기만으로는	ᄁ ᅳ ᆫ ᄀ ᅵ ᄆ ᅡ ᄂ ᅳ ᄅ ᅩ ᄂ ᅳ ᆫ
현실적인	ᄒ ᅧ ᆫ ᄉ ᅵ ᆯ ᄌ ᅥ ᄀ ᅵ ᆫ
어려움을	ᄋ ᅥ ᄅ ᅧ ᄋ ᅮ ᄆ ᅳ ᆯ
극복하기	ᄀ ᅳ ᆨ ᄈ ᅩ ᄏ ᅡ ᄀ ᅵ
힘들어요	ᄒ ᅵ ᆷ ᄃ ᅳ ᄅ ᅥ ᄋ ᅭ
부모님은	ᄇ ᅮ ᄆ ᅩ ᄂ ᅵ ᄆ ᅳ ᆫ
착실하게	ᄎ ᅡ ᆨ ᄊ ᅵ ᆯ ᄒ ᅡ ᄀ ᅦ
벌고	ᄇ ᅥ ᆯ ᄀ ᅩ
아껴서	ᄋ ᅡ ᄁ ᅧ ᄉ ᅥ
저축하라고	ᄌ ᅥ ᄎ ᅮ ᄏ ᅡ ᄅ ᅡ ᄀ ᅩ
가르쳐주셔서	ᄀ ᅡ ᄅ ᅳ ᄎ ᅥ ᄌ ᅮ ᄉ ᅧ ᄉ ᅥ
그러나	ᄀ ᅳ ᄅ ᅥ ᄂ ᅡ
후	ᄒ ᅮ
돈과	ᄃ ᅩ ᆫ ᄀ ᅪ
거리가	ᄀ ᅥ ᄅ ᅵ ᄀ ᅡ
멀어보고	ᄆ ᅥ ᄅ ᅥ ᄇ ᅩ ᄀ ᅩ
도움받을	ᄃ ᅩ ᄋ ᅮ ᆷ ᄇ ᅡ ᄃ ᅳ ᆯ
멘토도	ᄆ ᅦ ᆫ ᄐ ᅩ ᄃ ᅩ
없었어요	ᄋ ᅥ ᆸ ᄊ ᅥ ᄊ ᅥ ᄋ ᅭ
아이	ᄋ ᅡ ᄋ ᅵ
생각도	ᄉ ᅢ ᆼ ᄀ ᅡ ᆨ ᄄ ᅩ
했죠	ᄒ ᅢ ᆮ ᄍ ᅭ
아마	ᄋ ᅡ ᄆ ᅡ
저와	ᄌ ᅥ ᄋ ᅪ
고민을	ᄀ ᅩ ᄆ ᅵ ᄂ ᅳ ᆯ
거예요	ᄀ ᅥ ᄋ ᅨ ᄋ ᅭ
경험을	ᄀ ᅧ ᆼ ᄒ ᅥ ᄆ ᅳ ᆯ
토대로	ᄐ ᅩ ᄃ ᅢ ᄅ ᅩ
꿈을	ᄁ ᅮ ᄆ ᅳ ᆯ
이루기	ᄋ ᅵ ᄅ ᅮ ᄀ ᅵ
경제적	ᄀ ᅧ ᆼ ᄌ ᅦ ᄌ ᅥ ᆨ
독립이	ᄃ ᅩ ᆼ ᄂ ᅵ ᄇ ᅵ
믿어요	ᄆ ᅵ ᄃ ᅥ ᄋ ᅭ
독립의	ᄃ ᅩ ᆼ ᄂ ᅵ ᄇ ᅴ
출발은	ᄎ ᅮ ᆯ ᄇ ᅡ ᄅ ᅳ ᆫ
어렸을	ᄋ ᅥ ᄅ ᅧ ᄊ ᅳ ᆯ
공부라고	ᄀ ᅩ ᆼ ᄇ ᅮ ᄅ ᅡ ᄀ ᅩ
생각해요	ᄉ ᅢ ᆼ ᄀ ᅡ ᄏ ᅢ ᄋ ᅭ
전문가들은	ᄌ ᅥ ᆫ ᄆ ᅮ ᆫ ᄀ ᅡ ᄃ ᅳ ᄅ ᅳ ᆫ
초등생인	ᄎ ᅩ ᄃ ᅳ ᆼ ᄉ ᅢ ᆼ ᄋ ᅵ ᆫ
이십에서	ᄋ ᅵ ᄉ ᅵ ᄇ ᅦ ᄉ ᅥ
이십오	ᄋ ᅵ ᄉ ᅵ ᄇ ᅩ
세가	ᄉ ᅦ ᄀ ᅡ
전문직의	ᄌ ᅥ ᆫ ᄆ ᅮ ᆫ ᄌ ᅵ ᄀ ᅴ
십에서	ᄉ ᅵ ᄇ ᅦ ᄉ ᅥ
삼십	ᄉ ᅡ ᆷ ᄉ ᅵ ᆸ
퍼센트가	ᄑ ᅥ ᄉ ᅦ ᆫ ᄐ ᅳ ᄀ ᅡ
인공지능으로	ᄋ ᅵ ᆫ ᄀ ᅩ ᆼ ᄌ ᅵ ᄂ ᅳ ᆼ ᄋ ᅳ ᄅ ᅩ
대체	ᄃ ᅢ ᄎ ᅦ
되리라	ᄃ ᅬ ᄅ ᅵ ᄅ ᅡ
예측하죠	ᄋ ᅨ ᄎ ᅳ ᄏ ᅡ ᄌ ᅭ
대비하기	ᄃ ᅢ ᄇ ᅵ ᄒ ᅡ ᄀ ᅵ
무엇보다	ᄆ ᅮ ᄋ ᅥ ᆮ ᄈ ᅩ ᄃ ᅡ
경제를	ᄀ ᅧ ᆼ ᄌ ᅦ ᄅ ᅳ ᆯ
가르쳐야	ᄀ ᅡ ᄅ ᅳ ᄎ ᅥ ᄋ ᅣ
구독한	ᄀ ᅮ ᄃ ᅩ ᄏ ᅡ ᆫ
이유도	ᄋ ᅵ ᄋ ᅲ ᄃ ᅩ
있어요	ᄋ ᅵ ᄊ ᅥ ᄋ ᅭ
정기	ᄌ ᅥ ᆼ ᄀ ᅵ
지급	ᄌ ᅵ ᄀ ᅳ ᆸ
가르쳐	ᄀ ᅡ ᄅ ᅳ ᄎ ᅥ
있나요	ᄋ ᅵ ᆫ ᄂ ᅡ ᄋ ᅭ
개념만	ᄀ ᅢ ᄂ ᅧ ᆷ ᄆ ᅡ ᆫ
외운다고	ᄋ ᅬ ᄋ ᅮ ᆫ ᄃ ᅡ ᄀ ᅩ
아니에요	ᄋ ᅡ ᄂ ᅵ ᄋ ᅦ ᄋ ᅭ
이론과	ᄋ ᅵ ᄅ ᅩ ᆫ ᄀ ᅪ
변화무쌍한	ᄇ ᅧ ᆫ ᄒ ᅪ ᄆ ᅮ ᄊ ᅡ ᆼ ᄒ ᅡ ᆫ
체득	ᄎ ᅦ ᄃ ᅳ ᆨ
봅니다	ᄇ ᅩ ᆷ ᄂ ᅵ ᄃ ᅡ
이름으로	ᄋ ᅵ ᄅ ᅳ ᄆ ᅳ ᄅ ᅩ
계좌를	ᄀ ᅨ ᄌ ᅪ ᄅ ᅳ ᆯ
개설해서	ᄀ ᅢ ᄉ ᅥ ᆯ ᄒ ᅢ ᄉ ᅥ
조금씩	ᄌ ᅩ ᄀ ᅳ ᆷ ᄊ ᅵ ᆨ
가르쳐주고	ᄀ ᅡ ᄅ ᅳ ᄎ ᅥ ᄌ ᅮ ᄀ ᅩ
근처에서	ᄀ ᅳ ᆫ ᄎ ᅥ ᄋ ᅦ ᄉ ᅥ
벌	ᄇ ᅥ ᆯ
간단한	ᄀ ᅡ ᆫ ᄃ ᅡ ᆫ ᄒ ᅡ ᆫ
사업도	ᄉ ᅡ ᄋ ᅥ ᆸ ᄄ ᅩ
구상	ᄀ ᅮ ᄉ ᅡ ᆼ
십구	ᄉ ᅵ ᆸ ᄁ ᅮ
실천은	ᄉ ᅵ ᆯ ᄎ ᅥ ᄂ ᅳ ᆫ
못하고	ᄆ ᅩ ᄐ ᅡ ᄀ ᅩ
학년이	ᄒ ᅡ ᆼ ᄂ ᅧ ᄂ ᅵ
되면서	ᄃ ᅬ ᄆ ᅧ ᆫ ᄉ ᅥ
일주일에	ᄋ ᅵ ᆯ ᄌ ᅮ ᄋ ᅵ ᄅ ᅦ
원인데	ᄋ ᅯ ᄂ ᅵ ᆫ ᄃ ᅦ
오	ᄋ ᅩ
원으로	ᄋ ᅯ ᄂ ᅳ ᄅ ᅩ
올리기로	ᄋ ᅩ ᆯ ᄅ ᅵ ᄀ ᅵ ᄅ ᅩ
기록장에	ᄀ ᅵ ᄅ ᅩ ᆨ ᄍ ᅡ ᆼ ᄋ ᅦ
정리하고	ᄌ ᅥ ᆼ ᄂ ᅵ ᄒ ᅡ ᄀ ᅩ
모아	ᄆ ᅩ ᄋ ᅡ
고성능	ᄀ ᅩ ᄉ ᅥ ᆼ ᄂ ᅳ ᆼ
컴퓨터와	ᄏ ᅥ ᆷ ᄑ ᅲ ᄐ ᅥ ᄋ ᅪ
브이알	ᄇ ᅳ ᄋ ᅵ ᄋ ᅡ ᆯ
고글을	ᄀ ᅩ ᄀ ᅳ ᄅ ᅳ ᆯ
마련하는	ᄆ ᅡ ᄅ ᅧ ᆫ ᄒ ᅡ ᄂ ᅳ ᆫ
목표	ᄆ ᅩ ᆨ ᄑ ᅭ
아이는	ᄋ ᅡ ᄋ ᅵ ᄂ ᅳ ᆫ
만나면서	ᄆ ᅡ ᆫ ᄂ ᅡ ᄆ ᅧ ᆫ ᄉ ᅥ
저축해도	ᄌ ᅥ ᄎ ᅮ ᄏ ᅢ ᄃ ᅩ
목표를	ᄆ ᅩ ᆨ ᄑ ᅭ ᄅ ᅳ ᆯ
이루는	ᄋ ᅵ ᄅ ᅮ ᄂ ᅳ ᆫ
쉽지	ᄉ ᅱ ᆸ ᄍ ᅵ
않다는	ᄋ ᅡ ᆫ ᄐ ᅡ ᄂ ᅳ ᆫ
됐고	ᄃ ᅫ ᆮ ᄁ ᅩ
해결	ᄒ ᅢ ᄀ ᅧ ᆯ
고민하는	ᄀ ᅩ ᄆ ᅵ ᆫ ᄒ ᅡ ᄂ ᅳ ᆫ
이에요	ᄋ ᅵ ᄋ ᅦ ᄋ ᅭ
사용은	ᄉ ᅡ ᄋ ᅭ ᆼ ᄋ ᅳ ᆫ
자율에	ᄌ ᅡ ᄋ ᅲ ᄅ ᅦ
맡기고	ᄆ ᅡ ᆮ ᄁ ᅵ ᄀ ᅩ
얘기를	ᄋ ᅤ ᄀ ᅵ ᄅ ᅳ ᆯ
볼까요	ᄇ ᅩ ᆯ ᄁ ᅡ ᄋ ᅭ
관심을	ᄀ ᅪ ᆫ ᄉ ᅵ ᄆ ᅳ ᆯ
갖게	ᄀ ᅡ ᆮ ᄁ ᅦ
계기가	ᄀ ᅨ ᄀ ᅵ ᄀ ᅡ
크면서	ᄏ ᅳ ᄆ ᅧ ᆫ ᄉ ᅥ
하다가	ᄒ ᅡ ᄃ ᅡ ᄀ ᅡ
소액으로	ᄉ ᅩ ᄋ ᅢ ᄀ ᅳ ᄅ ᅩ
하기로	ᄒ ᅡ ᄀ ᅵ ᄅ ᅩ
주거를	ᄌ ᅮ ᄀ ᅥ ᄅ ᅳ ᆯ
소유	ᄉ ᅩ ᄋ ᅲ
보다	ᄇ ᅩ ᄃ ᅡ
거주로	ᄀ ᅥ ᄌ ᅮ ᄅ ᅩ
생각하기	ᄉ ᅢ ᆼ ᄀ ᅡ ᄏ ᅡ ᄀ ᅵ
부동산에는	ᄇ ᅮ ᄃ ᅩ ᆼ ᄉ ᅡ ᄂ ᅦ ᄂ ᅳ ᆫ
적었죠	ᄌ ᅥ ᄀ ᅥ ᆮ ᄍ ᅭ
국제적으로	ᄀ ᅮ ᆨ ᄍ ᅦ ᄌ ᅥ ᄀ ᅳ ᄅ ᅩ
경쟁력	ᄀ ᅧ ᆼ ᄌ ᅢ ᆼ ᄂ ᅧ ᆨ
한국	ᄒ ᅡ ᆫ ᄀ ᅮ ᆨ
기업	ᄀ ᅵ ᄋ ᅥ ᆸ
선택	ᄉ ᅥ ᆫ ᄐ ᅢ ᆨ
활동은	ᄒ ᅪ ᆯ ᄃ ᅩ ᆼ ᄋ ᅳ ᆫ
진행	ᄌ ᅵ ᆫ ᄒ ᅢ ᆼ
생애	ᄉ ᅢ ᆼ ᄋ ᅢ
계좌는	ᄀ ᅨ ᄌ ᅪ ᄂ ᅳ ᆫ
친척으로부터	ᄎ ᅵ ᆫ ᄎ ᅥ ᄀ ᅳ ᄅ ᅩ ᄇ ᅮ ᄐ ᅥ
받은	ᄇ ᅡ ᄃ ᅳ ᆫ
돈으로	ᄃ ᅩ ᄂ ᅳ ᄅ ᅩ
마련	ᄆ ᅡ ᄅ ᅧ ᆫ
이라도	ᄋ ᅵ ᄅ ᅡ ᄃ ᅩ
꾸준히	ᄁ ᅮ ᄌ ᅮ ᆫ ᄒ ᅵ
투자하라는	ᄐ ᅮ ᄌ ᅡ ᄒ ᅡ ᄅ ᅡ ᄂ ᅳ ᆫ
전문가의	ᄌ ᅥ ᆫ ᄆ ᅮ ᆫ ᄀ ᅡ ᄋ ᅴ
참고해	ᄎ ᅡ ᆷ ᄀ ᅩ ᄒ ᅢ
생활비에서	ᄉ ᅢ ᆼ ᄒ ᅪ ᆯ ᄇ ᅵ ᄋ ᅦ ᄉ ᅥ
삼만	ᄉ ᅡ ᆷ ᄆ ᅡ ᆫ
원씩	ᄋ ᅯ ᆫ ᄊ ᅵ ᆨ
펀드에	ᄑ ᅥ ᆫ ᄃ ᅳ ᄋ ᅦ
넣고	ᄂ ᅥ ᄏ ᅩ
초등학생	ᄎ ᅩ ᄃ ᅳ ᆼ ᄒ ᅡ ᆨ ᄊ ᅢ ᆼ
이라	ᄋ ᅵ ᄅ ᅡ
중장기	ᄌ ᅮ ᆼ ᄌ ᅡ ᆼ ᄀ ᅵ
차트에	ᄎ ᅡ ᄐ ᅳ ᄋ ᅦ
어느	ᄋ ᅥ ᄂ ᅳ
정도	ᄌ ᅥ ᆼ ᄃ ᅩ
익숙해져	ᄋ ᅵ ᆨ ᄊ ᅮ ᄏ ᅢ ᄌ ᅥ
그래서	ᄀ ᅳ ᄅ ᅢ ᄉ ᅥ
가치투자라는	ᄀ ᅡ ᄎ ᅵ ᄐ ᅮ ᄌ ᅡ ᄅ ᅡ ᄂ ᅳ ᆫ
용어는	ᄋ ᅭ ᆼ ᄋ ᅥ ᄂ ᅳ ᆫ
종목을	ᄌ ᅩ ᆼ ᄆ ᅩ ᄀ ᅳ ᆯ
사서	ᄉ ᅡ ᄉ ᅥ
비쌀	ᄇ ᅵ ᄊ ᅡ ᆯ
판다는	ᄑ ᅡ ᆫ ᄃ ᅡ ᄂ ᅳ ᆫ
기본은	ᄀ ᅵ ᄇ ᅩ ᄂ ᅳ ᆫ
알아요	ᄋ ᅡ ᄅ ᅡ ᄋ ᅭ
아이와	ᄋ ᅡ ᄋ ᅵ ᄋ ᅪ
종목이란	ᄌ ᅩ ᆼ ᄆ ᅩ ᄀ ᅵ ᄅ ᅡ ᆫ
무엇인가	ᄆ ᅮ ᄋ ᅥ ᄉ ᅵ ᆫ ᄀ ᅡ
쌀	ᄊ ᅡ ᆯ
언제인가	ᄋ ᅥ ᆫ ᄌ ᅦ ᄋ ᅵ ᆫ ᄀ ᅡ
토론하고	ᄐ ᅩ ᄅ ᅩ ᆫ ᄒ ᅡ ᄀ ᅩ
분야는	ᄇ ᅮ ᄂ ᅣ ᄂ ᅳ ᆫ
경쟁력이	ᄀ ᅧ ᆼ ᄌ ᅢ ᆼ ᄂ ᅧ ᄀ ᅵ
업종으로	ᄋ ᅥ ᆸ ᄍ ᅩ ᆼ ᄋ ᅳ ᄅ ᅩ
정했어요	ᄌ ᅥ ᆼ ᄒ ᅢ ᄊ ᅥ ᄋ ᅭ
이게	ᄋ ᅵ ᄀ ᅦ
저희의	ᄌ ᅥ ᄒ ᅵ ᄋ ᅴ
원칙	ᄋ ᅯ ᆫ ᄎ ᅵ ᆨ
정민	ᄌ ᅥ ᆼ ᄆ ᅵ ᆫ
군이	ᄀ ᅮ ᄂ ᅵ
매매를	ᄆ ᅢ ᄆ ᅢ ᄅ ᅳ ᆯ
하나요	ᄒ ᅡ ᄂ ᅡ ᄋ ᅭ
운용사나	ᄋ ᅮ ᄂ ᅭ ᆼ ᄉ ᅡ ᄂ ᅡ
펀드매니저	ᄑ ᅥ ᆫ ᄃ ᅳ ᄆ ᅢ ᄂ ᅵ ᄌ ᅥ
셈이죠	ᄉ ᅦ ᄆ ᅵ ᄌ ᅭ
추천하고	ᄎ ᅮ ᄎ ᅥ ᆫ ᄒ ᅡ ᄀ ᅩ
계좌	ᄀ ᅨ ᄌ ᅪ
운용을	ᄋ ᅮ ᄂ ᅭ ᆼ ᄋ ᅳ ᆯ
아들은	ᄋ ᅡ ᄃ ᅳ ᄅ ᅳ ᆫ
계좌와	ᄀ ᅨ ᄌ ᅪ ᄋ ᅪ
종목의	ᄌ ᅩ ᆼ ᄆ ᅩ ᄀ ᅴ
주가	ᄌ ᅮ ᄀ ᅡ
차트를	ᄎ ᅡ ᄐ ᅳ ᄅ ᅳ ᆯ
밝혀요	ᄇ ᅡ ᆯ ᄏ ᅧ ᄋ ᅭ
싼	ᄊ ᅡ ᆫ
같은데	ᄀ ᅡ ᄐ ᅳ ᆫ ᄃ ᅦ
어때요	ᄋ ᅥ ᄄ ᅢ ᄋ ᅭ
투자라고	ᄐ ᅮ ᄌ ᅡ ᄅ ᅡ ᄀ ᅩ
생각하거나	ᄉ ᅢ ᆼ ᄀ ᅡ ᄏ ᅡ ᄀ ᅥ ᄂ ᅡ
위험한	ᄋ ᅱ ᄒ ᅥ ᆷ ᄒ ᅡ ᆫ
여기는	ᄋ ᅧ ᄀ ᅵ ᄂ ᅳ ᆫ
많아요	ᄆ ᅡ ᄂ ᅡ ᄋ ᅭ
교육의	ᄀ ᅭ ᄋ ᅲ ᄀ ᅴ
생각하는데	ᄉ ᅢ ᆼ ᄀ ᅡ ᄏ ᅡ ᄂ ᅳ ᆫ ᄃ ᅦ
이에	ᄋ ᅵ ᄋ ᅦ
생각하나요	ᄉ ᅢ ᆼ ᄀ ᅡ ᄏ ᅡ ᄂ ᅡ ᄋ ᅭ
산다는	ᄉ ᅡ ᆫ ᄃ ᅡ ᄂ ᅳ ᆫ
비록	ᄇ ᅵ ᄅ ᅩ ᆨ
일부라	ᄋ ᅵ ᆯ ᄇ ᅮ ᄅ ᅡ
기업을	ᄀ ᅵ ᄋ ᅥ ᄇ ᅳ ᆯ
뜻해요	ᄄ ᅳ ᄐ ᅢ ᄋ ᅭ
간접적으로	ᄀ ᅡ ᆫ ᄌ ᅥ ᆸ ᄍ ᅥ ᄀ ᅳ ᄅ ᅩ
것이죠	ᄀ ᅥ ᄉ ᅵ ᄌ ᅭ
소비자에서	ᄉ ᅩ ᄇ ᅵ ᄌ ᅡ ᄋ ᅦ ᄉ ᅥ
생산자	ᄉ ᅢ ᆼ ᄉ ᅡ ᆫ ᄌ ᅡ
입장이	ᄋ ᅵ ᆸ ᄍ ᅡ ᆼ ᄋ ᅵ
체험이에요	ᄎ ᅦ ᄒ ᅥ ᄆ ᅵ ᄋ ᅦ ᄋ ᅭ
자녀의	ᄌ ᅡ ᄂ ᅧ ᄋ ᅴ
투자자금	ᄐ ᅮ ᄌ ᅡ ᄌ ᅡ ᄀ ᅳ ᆷ
마련에	ᄆ ᅡ ᄅ ᅧ ᄂ ᅦ
어머니들에게	ᄋ ᅥ ᄆ ᅥ ᄂ ᅵ ᄃ ᅳ ᄅ ᅦ ᄀ ᅦ
조언	ᄌ ᅩ ᄋ ᅥ ᆫ
해준다면	ᄒ ᅢ ᄌ ᅮ ᆫ ᄃ ᅡ ᄆ ᅧ ᆫ
부모와	ᄇ ᅮ ᄆ ᅩ ᄋ ᅪ
조성하는	ᄌ ᅩ ᄉ ᅥ ᆼ ᄒ ᅡ ᄂ ᅳ ᆫ
봐요	ᄇ ᅪ ᄋ ᅭ
소득	ᄉ ᅩ ᄃ ᅳ ᆨ
마련하고	ᄆ ᅡ ᄅ ᅧ ᆫ ᄒ ᅡ ᄀ ᅩ
일부라도	ᄋ ᅵ ᆯ ᄇ ᅮ ᄅ ᅡ ᄃ ᅩ
노력이	ᄂ ᅩ ᄅ ᅧ ᄀ ᅵ
들어간	ᄃ ᅳ ᄅ ᅥ ᄀ ᅡ ᆫ
돈이	ᄃ ᅩ ᄂ ᅵ
된다는	ᄃ ᅬ ᆫ ᄃ ᅡ ᄂ ᅳ ᆫ
알면	ᄋ ᅡ ᆯ ᄆ ᅧ ᆫ
신중하고	ᄉ ᅵ ᆫ ᄌ ᅮ ᆼ ᄒ ᅡ ᄀ ᅩ
두게	ᄃ ᅮ ᄀ ᅦ
좋을까요	ᄌ ᅩ ᄋ ᅳ ᆯ ᄁ ᅡ ᄋ ᅭ
장난감	ᄌ ᅡ ᆼ ᄂ ᅡ ᆫ ᄀ ᅡ ᆷ
게임	ᄀ ᅦ ᄋ ᅵ ᆷ
먹거리를	ᄆ ᅥ ᆨ ᄁ ᅥ ᄅ ᅵ ᄅ ᅳ ᆯ
만든	ᄆ ᅡ ᆫ ᄃ ᅳ ᆫ
회사부터	ᄒ ᅬ ᄉ ᅡ ᄇ ᅮ ᄐ ᅥ
추천해요	ᄎ ᅮ ᄎ ᅥ ᆫ ᄒ ᅢ ᄋ ᅭ
자기가	ᄌ ᅡ ᄀ ᅵ ᄀ ᅡ
분야에	ᄇ ᅮ ᄂ ᅣ ᄋ ᅦ
주인	ᄌ ᅮ ᄋ ᅵ ᆫ
주주	ᄌ ᅮ ᄌ ᅮ
확실한	ᄒ ᅪ ᆨ ᄊ ᅵ ᆯ ᄒ ᅡ ᆫ
투자와	ᄐ ᅮ ᄌ ᅡ ᄋ ᅪ
동기부여가	ᄃ ᅩ ᆼ ᄀ ᅵ ᄇ ᅮ ᄋ ᅧ ᄀ ᅡ
계획은	ᄀ ᅨ ᄒ ᅬ ᄀ ᅳ ᆫ
공부하면서	ᄀ ᅩ ᆼ ᄇ ᅮ ᄒ ᅡ ᄆ ᅧ ᆫ ᄉ ᅥ
공부를	ᄀ ᅩ ᆼ ᄇ ᅮ ᄅ ᅳ ᆯ
하기에는	ᄒ ᅡ ᄀ ᅵ ᄋ ᅦ ᄂ ᅳ ᆫ
가치	ᄀ ᅡ ᄎ ᅵ
필수라고	ᄑ ᅵ ᆯ ᄉ ᅮ ᄅ ᅡ ᄀ ᅩ
운용	ᄋ ᅮ ᄂ ᅭ ᆼ
하는데	ᄒ ᅡ ᄂ ᅳ ᆫ ᄃ ᅦ
쌓으면	ᄊ ᅡ ᄋ ᅳ ᄆ ᅧ ᆫ
하게	ᄒ ᅡ ᄀ ᅦ
생각	ᄉ ᅢ ᆼ ᄀ ᅡ ᆨ
그전에	ᄀ ᅳ ᄌ ᅥ ᄂ ᅦ
자금을	ᄌ ᅡ ᄀ ᅳ ᄆ ᅳ ᆯ
관리	ᄀ ᅪ ᆯ ᄅ ᅵ
운용하는	ᄋ ᅮ ᄂ ᅭ ᆼ ᄒ ᅡ ᄂ ᅳ ᆫ
방법과	ᄇ ᅡ ᆼ ᄇ ᅥ ᆸ ᄁ ᅪ
마인드에	ᄆ ᅡ ᄋ ᅵ ᆫ ᄃ ᅳ ᄋ ᅦ
들어가야겠죠	ᄃ ᅳ ᄅ ᅥ ᄀ ᅡ ᄋ ᅣ ᄀ ᅦ ᆮ ᄍ ᅭ
싶어하는	ᄉ ᅵ ᄑ ᅥ ᄒ ᅡ ᄂ ᅳ ᆫ
어머니들이	ᄋ ᅥ ᄆ ᅥ ᄂ ᅵ ᄃ ᅳ ᄅ ᅵ
많은데	ᄆ ᅡ ᄂ ᅳ ᆫ ᄃ ᅦ
호소해요	ᄒ ᅩ ᄉ ᅩ ᄒ ᅢ ᄋ ᅭ
방법이	ᄇ ᅡ ᆼ ᄇ ᅥ ᄇ ᅵ
없을까요	ᄋ ᅥ ᆸ ᄊ ᅳ ᆯ ᄁ ᅡ ᄋ ᅭ
나누는	ᄂ ᅡ ᄂ ᅮ ᄂ ᅳ ᆫ
것이라고	ᄀ ᅥ ᄉ ᅵ ᄅ ᅡ ᄀ ᅩ
새벽에	ᄉ ᅢ ᄇ ᅧ ᄀ ᅦ
일어나서	ᄋ ᅵ ᄅ ᅥ ᄂ ᅡ ᄉ ᅥ
읽었어요	ᄋ ᅵ ᆯ ᄀ ᅥ ᄊ ᅥ ᄋ ᅭ
맨큐의	ᄆ ᅢ ᆫ ᄏ ᅲ ᄋ ᅴ
경제학	ᄀ ᅧ ᆼ ᄌ ᅦ ᄒ ᅡ ᆨ
대학	ᄃ ᅢ ᄒ ᅡ ᆨ
교제도	ᄀ ᅭ ᄌ ᅦ ᄃ ᅩ
읽었죠	ᄋ ᅵ ᆯ ᄀ ᅥ ᆮ ᄍ ᅭ
요약하고	ᄋ ᅭ ᄋ ᅣ ᄏ ᅡ ᄀ ᅩ
모임에	ᄆ ᅩ ᄋ ᅵ ᄆ ᅦ
가입해서	ᄀ ᅡ ᄋ ᅵ ᄑ ᅢ ᄉ ᅥ
발표하고	ᄇ ᅡ ᆯ ᄑ ᅭ ᄒ ᅡ ᄀ ᅩ
토론을	ᄐ ᅩ ᄅ ᅩ ᄂ ᅳ ᆯ
이끌었어요	ᄋ ᅵ ᄁ ᅳ ᄅ ᅥ ᄊ ᅥ ᄋ ᅭ
요즘에는	ᄋ ᅭ ᄌ ᅳ ᄆ ᅦ ᄂ ᅳ ᆫ
유튜브나	ᄋ ᅲ ᄐ ᅲ ᄇ ᅳ ᄂ ᅡ
팟캐스트	ᄑ ᅡ ᆮ ᄏ ᅢ ᄉ ᅳ ᄐ ᅳ
컨텐츠가	ᄏ ᅥ ᆫ ᄐ ᅦ ᆫ ᄎ ᅳ ᄀ ᅡ
집안일	ᄌ ᅵ ᄇ ᅡ ᄂ ᅵ ᆯ
요리하면서	ᄋ ᅭ ᄅ ᅵ ᄒ ᅡ ᄆ ᅧ ᆫ ᄉ ᅥ
유튜브	ᄋ ᅲ ᄐ ᅲ ᄇ ᅳ
채널에	ᄎ ᅢ ᄂ ᅥ ᄅ ᅦ
구독을	ᄀ ᅮ ᄃ ᅩ ᄀ ᅳ ᆯ
추천	ᄎ ᅮ ᄎ ᅥ ᆫ
경제신문의	ᄀ ᅧ ᆼ ᄌ ᅦ ᄉ ᅵ ᆫ ᄆ ᅮ ᄂ ᅴ
활용	ᄒ ᅪ ᄅ ᅭ ᆼ
소개해	ᄉ ᅩ ᄀ ᅢ ᄒ ᅢ
주신다면	ᄌ ᅮ ᄉ ᅵ ᆫ ᄃ ᅡ ᄆ ᅧ ᆫ
배우려면	ᄇ ᅢ ᄋ ᅮ ᄅ ᅧ ᄆ ᅧ ᆫ
지치지	ᄌ ᅵ ᄎ ᅵ ᄌ ᅵ
않게	ᄋ ᅡ ᆫ ᄏ ᅦ
중요해요	ᄌ ᅮ ᆼ ᄋ ᅭ ᄒ ᅢ ᄋ ᅭ
꼼꼼히	ᄁ ᅩ ᆷ ᄁ ᅩ ᆷ ᄒ ᅵ
읽도록	ᄋ ᅵ ᆨ ᄄ ᅩ ᄅ ᅩ ᆨ
두고	ᄃ ᅮ ᄀ ᅩ
평일	ᄑ ᅧ ᆼ ᄋ ᅵ ᆯ
장씩	ᄌ ᅡ ᆼ ᄊ ᅵ ᆨ
내어	ᄂ ᅢ ᄋ ᅥ
또박또박	ᄄ ᅩ ᄇ ᅡ ᆨ ᄄ ᅩ ᄇ ᅡ ᆨ
그것을	ᄀ ᅳ ᄀ ᅥ ᄉ ᅳ ᆯ
녹음하게	ᄂ ᅩ ᄀ ᅳ ᆷ ᄒ ᅡ ᄀ ᅦ
읽으며	ᄋ ᅵ ᆯ ᄀ ᅳ ᄆ ᅧ
독서	ᄃ ᅩ ᆨ ᄊ ᅥ
훈련까지	ᄒ ᅮ ᆯ ᄅ ᅧ ᆫ ᄁ ᅡ ᄌ ᅵ
겸	ᄀ ᅧ ᆷ
홍정민	ᄒ ᅩ ᆼ ᄌ ᅥ ᆼ ᄆ ᅵ ᆫ
군	ᄀ ᅮ ᆫ
레모네이드	ᄅ ᅦ ᄆ ᅩ ᄂ ᅦ ᄋ ᅵ ᄃ ᅳ
사업에도	ᄉ ᅡ ᄋ ᅥ ᄇ ᅦ ᄃ ᅩ
가지면서	ᄀ ᅡ ᄌ ᅵ ᄆ ᅧ ᆫ ᄉ ᅥ
달라진	ᄃ ᅡ ᆯ ᄅ ᅡ ᄌ ᅵ ᆫ
부	ᄇ ᅮ
터	ᄐ ᅥ
경제에	ᄀ ᅧ ᆼ ᄌ ᅦ ᄋ ᅦ
커졌어요	ᄏ ᅥ ᄌ ᅥ ᄊ ᅥ ᄋ ᅭ
배우지	ᄇ ᅢ ᄋ ᅮ ᄌ ᅵ
또래들에게	ᄄ ᅩ ᄅ ᅢ ᄃ ᅳ ᄅ ᅦ ᄀ ᅦ
해주고	ᄒ ᅢ ᄌ ᅮ ᄀ ᅩ
싶은	ᄉ ᅵ ᄑ ᅳ ᆫ
하라고	ᄒ ᅡ ᄅ ᅡ ᄀ ᅩ
싶어요	ᄉ ᅵ ᄑ ᅥ ᄋ ᅭ
어렵게	ᄋ ᅥ ᄅ ᅧ ᆸ ᄁ ᅦ
느껴질	ᄂ ᅳ ᄁ ᅧ ᄌ ᅵ ᆯ
조금만	ᄌ ᅩ ᄀ ᅳ ᆷ ᄆ ᅡ ᆫ
상식이	ᄉ ᅡ ᆼ ᄉ ᅵ ᄀ ᅵ
한번	ᄒ ᅡ ᆫ ᄇ ᅥ ᆫ
해보세요	ᄒ ᅢ ᄇ ᅩ ᄉ ᅦ ᄋ ᅭ
생겨요	ᄉ ᅢ ᆼ ᄀ ᅧ ᄋ ᅭ
물론	ᄆ ᅮ ᆯ ᄅ ᅩ ᆫ
버는	ᄇ ᅥ ᄂ ᅳ ᆫ
재미도	ᄌ ᅢ ᄆ ᅵ ᄃ ᅩ
방법	ᄇ ᅡ ᆼ ᄇ ᅥ ᆸ
가지를	ᄀ ᅡ ᄌ ᅵ ᄅ ᅳ ᆯ
배울	ᄇ ᅢ ᄋ ᅮ ᆯ
활동에도	ᄒ ᅪ ᆯ ᄃ ᅩ ᆼ ᄋ ᅦ ᄃ ᅩ
하던데	ᄒ ᅡ ᄃ ᅥ ᆫ ᄃ ᅦ
책으로	ᄎ ᅢ ᄀ ᅳ ᄅ ᅩ
그리고	ᄀ ᅳ ᄅ ᅵ ᄀ ᅩ
사태가	ᄉ ᅡ ᄐ ᅢ ᄀ ᅡ
끝나면	ᄁ ᅳ ᆫ ᄂ ᅡ ᄆ ᅧ ᆫ
모은	ᄆ ᅩ ᄋ ᅳ ᆫ
용돈으로	ᄋ ᅭ ᆼ ᄃ ᅩ ᄂ ᅳ ᄅ ᅩ
레모네이드를	ᄅ ᅦ ᄆ ᅩ ᄂ ᅦ ᄋ ᅵ ᄃ ᅳ ᄅ ᅳ ᆯ
만들어	ᄆ ᅡ ᆫ ᄃ ᅳ ᄅ ᅥ
생각이에요	ᄉ ᅢ ᆼ ᄀ ᅡ ᄀ ᅵ ᄋ ᅦ ᄋ ᅭ
헤드셋을	ᄒ ᅦ ᄃ ᅳ ᄉ ᅦ ᄉ ᅳ ᆯ
사려면	ᄉ ᅡ ᄅ ᅧ ᄆ ᅧ ᆫ
용돈으로는	ᄋ ᅭ ᆼ ᄃ ᅩ ᄂ ᅳ ᄅ ᅩ ᄂ ᅳ ᆫ
부족	ᄇ ᅮ ᄌ ᅩ ᆨ
하거든요	ᄒ ᅡ ᄀ ᅥ ᄃ ᅳ ᄂ ᅭ
공공	ᄀ ᅩ ᆼ ᄀ ᅩ ᆼ
출하	ᄎ ᅮ ᆯ ᄒ ᅡ
포기	ᄑ ᅩ ᄀ ᅵ
줄이기	ᄌ ᅮ ᄅ ᅵ ᄀ ᅵ
포기라는	ᄑ ᅩ ᄀ ᅵ ᄅ ᅡ ᄂ ᅳ ᆫ
농산물이	ᄂ ᅩ ᆼ ᄉ ᅡ ᆫ ᄆ ᅮ ᄅ ᅵ
생산되서	ᄉ ᅢ ᆼ ᄉ ᅡ ᆫ ᄃ ᅬ ᄉ ᅥ
가격이	ᄀ ᅡ ᄀ ᅧ ᄀ ᅵ
지나치게	ᄌ ᅵ ᄂ ᅡ ᄎ ᅵ ᄀ ᅦ
낮아졌을	ᄂ ᅡ ᄌ ᅡ ᄌ ᅥ ᄊ ᅳ ᆯ
농민들이	ᄂ ᅩ ᆼ ᄆ ᅵ ᆫ ᄃ ᅳ ᄅ ᅵ
작물을	ᄌ ᅡ ᆼ ᄆ ᅮ ᄅ ᅳ ᆯ
시장에	ᄉ ᅵ ᄌ ᅡ ᆼ ᄋ ᅦ
내놓는	ᄂ ᅢ ᄂ ᅩ ᆫ ᄂ ᅳ ᆫ
포기하고	ᄑ ᅩ ᄀ ᅵ ᄒ ᅡ ᄀ ᅩ
밭을	ᄇ ᅡ ᄐ ᅳ ᆯ
작물	ᄌ ᅡ ᆼ ᄆ ᅮ ᆯ
채로	ᄎ ᅢ ᄅ ᅩ
갈아엎는	ᄀ ᅡ ᄅ ᅡ ᄋ ᅥ ᆷ ᄂ ᅳ ᆫ
말하죠	ᄆ ᅡ ᆯ ᄒ ᅡ ᄌ ᅭ
수확	ᄉ ᅮ ᄒ ᅪ ᆨ
익은	ᄋ ᅵ ᄀ ᅳ ᆫ
농작물을	ᄂ ᅩ ᆼ ᄌ ᅡ ᆼ ᄆ ᅮ ᄅ ᅳ ᆯ
거두어들임	ᄀ ᅥ ᄃ ᅮ ᄋ ᅥ ᄃ ᅳ ᄅ ᅵ ᆷ
기른	ᄀ ᅵ ᄅ ᅳ ᆫ
폐기하기	ᄑ ᅨ ᄀ ᅵ ᄒ ᅡ ᄀ ᅵ
언론에서는	ᄋ ᅥ ᆯ ᄅ ᅩ ᄂ ᅦ ᄉ ᅥ ᄂ ᅳ ᆫ
현장	ᄒ ᅧ ᆫ ᄌ ᅡ ᆼ
패기라고	ᄑ ᅢ ᄀ ᅵ ᄅ ᅡ ᄀ ᅩ
표현하기도	ᄑ ᅭ ᄒ ᅧ ᆫ ᄒ ᅡ ᄀ ᅵ ᄃ ᅩ
가격의	ᄀ ᅡ ᄀ ᅧ ᄀ ᅴ
차이가	ᄎ ᅡ ᄋ ᅵ ᄀ ᅡ
날까요	ᄂ ᅡ ᆯ ᄁ ᅡ ᄋ ᅭ
농산물은	ᄂ ᅩ ᆼ ᄉ ᅡ ᆫ ᄆ ᅮ ᄅ ᅳ ᆫ
자라	ᄌ ᅡ ᄅ ᅡ
상품이	ᄉ ᅡ ᆼ ᄑ ᅮ ᄆ ᅵ
되기까지	ᄃ ᅬ ᄀ ᅵ ᄁ ᅡ ᄌ ᅵ
걸리고	ᄀ ᅥ ᆯ ᄅ ᅵ ᄀ ᅩ
외부	ᄋ ᅬ ᄇ ᅮ
환경에	ᄒ ᅪ ᆫ ᄀ ᅧ ᆼ ᄋ ᅦ
생산량이	ᄉ ᅢ ᆼ ᄉ ᅡ ᆫ ᄂ ᅣ ᆼ ᄋ ᅵ
영향	ᄋ ᅧ ᆼ ᄒ ᅣ ᆼ
받아요	ᄇ ᅡ ᄃ ᅡ ᄋ ᅭ
게다가	ᄀ ᅦ ᄃ ᅡ ᄀ ᅡ
오래	ᄋ ᅩ ᄅ ᅢ
보관하기도	ᄇ ᅩ ᄀ ᅪ ᆫ ᄒ ᅡ ᄀ ᅵ ᄃ ᅩ
힘들죠	ᄒ ᅵ ᆷ ᄃ ᅳ ᆯ ᄌ ᅭ
즉	ᄌ ᅳ ᆨ
농작물은	ᄂ ᅩ ᆼ ᄌ ᅡ ᆼ ᄆ ᅮ ᄅ ᅳ ᆫ
공급량과	ᄀ ᅩ ᆼ ᄀ ᅳ ᆷ ᄂ ᅣ ᆼ ᄀ ᅪ
수요량을	ᄉ ᅮ ᄋ ᅭ ᄅ ᅣ ᆼ ᄋ ᅳ ᆯ
예상하고	ᄋ ᅨ ᄉ ᅡ ᆼ ᄒ ᅡ ᄀ ᅩ
조정하는	ᄌ ᅩ ᄌ ᅥ ᆼ ᄒ ᅡ ᄂ ᅳ ᆫ
어려워요	ᄋ ᅥ ᄅ ᅧ ᄋ ᅯ ᄋ ᅭ
작물이든	ᄌ ᅡ ᆼ ᄆ ᅮ ᄅ ᅵ ᄃ ᅳ ᆫ
포기가	ᄑ ᅩ ᄀ ᅵ ᄀ ᅡ
반복되는	ᄇ ᅡ ᆫ ᄇ ᅩ ᆨ ᄄ ᅬ ᄂ ᅳ ᆫ
이유	ᄋ ᅵ ᄋ ᅲ
유통	ᄋ ᅲ ᄐ ᅩ ᆼ
비용	ᄇ ᅵ ᄋ ᅭ ᆼ
문제	ᄆ ᅮ ᆫ ᄌ ᅦ
다룰	ᄃ ᅡ ᄅ ᅮ ᆯ
농민은	ᄂ ᅩ ᆼ ᄆ ᅵ ᄂ ᅳ ᆫ
싸져	ᄊ ᅡ ᄌ ᅥ
현지에서	ᄒ ᅧ ᆫ ᄌ ᅵ ᄋ ᅦ ᄉ ᅥ
폐기하는데	ᄑ ᅨ ᄀ ᅵ ᄒ ᅡ ᄂ ᅳ ᆫ ᄃ ᅦ
정작	ᄌ ᅥ ᆼ ᄌ ᅡ ᆨ
소비자가	ᄉ ᅩ ᄇ ᅵ ᄌ ᅡ ᄀ ᅡ
사먹는	ᄉ ᅡ ᄆ ᅥ ᆼ ᄂ ᅳ ᆫ
농산물의	ᄂ ᅩ ᆼ ᄉ ᅡ ᆫ ᄆ ᅮ ᄅ ᅴ
판매가는	ᄑ ᅡ ᆫ ᄆ ᅢ ᄀ ᅡ ᄂ ᅳ ᆫ
내려가지	ᄂ ᅢ ᄅ ᅧ ᄀ ᅡ ᄌ ᅵ
않았다는	ᄋ ᅡ ᄂ ᅡ ᆮ ᄄ ᅡ ᄂ ᅳ ᆫ
불만이죠	ᄇ ᅮ ᆯ ᄆ ᅡ ᄂ ᅵ ᄌ ᅭ
원인으로	ᄋ ᅯ ᄂ ᅵ ᄂ ᅳ ᄅ ᅩ
언급되는	ᄋ ᅥ ᆫ ᄀ ᅳ ᆸ ᄄ ᅬ ᄂ ᅳ ᆫ
유통비용	ᄋ ᅲ ᄐ ᅩ ᆼ ᄇ ᅵ ᄋ ᅭ ᆼ
도매상인은	ᄃ ᅩ ᄆ ᅢ ᄉ ᅡ ᆼ ᄋ ᅵ ᄂ ᅳ ᆫ
농민에게서	ᄂ ᅩ ᆼ ᄆ ᅵ ᄂ ᅦ ᄀ ᅦ ᄉ ᅥ
농산물을	ᄂ ᅩ ᆼ ᄉ ᅡ ᆫ ᄆ ᅮ ᄅ ᅳ ᆯ
운반해	ᄋ ᅮ ᆫ ᄇ ᅡ ᆫ ᄒ ᅢ
대량으로	ᄃ ᅢ ᄅ ᅣ ᆼ ᄋ ᅳ ᄅ ᅩ
팔고	ᄑ ᅡ ᆯ ᄀ ᅩ
구매	ᄀ ᅮ ᄆ ᅢ
상인이	ᄉ ᅡ ᆼ ᄋ ᅵ ᄂ ᅵ
이를	ᄋ ᅵ ᄅ ᅳ ᆯ
나른	ᄂ ᅡ ᄅ ᅳ ᆫ
소비자에게	ᄉ ᅩ ᄇ ᅵ ᄌ ᅡ ᄋ ᅦ ᄀ ᅦ
으로	ᄋ ᅳ ᄅ ᅩ
나눠	ᄂ ᅡ ᄂ ᅯ
팔죠	ᄑ ᅡ ᆯ ᄌ ᅭ
생산자와	ᄉ ᅢ ᆼ ᄉ ᅡ ᆫ ᄌ ᅡ ᄋ ᅪ
소비자	ᄉ ᅩ ᄇ ᅵ ᄌ ᅡ
사이에서	ᄉ ᅡ ᄋ ᅵ ᄋ ᅦ ᄉ ᅥ
이동하는	ᄋ ᅵ ᄃ ᅩ ᆼ ᄒ ᅡ ᄂ ᅳ ᆫ
과정을	ᄀ ᅪ ᄌ ᅥ ᆼ ᄋ ᅳ ᆯ
유통이라고	ᄋ ᅲ ᄐ ᅩ ᆼ ᄋ ᅵ ᄅ ᅡ ᄀ ᅩ
그런데	ᄀ ᅳ ᄅ ᅥ ᆫ ᄃ ᅦ
우리나라는	ᄋ ᅮ ᄅ ᅵ ᄂ ᅡ ᄅ ᅡ ᄂ ᅳ ᆫ
상인을	ᄉ ᅡ ᆼ ᄋ ᅵ ᄂ ᅳ ᆯ
거치다	ᄀ ᅥ ᄎ ᅵ ᄃ ᅡ
생산지의	ᄉ ᅢ ᆼ ᄉ ᅡ ᆫ ᄌ ᅵ ᄋ ᅴ
내려가도	ᄂ ᅢ ᄅ ᅧ ᄀ ᅡ ᄃ ᅩ
판매가엔	ᄑ ᅡ ᆫ ᄆ ᅢ ᄀ ᅡ ᄋ ᅦ ᆫ
반영되지	ᄇ ᅡ ᄂ ᅧ ᆼ ᄃ ᅬ ᄌ ᅵ
않는다는	ᄋ ᅡ ᆫ ᄂ ᅳ ᆫ ᄃ ᅡ ᄂ ᅳ ᆫ
얘기죠	ᄋ ᅤ ᄀ ᅵ ᄌ ᅭ
원래는	ᄋ ᅯ ᆯ ᄅ ᅢ ᄂ ᅳ ᆫ
싸지면	ᄊ ᅡ ᄌ ᅵ ᄆ ᅧ ᆫ
수요량이	ᄉ ᅮ ᄋ ᅭ ᄅ ᅣ ᆼ ᄋ ᅵ
충분히	ᄎ ᅮ ᆼ ᄇ ᅮ ᆫ ᄒ ᅵ
늘지	ᄂ ᅳ ᆯ ᄌ ᅵ
그만큼	ᄀ ᅳ ᄆ ᅡ ᆫ ᄏ ᅳ ᆷ
오르려는	ᄋ ᅩ ᄅ ᅳ ᄅ ᅧ ᄂ ᅳ ᆫ
힘도	ᄒ ᅵ ᆷ ᄃ ᅩ
약해집니다	ᄋ ᅣ ᄏ ᅢ ᄌ ᅵ ᆷ ᄂ ᅵ ᄃ ᅡ
농민도	ᄂ ᅩ ᆼ ᄆ ᅵ ᆫ ᄃ ᅩ
소비자도	ᄉ ᅩ ᄇ ᅵ ᄌ ᅡ ᄃ ᅩ
울상입니다	ᄋ ᅮ ᆯ ᄉ ᅡ ᆼ ᄋ ᅵ ᆷ ᄂ ᅵ ᄃ ᅡ
시스템	ᄉ ᅵ ᄉ ᅳ ᄐ ᅦ ᆷ
구축	ᄀ ᅮ ᄎ ᅮ ᆨ
해결할	ᄒ ᅢ ᄀ ᅧ ᆯ ᄒ ᅡ ᆯ
문제부터	ᄆ ᅮ ᆫ ᄌ ᅦ ᄇ ᅮ ᄐ ᅥ
생산량은	ᄉ ᅢ ᆼ ᄉ ᅡ ᆫ ᄂ ᅣ ᆼ ᄋ ᅳ ᆫ
환경의	ᄒ ᅪ ᆫ ᄀ ᅧ ᆼ ᄋ ᅴ
영향을	ᄋ ᅧ ᆼ ᄒ ᅣ ᆼ ᄋ ᅳ ᆯ
얘기했죠	ᄋ ᅤ ᄀ ᅵ ᄒ ᅢ ᆮ ᄍ ᅭ
전국	ᄌ ᅥ ᆫ ᄀ ᅮ ᆨ
각지에서	ᄀ ᅡ ᆨ ᄍ ᅵ ᄋ ᅦ ᄉ ᅥ
소규모로	ᄉ ᅩ ᄀ ᅲ ᄆ ᅩ ᄅ ᅩ
농사를	ᄂ ᅩ ᆼ ᄉ ᅡ ᄅ ᅳ ᆯ
짓는	ᄌ ᅵ ᆫ ᄂ ᅳ ᆫ
우리나라의	ᄋ ᅮ ᄅ ᅵ ᄂ ᅡ ᄅ ᅡ ᄋ ᅴ
농업의	ᄂ ᅩ ᆼ ᄋ ᅥ ᄇ ᅴ
특성	ᄐ ᅳ ᆨ ᄊ ᅥ ᆼ
유행까지	ᄋ ᅲ ᄒ ᅢ ᆼ ᄁ ᅡ ᄌ ᅵ
해져요	ᄒ ᅢ ᄌ ᅥ ᄋ ᅭ
정리하면	ᄌ ᅥ ᆼ ᄂ ᅵ ᄒ ᅡ ᄆ ᅧ ᆫ
농작물의	ᄂ ᅩ ᆼ ᄌ ᅡ ᆼ ᄆ ᅮ ᄅ ᅴ
소비자인	ᄉ ᅩ ᄇ ᅵ ᄌ ᅡ ᄋ ᅵ ᆫ
국민에게도	ᄀ ᅮ ᆼ ᄆ ᅵ ᄂ ᅦ ᄀ ᅦ ᄃ ᅩ
이득이	ᄋ ᅵ ᄃ ᅳ ᄀ ᅵ
돌아	ᄃ ᅩ ᄅ ᅡ
갑니다	ᄀ ᅡ ᆷ ᄂ ᅵ ᄃ ᅡ
유통과정을	ᄋ ᅲ ᄐ ᅩ ᆼ ᄀ ᅪ ᄌ ᅥ ᆼ ᄋ ᅳ ᆯ
개선하는	ᄀ ᅢ ᄉ ᅥ ᆫ ᄒ ᅡ ᄂ ᅳ ᆫ
이유죠	ᄋ ᅵ ᄋ ᅲ ᄌ ᅭ
단계를	ᄃ ᅡ ᆫ ᄀ ᅨ ᄅ ᅳ ᆯ
줄여라	ᄌ ᅮ ᄅ ᅧ ᄅ ᅡ
산지직송이나	ᄉ ᅡ ᆫ ᄌ ᅵ ᄌ ᅵ ᆨ ᄊ ᅩ ᆼ ᄋ ᅵ ᄂ ᅡ
직거래	ᄌ ᅵ ᆨ ᄁ ᅥ ᄅ ᅢ
표현을	ᄑ ᅭ ᄒ ᅧ ᄂ ᅳ ᆯ
들어본	ᄃ ᅳ ᄅ ᅥ ᄇ ᅩ ᆫ
적	ᄌ ᅥ ᆨ
생산지에서	ᄉ ᅢ ᆼ ᄉ ᅡ ᆫ ᄌ ᅵ ᄋ ᅦ ᄉ ᅥ
곧바로	ᄀ ᅩ ᆮ ᄈ ᅡ ᄅ ᅩ
가져왔다는	ᄀ ᅡ ᄌ ᅥ ᄋ ᅪ ᆮ ᄄ ᅡ ᄂ ᅳ ᆫ
뜻이에요	ᄄ ᅳ ᄉ ᅵ ᄋ ᅦ ᄋ ᅭ
유통단계를	ᄋ ᅲ ᄐ ᅩ ᆼ ᄃ ᅡ ᆫ ᄀ ᅨ ᄅ ᅳ ᆯ
적게	ᄌ ᅥ ᆨ ᄁ ᅦ
거쳤으니	ᄀ ᅥ ᄎ ᅥ ᄊ ᅳ ᄂ ᅵ
싸고	ᄊ ᅡ ᄀ ᅩ
신선하다는	ᄉ ᅵ ᆫ ᄉ ᅥ ᆫ ᄒ ᅡ ᄃ ᅡ ᄂ ᅳ ᆫ
의미가	ᄋ ᅴ ᄆ ᅵ ᄀ ᅡ
담겨	ᄃ ᅡ ᆷ ᄀ ᅧ
개선책도	ᄀ ᅢ ᄉ ᅥ ᆫ ᄎ ᅢ ᆨ ᄄ ᅩ
줄이는	ᄌ ᅮ ᄅ ᅵ ᄂ ᅳ ᆫ
생산자에게서	ᄉ ᅢ ᆼ ᄉ ᅡ ᆫ ᄌ ᅡ ᄋ ᅦ ᄀ ᅦ ᄉ ᅥ
소비자까지	ᄉ ᅩ ᄇ ᅵ ᄌ ᅡ ᄁ ᅡ ᄌ ᅵ
거치는	ᄀ ᅥ ᄎ ᅵ ᄂ ᅳ ᆫ
상인의	ᄉ ᅡ ᆼ ᄋ ᅵ ᄂ ᅴ
단계가	ᄃ ᅡ ᆫ ᄀ ᅨ ᄀ ᅡ
적을수록	ᄌ ᅥ ᄀ ᅳ ᆯ ᄊ ᅮ ᄅ ᅩ ᆨ
싸지기	ᄊ ᅡ ᄌ ᅵ ᄀ ᅵ
때문이죠	ᄄ ᅢ ᄆ ᅮ ᄂ ᅵ ᄌ ᅭ
농산물	ᄂ ᅩ ᆼ ᄉ ᅡ ᆫ ᄆ ᅮ ᆯ
거래소	ᄀ ᅥ ᄅ ᅢ ᄉ ᅩ
십구년	ᄉ ᅵ ᆸ ᄁ ᅮ ᄂ ᅧ ᆫ
이십칠일	ᄋ ᅵ ᄉ ᅵ ᆸ ᄎ ᅵ ᄅ ᅵ ᆯ
농림축산식품부는	ᄂ ᅩ ᆼ ᄂ ᅵ ᆷ ᄎ ᅮ ᆨ ᄊ ᅡ ᆫ ᄉ ᅵ ᆨ ᄑ ᅮ ᆷ ᄇ ᅮ ᄂ ᅳ ᆫ
농협과	ᄂ ᅩ ᆼ ᄒ ᅧ ᆸ ᄁ ᅪ
거래소를	ᄀ ᅥ ᄅ ᅢ ᄉ ᅩ ᄅ ᅳ ᆯ
었어요	ᄋ ᅥ ᄊ ᅥ ᄋ ᅭ
온라인으로	ᄋ ᅩ ᆯ ᄅ ᅡ ᄋ ᅵ ᄂ ᅳ ᄅ ᅩ
상품을	ᄉ ᅡ ᆼ ᄑ ᅮ ᄆ ᅳ ᆯ
대량	ᄃ ᅢ ᄅ ᅣ ᆼ
아닌	ᄋ ᅡ ᄂ ᅵ ᆫ
상인에게	ᄉ ᅡ ᆼ ᄋ ᅵ ᄂ ᅦ ᄀ ᅦ
파는	ᄑ ᅡ ᄂ ᅳ ᆫ
유통하는	ᄋ ᅲ ᄐ ᅩ ᆼ ᄒ ᅡ ᄂ ᅳ ᆫ
사이트죠	ᄉ ᅡ ᄋ ᅵ ᄐ ᅳ ᄌ ᅭ
상인은	ᄉ ᅡ ᆼ ᄋ ᅵ ᄂ ᅳ ᆫ
직배송	ᄌ ᅵ ᆨ ᄈ ᅢ ᄉ ᅩ ᆼ
정부는	ᄌ ᅥ ᆼ ᄇ ᅮ ᄂ ᅳ ᆫ
중간	ᄌ ᅮ ᆼ ᄀ ᅡ ᆫ
줄여서	ᄌ ᅮ ᄅ ᅧ ᄉ ᅥ
유통비용을	ᄋ ᅲ ᄐ ᅩ ᆼ ᄇ ᅵ ᄋ ᅭ ᆼ ᄋ ᅳ ᆯ
싸게	ᄊ ᅡ ᄀ ᅦ
만들고	ᄆ ᅡ ᆫ ᄃ ᅳ ᆯ ᄀ ᅩ
신선도는	ᄉ ᅵ ᆫ ᄉ ᅥ ᆫ ᄃ ᅩ ᄂ ᅳ ᆫ
높일	ᄂ ᅩ ᄑ ᅵ ᆯ
양파와	ᄋ ᅣ ᆼ ᄑ ᅡ ᄋ ᅪ
마늘을	ᄆ ᅡ ᄂ ᅳ ᄅ ᅳ ᆯ
거래하고	ᄀ ᅥ ᄅ ᅢ ᄒ ᅡ ᄀ ᅩ
이천	ᄋ ᅵ ᄎ ᅥ ᆫ
이년까지	ᄋ ᅵ ᄂ ᅧ ᆫ ᄁ ᅡ ᄌ ᅵ
다루는	ᄃ ᅡ ᄅ ᅮ ᄂ ᅳ ᆫ
종류와	ᄌ ᅩ ᆼ ᄂ ᅲ ᄋ ᅪ
양을	ᄋ ᅣ ᆼ ᄋ ᅳ ᆯ
늘려	ᄂ ᅳ ᆯ ᄅ ᅧ
계획	ᄀ ᅨ ᄒ ᅬ ᆨ
유통업체	ᄋ ᅲ ᄐ ᅩ ᆼ ᄋ ᅥ ᆸ ᄎ ᅦ
지자체와	ᄌ ᅵ ᄌ ᅡ ᄎ ᅦ ᄋ ᅪ
손	ᄉ ᅩ ᆫ
잡아	ᄌ ᅡ ᄇ ᅡ
유통업체가	ᄋ ᅲ ᄐ ᅩ ᆼ ᄋ ᅥ ᆸ ᄎ ᅦ ᄀ ᅡ
지방자치단체와	ᄌ ᅵ ᄇ ᅡ ᆼ ᄌ ᅡ ᄎ ᅵ ᄃ ᅡ ᆫ ᄎ ᅦ ᄋ ᅪ
협력해서	ᄒ ᅧ ᆷ ᄂ ᅧ ᄏ ᅢ ᄉ ᅥ
직통	ᄌ ᅵ ᆨ ᄐ ᅩ ᆼ
경로를	ᄀ ᅧ ᆼ ᄂ ᅩ ᄅ ᅳ ᆯ
만들겠다고	ᄆ ᅡ ᆫ ᄃ ᅳ ᆯ ᄀ ᅦ ᆮ ᄄ ᅡ ᄀ ᅩ
밝혔어요	ᄇ ᅡ ᆯ ᄏ ᅧ ᄊ ᅥ ᄋ ᅭ
업체는	ᄋ ᅥ ᆸ ᄎ ᅦ ᄂ ᅳ ᆫ
과거의	ᄀ ᅪ ᄀ ᅥ ᄋ ᅴ
기록을	ᄀ ᅵ ᄅ ᅩ ᄀ ᅳ ᆯ
참고	ᄎ ᅡ ᆷ ᄀ ᅩ
특정	ᄐ ᅳ ᆨ ᄍ ᅥ ᆼ
작황을	ᄌ ᅡ ᄏ ᅪ ᆼ ᄋ ᅳ ᆯ
최대한	ᄎ ᅬ ᄃ ᅢ ᄒ ᅡ ᆫ
정확히	ᄌ ᅥ ᆼ ᄒ ᅪ ᄏ ᅵ
자치단체와	ᄌ ᅡ ᄎ ᅵ ᄃ ᅡ ᆫ ᄎ ᅦ ᄋ ᅪ
계약을	ᄀ ᅨ ᄋ ᅣ ᄀ ᅳ ᆯ
맺을	ᄆ ᅢ ᄌ ᅳ ᆯ
계획입니다	ᄀ ᅨ ᄒ ᅬ ᄀ ᅵ ᆷ ᄂ ᅵ ᄃ ᅡ
협력을	ᄒ ᅧ ᆷ ᄂ ᅧ ᄀ ᅳ ᆯ
모두가	ᄆ ᅩ ᄃ ᅮ ᄀ ᅡ
상생	ᄉ ᅡ ᆼ ᄉ ᅢ ᆼ
거라고	ᄀ ᅥ ᄅ ᅡ ᄀ ᅩ
기대했어요	ᄀ ᅵ ᄃ ᅢ ᄒ ᅢ ᄊ ᅥ ᄋ ᅭ
지방자치단체의	ᄌ ᅵ ᄇ ᅡ ᆼ ᄌ ᅡ ᄎ ᅵ ᄃ ᅡ ᆫ ᄎ ᅦ ᄋ ᅴ
중개를	ᄌ ᅮ ᆼ ᄀ ᅢ ᄅ ᅳ ᆯ
안정적으로	ᄋ ᅡ ᆫ ᄌ ᅥ ᆼ ᄌ ᅥ ᄀ ᅳ ᄅ ᅩ
장물을	ᄌ ᅡ ᆼ ᄆ ᅮ ᄅ ᅳ ᆯ
판매하고	ᄑ ᅡ ᆫ ᄆ ᅢ ᄒ ᅡ ᄀ ᅩ
유통업체는	ᄋ ᅲ ᄐ ᅩ ᆼ ᄋ ᅥ ᆸ ᄎ ᅦ ᄂ ᅳ ᆫ
지자체를	ᄌ ᅵ ᄌ ᅡ ᄎ ᅦ ᄅ ᅳ ᆯ
편리하게	ᄑ ᅧ ᆯ ᄅ ᅵ ᄒ ᅡ ᄀ ᅦ
공급	ᄀ ᅩ ᆼ ᄀ ᅳ ᆸ
받을	ᄇ ᅡ ᄃ ᅳ ᆯ
줄어	ᄌ ᅮ ᄅ ᅥ
가격보다	ᄀ ᅡ ᄀ ᅧ ᆨ ᄈ ᅩ ᄃ ᅡ
것이라며	ᄀ ᅥ ᄉ ᅵ ᄅ ᅡ ᄆ ᅧ
포부를	ᄑ ᅩ ᄇ ᅮ ᄅ ᅳ ᆯ
밝혔죠	ᄇ ᅡ ᆯ ᄏ ᅧ ᆮ ᄍ ᅭ
대책이	ᄃ ᅢ ᄎ ᅢ ᄀ ᅵ
결실을	ᄀ ᅧ ᆯ ᄉ ᅵ ᄅ ᅳ ᆯ
볼지는	ᄇ ᅩ ᆯ ᄌ ᅵ ᄂ ᅳ ᆫ
조금	ᄌ ᅩ ᄀ ᅳ ᆷ
지켜봐야겠지만	ᄌ ᅵ ᄏ ᅧ ᄇ ᅪ ᄋ ᅣ ᄀ ᅦ ᆮ ᄍ ᅵ ᄆ ᅡ ᆫ
성과를	ᄉ ᅥ ᆼ ᄀ ᅪ ᄅ ᅳ ᆯ
거둬	ᄀ ᅥ ᄃ ᅯ
웃을	ᄋ ᅮ ᄉ ᅳ ᆯ
좋겠	ᄌ ᅩ ᄏ ᅦ ᆮ
습니다	ᄉ ᅳ ᆷ ᄂ ᅵ ᄃ ᅡ
슬픈은	ᄉ ᅳ ᆯ ᄑ ᅳ ᄂ ᅳ ᆫ
표정으로	ᄑ ᅭ ᄌ ᅥ ᆼ ᄋ ᅳ ᄅ ᅩ
갈아엎	ᄀ ᅡ ᄅ ᅡ ᄋ ᅥ ᆸ
는	ᄂ ᅳ ᆫ
농민	ᄂ ᅩ ᆼ ᄆ ᅵ ᆫ
가격표	ᄀ ᅡ ᄀ ᅧ ᆨ ᄑ ᅭ
를	ᄅ ᅳ ᆯ
얼굴	ᄋ ᅥ ᆯ ᄀ ᅮ ᆯ
을	ᄋ ᅳ ᆯ
찌푸	ᄍ ᅵ ᄑ ᅮ
린	ᄅ ᅵ ᆫ
의	ᄋ ᅴ
사진	ᄉ ᅡ ᄌ ᅵ ᆫ
보단	ᄇ ᅩ ᄃ ᅡ ᆫ
웃으며	ᄋ ᅮ ᄉ ᅳ ᄆ ᅧ
풍년을	ᄑ ᅮ ᆼ ᄂ ᅧ ᄂ ᅳ ᆯ
기뻐하는	ᄀ ᅵ ᄈ ᅥ ᄒ ᅡ ᄂ ᅳ ᆫ
사진이	ᄉ ᅡ ᄌ ᅵ ᄂ ᅵ
훨씬	ᄒ ᅯ ᆯ ᄊ ᅵ ᆫ
낫지	ᄂ ᅡ ᆮ ᄍ ᅵ
않겠어요	ᄋ ᅡ ᆫ ᄏ ᅦ ᄊ ᅥ ᄋ ᅭ
고학년	ᄀ ᅩ ᄒ ᅡ ᆼ ᄂ ᅧ ᆫ
문제에	ᄆ ᅮ ᆫ ᄌ ᅦ ᄋ ᅦ
생각해봐요	ᄉ ᅢ ᆼ ᄀ ᅡ ᄏ ᅢ ᄇ ᅪ ᄋ ᅭ
작게	ᄌ ᅡ ᆨ ᄁ ᅦ
당연한	ᄃ ᅡ ᆼ ᄋ ᅧ ᆫ ᄒ ᅡ ᆫ
나르는	ᄂ ᅡ ᄅ ᅳ ᄂ ᅳ ᆫ
일이니	ᄋ ᅵ ᄅ ᅵ ᄂ ᅵ
가격에	ᄀ ᅡ ᄀ ᅧ ᄀ ᅦ
이익을	ᄋ ᅵ ᄋ ᅵ ᄀ ᅳ ᆯ
더해	ᄃ ᅥ ᄒ ᅢ
일입니다	ᄋ ᅵ ᄅ ᅵ ᆷ ᄂ ᅵ ᄃ ᅡ
배추를	ᄇ ᅢ ᄎ ᅮ ᄅ ᅳ ᆯ
예전의	ᄋ ᅨ ᄌ ᅥ ᄂ ᅴ
절반	ᄌ ᅥ ᆯ ᄇ ᅡ ᆫ
값에	ᄀ ᅡ ᆸ ᄊ ᅦ
팔았는데	ᄑ ᅡ ᄅ ᅡ ᆫ ᄂ ᅳ ᆫ ᄃ ᅦ
사분의	ᄉ ᅡ ᄇ ᅮ ᄂ ᅴ
일밖에	ᄋ ᅵ ᆯ ᄈ ᅡ ᄁ ᅦ
않았다고	ᄋ ᅡ ᄂ ᅡ ᆮ ᄄ ᅡ ᄀ ᅩ
뭔가	ᄆ ᅯ ᆫ ᄀ ᅡ
이상하죠	ᄋ ᅵ ᄉ ᅡ ᆼ ᄒ ᅡ ᄌ ᅭ
유통상인은	ᄋ ᅲ ᄐ ᅩ ᆼ ᄉ ᅡ ᆼ ᄋ ᅵ ᄂ ᅳ ᆫ
공공의	ᄀ ᅩ ᆼ ᄀ ᅩ ᆼ ᄋ ᅴ
이익으로	ᄋ ᅵ ᄋ ᅵ ᄀ ᅳ ᄅ ᅩ
이어지지는	ᄋ ᅵ ᄋ ᅥ ᄌ ᅵ ᄌ ᅵ ᄂ ᅳ ᆫ
않는다라고	ᄋ ᅡ ᆫ ᄂ ᅳ ᆫ ᄃ ᅡ ᄅ ᅡ ᄀ ᅩ
표현해요	ᄑ ᅭ ᄒ ᅧ ᆫ ᄒ ᅢ ᄋ ᅭ
말이지만	ᄆ ᅡ ᄅ ᅵ ᄌ ᅵ ᄆ ᅡ ᆫ
사례이니	ᄉ ᅡ ᄅ ᅨ ᄋ ᅵ ᄂ ᅵ
천천히	ᄎ ᅥ ᆫ ᄎ ᅥ ᆫ ᄒ ᅵ
키워드	ᄏ ᅵ ᄋ ᅯ ᄃ ᅳ
샵	ᄉ ᅣ ᆸ
경제신문	ᄀ ᅧ ᆼ ᄌ ᅦ ᄉ ᅵ ᆫ ᄆ ᅮ ᆫ
유통단계	ᄋ ᅲ ᄐ ᅩ ᆼ ᄃ ᅡ ᆫ ᄀ ᅨ
그물은	ᄀ ᅳ ᄆ ᅮ ᄅ ᅳ ᆫ
커서	ᄏ ᅥ ᄉ ᅥ
세계를	ᄉ ᅦ ᄀ ᅨ ᄅ ᅳ ᆯ
뒤덮어요	ᄃ ᅱ ᄃ ᅥ ᄑ ᅥ ᄋ ᅭ
도시에서	ᄃ ᅩ ᄉ ᅵ ᄋ ᅦ ᄉ ᅥ
나라에서	ᄂ ᅡ ᄅ ᅡ ᄋ ᅦ ᄉ ᅥ
나라	ᄂ ᅡ ᄅ ᅡ
대륙에서	ᄃ ᅢ ᄅ ᅲ ᄀ ᅦ ᄉ ᅥ
대륙을	ᄃ ᅢ ᄅ ᅲ ᄀ ᅳ ᆯ
오가죠	ᄋ ᅩ ᄀ ᅡ ᄌ ᅭ
뻗어	ᄈ ᅥ ᄃ ᅥ
나위	ᄂ ᅡ ᄋ ᅱ
튼튼해	ᄐ ᅳ ᆫ ᄐ ᅳ ᆫ ᄒ ᅢ
보였어요	ᄇ ᅩ ᄋ ᅧ ᄊ ᅥ ᄋ ᅭ
끊기고	ᄁ ᅳ ᆫ ᄏ ᅵ ᄀ ᅩ
곳곳이	ᄀ ᅩ ᆮ ᄁ ᅩ ᄉ ᅵ
꼬여서	ᄁ ᅩ ᄋ ᅧ ᄉ ᅥ
큰일이래요	ᄏ ᅳ ᄂ ᅵ ᄅ ᅵ ᄅ ᅢ ᄋ ᅭ
그물을	ᄀ ᅳ ᄆ ᅮ ᄅ ᅳ ᆯ
어부가	ᄋ ᅥ ᄇ ᅮ ᄀ ᅡ
단어	ᄃ ᅡ ᄂ ᅥ
같지만	ᄀ ᅡ ᆮ ᄍ ᅵ ᄆ ᅡ ᆫ
일상과	ᄋ ᅵ ᆯ ᄉ ᅡ ᆼ ᄀ ᅪ
연결되어	ᄋ ᅧ ᆫ ᄀ ᅧ ᆯ ᄃ ᅬ ᄋ ᅥ
있답니다	ᄋ ᅵ ᆮ ᄄ ᅡ ᆷ ᄂ ᅵ ᄃ ᅡ
연결돼	ᄋ ᅧ ᆫ ᄀ ᅧ ᆯ ᄃ ᅫ
목적	ᄆ ᅩ ᆨ ᄍ ᅥ ᆨ
기업은	ᄀ ᅵ ᄋ ᅥ ᄇ ᅳ ᆫ
무엇을	ᄆ ᅮ ᄋ ᅥ ᄉ ᅳ ᆯ
만들어지고	ᄆ ᅡ ᆫ ᄃ ᅳ ᄅ ᅥ ᄌ ᅵ ᄀ ᅩ
할까요	ᄒ ᅡ ᆯ ᄁ ᅡ ᄋ ᅭ
최근에는	ᄎ ᅬ ᄀ ᅳ ᄂ ᅦ ᄂ ᅳ ᆫ
사회적인	ᄉ ᅡ ᄒ ᅬ ᄌ ᅥ ᄀ ᅵ ᆫ
책임도	ᄎ ᅢ ᄀ ᅵ ᆷ ᄃ ᅩ
강조하지만	ᄀ ᅡ ᆼ ᄌ ᅩ ᄒ ᅡ ᄌ ᅵ ᄆ ᅡ ᆫ
목적은	ᄆ ᅩ ᆨ ᄍ ᅥ ᄀ ᅳ ᆫ
본질적으로	ᄇ ᅩ ᆫ ᄌ ᅵ ᆯ ᄌ ᅥ ᄀ ᅳ ᄅ ᅩ
이익의	ᄋ ᅵ ᄋ ᅵ ᄀ ᅴ
추구입니다	ᄎ ᅮ ᄀ ᅮ ᄋ ᅵ ᆷ ᄂ ᅵ ᄃ ᅡ
물건과	ᄆ ᅮ ᆯ ᄀ ᅥ ᆫ ᄀ ᅪ
생산해	ᄉ ᅢ ᆼ ᄉ ᅡ ᆫ ᄒ ᅢ
팔아서	ᄑ ᅡ ᄅ ᅡ ᄉ ᅥ
얻는	ᄋ ᅥ ᆫ ᄂ ᅳ ᆫ
고민합니다	ᄀ ᅩ ᄆ ᅵ ᆫ ᄒ ᅡ ᆷ ᄂ ᅵ ᄃ ᅡ
예쁘게	ᄋ ᅨ ᄈ ᅳ ᄀ ᅦ
디자인하고	ᄃ ᅵ ᄌ ᅡ ᄋ ᅵ ᆫ ᄒ ᅡ ᄀ ᅩ
멋진	ᄆ ᅥ ᆮ ᄍ ᅵ ᆫ
연예인	ᄋ ᅧ ᄂ ᅨ ᄋ ᅵ ᆫ
모델로	ᄆ ᅩ ᄃ ᅦ ᆯ ᄅ ᅩ
광고를	ᄀ ᅪ ᆼ ᄀ ᅩ ᄅ ᅳ ᆯ
만들죠	ᄆ ᅡ ᆫ ᄃ ᅳ ᆯ ᄌ ᅭ
때로는	ᄄ ᅢ ᄅ ᅩ ᄂ ᅳ ᆫ
할인행사를	ᄒ ᅡ ᄅ ᅵ ᆫ ᄒ ᅢ ᆼ ᄉ ᅡ ᄅ ᅳ ᆯ
벌이기도	ᄇ ᅥ ᄅ ᅵ ᄀ ᅵ ᄃ ᅩ
경쟁자를	ᄀ ᅧ ᆼ ᄌ ᅢ ᆼ ᄌ ᅡ ᄅ ᅳ ᆯ
이길	ᄋ ᅵ ᄀ ᅵ ᆯ
새	ᄉ ᅢ
밤낮	ᄇ ᅡ ᆷ ᄂ ᅡ ᆮ
고민	ᄀ ᅩ ᄆ ᅵ ᆫ
글로벌	ᄀ ᅳ ᆯ ᄅ ᅩ ᄇ ᅥ ᆯ
사슬	ᄉ ᅡ ᄉ ᅳ ᆯ
것부터	ᄀ ᅥ ᆮ ᄈ ᅮ ᄐ ᅥ
중국이나	ᄌ ᅮ ᆼ ᄀ ᅮ ᄀ ᅵ ᄂ ᅡ
동남아시아에는	ᄃ ᅩ ᆼ ᄂ ᅡ ᄆ ᅡ ᄉ ᅵ ᄋ ᅡ ᄋ ᅦ ᄂ ᅳ ᆫ
우리나라	ᄋ ᅮ ᄅ ᅵ ᄂ ᅡ ᄅ ᅡ
업체가	ᄋ ᅥ ᆸ ᄎ ᅦ ᄀ ᅡ
진출해	ᄌ ᅵ ᆫ ᄎ ᅮ ᆯ ᄒ ᅢ
이곳에서는	ᄋ ᅵ ᄀ ᅩ ᄉ ᅦ ᄉ ᅥ ᄂ ᅳ ᆫ
인건비가	ᄋ ᅵ ᆫ ᄀ ᅥ ᆫ ᄇ ᅵ ᄀ ᅡ
낮은	ᄂ ᅡ ᄌ ᅳ ᆫ
직원을	ᄌ ᅵ ᄀ ᅯ ᄂ ᅳ ᆯ
고용	ᄀ ᅩ ᄋ ᅭ ᆼ
상품	ᄉ ᅡ ᆼ ᄑ ᅮ ᆷ
생산에	ᄉ ᅢ ᆼ ᄉ ᅡ ᄂ ᅦ
들어가는	ᄃ ᅳ ᄅ ᅥ ᄀ ᅡ ᄂ ᅳ ᆫ
각종	ᄀ ᅡ ᆨ ᄍ ᅩ ᆼ
원료와	ᄋ ᅯ ᆯ ᄅ ᅭ ᄋ ᅪ
자원이	ᄌ ᅡ ᄋ ᅯ ᄂ ᅵ
비용으로	ᄇ ᅵ ᄋ ᅭ ᆼ ᄋ ᅳ ᄅ ᅩ
생산	ᄉ ᅢ ᆼ ᄉ ᅡ ᆫ
얻을	ᄋ ᅥ ᄃ ᅳ ᆯ
판단했기에	ᄑ ᅡ ᆫ ᄃ ᅡ ᆫ ᄒ ᅢ ᆮ ᄁ ᅵ ᄋ ᅦ
기업들이	ᄀ ᅵ ᄋ ᅥ ᆸ ᄄ ᅳ ᄅ ᅵ
불편을	ᄇ ᅮ ᆯ ᄑ ᅧ ᄂ ᅳ ᆯ
감수하고	ᄀ ᅡ ᆷ ᄉ ᅮ ᄒ ᅡ ᄀ ᅩ
현지에	ᄒ ᅧ ᆫ ᄌ ᅵ ᄋ ᅦ
공장을	ᄀ ᅩ ᆼ ᄌ ᅡ ᆼ ᄋ ᅳ ᆯ
설치	ᄉ ᅥ ᆯ ᄎ ᅵ
나아가면	ᄂ ᅡ ᄋ ᅡ ᄀ ᅡ ᄆ ᅧ ᆫ
생산과정을	ᄉ ᅢ ᆼ ᄉ ᅡ ᆫ ᄀ ᅪ ᄌ ᅥ ᆼ ᄋ ᅳ ᆯ
토막토막	ᄐ ᅩ ᄆ ᅡ ᆨ ᄐ ᅩ ᄆ ᅡ ᆨ
세계에	ᄉ ᅦ ᄀ ᅨ ᄋ ᅦ
흩뿌리게	ᄒ ᅳ ᆮ ᄈ ᅮ ᄅ ᅵ ᄀ ᅦ
되요	ᄃ ᅬ ᄋ ᅭ
애플의	ᄋ ᅢ ᄑ ᅳ ᄅ ᅴ
아이폰을	ᄋ ᅡ ᄋ ᅵ ᄑ ᅩ ᄂ ᅳ ᆯ
살펴	ᄉ ᅡ ᆯ ᄑ ᅧ
아이폰	ᄋ ᅡ ᄋ ᅵ ᄑ ᅩ ᆫ
만들기	ᄆ ᅡ ᆫ ᄃ ᅳ ᆯ ᄀ ᅵ
필요	ᄑ ᅵ ᄅ ᅭ
우선	ᄋ ᅮ ᄉ ᅥ ᆫ
사방팔방에서	ᄉ ᅡ ᄇ ᅡ ᆼ ᄑ ᅡ ᆯ ᄇ ᅡ ᆼ ᄋ ᅦ ᄉ ᅥ
수입	ᄉ ᅮ ᄋ ᅵ ᆸ
원재료를	ᄋ ᅯ ᆫ ᄌ ᅢ ᄅ ᅭ ᄅ ᅳ ᆯ
독일과	ᄃ ᅩ ᄀ ᅵ ᆯ ᄀ ᅪ
일본	ᄋ ᅵ ᆯ ᄇ ᅩ ᆫ
대만	ᄃ ᅢ ᄆ ᅡ ᆫ
각국의	ᄀ ᅡ ᆨ ᄁ ᅮ ᄀ ᅴ
기업이	ᄀ ᅵ ᄋ ᅥ ᄇ ᅵ
각각	ᄀ ᅡ ᆨ ᄁ ᅡ ᆨ
부품을	ᄇ ᅮ ᄑ ᅮ ᄆ ᅳ ᆯ
만듭니다	ᄆ ᅡ ᆫ ᄃ ᅳ ᆷ ᄂ ᅵ ᄃ ᅡ
중국으로	ᄌ ᅮ ᆼ ᄀ ᅮ ᄀ ᅳ ᄅ ᅩ
조립하고	ᄌ ᅩ ᄅ ᅵ ᄑ ᅡ ᄀ ᅩ
판매하죠	ᄑ ᅡ ᆫ ᄆ ᅢ ᄒ ᅡ ᄌ ᅭ
제품의	ᄌ ᅦ ᄑ ᅮ ᄆ ᅴ
설계와	ᄉ ᅥ ᆯ ᄀ ᅨ ᄋ ᅪ
디자인	ᄃ ᅵ ᄌ ᅡ ᄋ ᅵ ᆫ
관리만	ᄀ ᅪ ᆯ ᄅ ᅵ ᄆ ᅡ ᆫ
미국의	ᄆ ᅵ ᄀ ᅮ ᄀ ᅴ
애플	ᄋ ᅢ ᄑ ᅳ ᆯ
본사가	ᄇ ᅩ ᆫ ᄉ ᅡ ᄀ ᅡ
맡아요	ᄆ ᅡ ᄐ ᅡ ᄋ ᅭ
스마트폰	ᄉ ᅳ ᄆ ᅡ ᄐ ᅳ ᄑ ᅩ ᆫ
산을	ᄉ ᅡ ᄂ ᅳ ᆯ
넘고	ᄂ ᅥ ᆷ ᄁ ᅩ
바다를	ᄇ ᅡ ᄃ ᅡ ᄅ ᅳ ᆯ
건너는	ᄀ ᅥ ᆫ ᄂ ᅥ ᄂ ᅳ ᆫ
반복	ᄇ ᅡ ᆫ ᄇ ᅩ ᆨ
쪽이	ᄍ ᅩ ᄀ ᅵ
되기에	ᄃ ᅬ ᄀ ᅵ ᄋ ᅦ
세계로	ᄉ ᅦ ᄀ ᅨ ᄅ ᅩ
흩어지게	ᄒ ᅳ ᄉ ᅥ ᄌ ᅵ ᄀ ᅦ
걸쳐	ᄀ ᅥ ᆯ ᄎ ᅥ
원재료의	ᄋ ᅯ ᆫ ᄌ ᅢ ᄅ ᅭ ᄋ ᅴ
확보	ᄒ ᅪ ᆨ ᄈ ᅩ
판매에	ᄑ ᅡ ᆫ ᄆ ᅢ ᄋ ᅦ
이르는	ᄋ ᅵ ᄅ ᅳ ᄂ ᅳ ᆫ
복잡	ᄇ ᅩ ᆨ ᄍ ᅡ ᆸ
연결	ᄋ ᅧ ᆫ ᄀ ᅧ ᆯ
관계를	ᄀ ᅪ ᆫ ᄀ ᅨ ᄅ ᅳ ᆯ
공급사슬이라고	ᄀ ᅩ ᆼ ᄀ ᅳ ᆸ ᄊ ᅡ ᄉ ᅳ ᄅ ᅵ ᄅ ᅡ ᄀ ᅩ
공급사슬은	ᄀ ᅩ ᆼ ᄀ ᅳ ᆸ ᄊ ᅡ ᄉ ᅳ ᄅ ᅳ ᆫ
바꿀	ᄇ ᅡ ᄁ ᅮ ᆯ
이천십구	ᄋ ᅵ ᄎ ᅥ ᆫ ᄉ ᅵ ᆸ ᄁ ᅮ
반도체	ᄇ ᅡ ᆫ ᄃ ᅩ ᄎ ᅦ
디스플레이	ᄃ ᅵ ᄉ ᅳ ᄑ ᅳ ᆯ ᄅ ᅦ ᄋ ᅵ
만드는	ᄆ ᅡ ᆫ ᄃ ᅳ ᄂ ᅳ ᆫ
필수적인	ᄑ ᅵ ᆯ ᄉ ᅮ ᄌ ᅥ ᄀ ᅵ ᆫ
부품과	ᄇ ᅮ ᄑ ᅮ ᆷ ᄀ ᅪ
소재를	ᄉ ᅩ ᄌ ᅢ ᄅ ᅳ ᆯ
한국에	ᄒ ᅡ ᆫ ᄀ ᅮ ᄀ ᅦ
수출	ᄉ ᅮ ᄎ ᅮ ᆯ
막았던	ᄆ ᅡ ᄀ ᅡ ᆮ ᄄ ᅥ ᆫ
일본이	ᄋ ᅵ ᆯ ᄇ ᅩ ᄂ ᅵ
한국으로	ᄒ ᅡ ᆫ ᄀ ᅮ ᄀ ᅳ ᄅ ᅩ
이어지는	ᄋ ᅵ ᄋ ᅥ ᄌ ᅵ ᄂ ᅳ ᆫ
사슬을	ᄉ ᅡ ᄉ ᅳ ᄅ ᅳ ᆯ
끊어	ᄁ ᅳ ᄂ ᅥ
우리나라에	ᄋ ᅮ ᄅ ᅵ ᄂ ᅡ ᄅ ᅡ ᄋ ᅦ
타격을	ᄐ ᅡ ᄀ ᅧ ᄀ ᅳ ᆯ
주려고	ᄌ ᅮ ᄅ ᅧ ᄀ ᅩ
필요한	ᄑ ᅵ ᄅ ᅭ ᄒ ᅡ ᆫ
수입하거나	ᄉ ᅮ ᄋ ᅵ ᄑ ᅡ ᄀ ᅥ ᄂ ᅡ
대응했죠	ᄃ ᅢ ᄋ ᅳ ᆼ ᄒ ᅢ ᆮ ᄍ ᅭ
끊다	ᄁ ᅳ ᆫ ᄐ ᅡ
병목	ᄇ ᅧ ᆼ ᄆ ᅩ ᆨ
현상	ᄒ ᅧ ᆫ ᄉ ᅡ ᆼ
다양한	ᄃ ᅡ ᄋ ᅣ ᆼ ᄒ ᅡ ᆫ
자의	ᄌ ᅡ ᄋ ᅴ
잡았어요	ᄌ ᅡ ᄇ ᅡ ᄊ ᅥ ᄋ ᅭ
곳은	ᄀ ᅩ ᄉ ᅳ ᆫ
공급하고	ᄀ ᅩ ᆼ ᄀ ᅳ ᄑ ᅡ ᄀ ᅩ
재료를	ᄌ ᅢ ᄅ ᅭ ᄅ ᅳ ᆯ
가공해	ᄀ ᅡ ᄀ ᅩ ᆼ ᄒ ᅢ
부품으로	ᄇ ᅮ ᄑ ᅮ ᄆ ᅳ ᄅ ᅩ
곳이	ᄀ ᅩ ᄉ ᅵ
조립해서	ᄌ ᅩ ᄅ ᅵ ᄑ ᅢ ᄉ ᅥ
완성품을	ᄋ ᅪ ᆫ ᄉ ᅥ ᆼ ᄑ ᅮ ᄆ ᅳ ᆯ
서로가	ᄉ ᅥ ᄅ ᅩ ᄀ ᅡ
필요해서	ᄑ ᅵ ᄅ ᅭ ᄒ ᅢ ᄉ ᅥ
손을	ᄉ ᅩ ᄂ ᅳ ᆯ
잡았으니	ᄌ ᅡ ᄇ ᅡ ᄊ ᅳ ᄂ ᅵ
튼튼하게만	ᄐ ᅳ ᆫ ᄐ ᅳ ᆫ ᄒ ᅡ ᄀ ᅦ ᄆ ᅡ ᆫ
보였던	ᄇ ᅩ ᄋ ᅧ ᆮ ᄄ ᅥ ᆫ
그물망이지만	ᄀ ᅳ ᄆ ᅮ ᆯ ᄆ ᅡ ᆼ ᄋ ᅵ ᄌ ᅵ ᄆ ᅡ ᆫ
엄청난	ᄋ ᅥ ᆷ ᄎ ᅥ ᆼ ᄂ ᅡ ᆫ
충격을	ᄎ ᅮ ᆼ ᄀ ᅧ ᄀ ᅳ ᆯ
마주	ᄆ ᅡ ᄌ ᅮ
했습니다	ᄒ ᅢ ᆮ ᄊ ᅳ ᆷ ᄂ ᅵ ᄃ ᅡ
십구입니다	ᄉ ᅵ ᆸ ᄁ ᅮ ᄋ ᅵ ᆷ ᄂ ᅵ ᄃ ᅡ
군데	ᄀ ᅮ ᆫ ᄃ ᅦ
문제가	ᄆ ᅮ ᆫ ᄌ ᅦ ᄀ ᅡ
생긴다면	ᄉ ᅢ ᆼ ᄀ ᅵ ᆫ ᄃ ᅡ ᄆ ᅧ ᆫ
그래도	ᄀ ᅳ ᄅ ᅢ ᄃ ᅩ
대응	ᄃ ᅢ ᄋ ᅳ ᆼ
찾아서	ᄎ ᅡ ᄌ ᅡ ᄉ ᅥ
구성	ᄀ ᅮ ᄉ ᅥ ᆼ
되니까요	ᄃ ᅬ ᄂ ᅵ ᄁ ᅡ ᄋ ᅭ
이번에는	ᄋ ᅵ ᄇ ᅥ ᄂ ᅦ ᄂ ᅳ ᆫ
달랐어요	ᄃ ᅡ ᆯ ᄅ ᅡ ᄊ ᅥ ᄋ ᅭ
하루가	ᄒ ᅡ ᄅ ᅮ ᄀ ᅡ
다르게	ᄃ ᅡ ᄅ ᅳ ᄀ ᅦ
질병이	ᄌ ᅵ ᆯ ᄇ ᅧ ᆼ ᄋ ᅵ
퍼져나가면서	ᄑ ᅥ ᄌ ᅥ ᄂ ᅡ ᄀ ᅡ ᄆ ᅧ ᆫ ᄉ ᅥ
사방에서	ᄉ ᅡ ᄇ ᅡ ᆼ ᄋ ᅦ ᄉ ᅥ
생산이	ᄉ ᅢ ᆼ ᄉ ᅡ ᄂ ᅵ
멈추고	ᄆ ᅥ ᆷ ᄎ ᅮ ᄀ ᅩ
유통이	ᄋ ᅲ ᄐ ᅩ ᆼ ᄋ ᅵ
멈췄어요	ᄆ ᅥ ᆷ ᄎ ᅯ ᄊ ᅥ ᄋ ᅭ
꽉	ᄁ ᅪ ᆨ
막히는	ᄆ ᅡ ᄏ ᅵ ᄂ ᅳ ᆫ
벌어졌죠	ᄇ ᅥ ᄅ ᅥ ᄌ ᅥ ᆮ ᄍ ᅭ
이리	ᄋ ᅵ ᄅ ᅵ
꼬이고	ᄁ ᅩ ᄋ ᅵ ᄀ ᅩ
저리	ᄌ ᅥ ᄅ ᅵ
끊어졌어요	ᄁ ᅳ ᄂ ᅥ ᄌ ᅥ ᄊ ᅥ ᄋ ᅭ
복구	ᄇ ᅩ ᆨ ᄁ ᅮ
되어도	ᄃ ᅬ ᄋ ᅥ ᄃ ᅩ
전역이	ᄌ ᅥ ᄂ ᅧ ᄀ ᅵ
혼란에	ᄒ ᅩ ᆯ ᄅ ᅡ ᄂ ᅦ
휩싸인	ᄒ ᅱ ᆸ ᄊ ᅡ ᄋ ᅵ ᆫ
공급사슬의	ᄀ ᅩ ᆼ ᄀ ᅳ ᆸ ᄊ ᅡ ᄉ ᅳ ᄅ ᅴ
약점이	ᄋ ᅣ ᆨ ᄍ ᅥ ᄆ ᅵ
드러났어요	ᄃ ᅳ ᄅ ᅥ ᄂ ᅡ ᄊ ᅥ ᄋ ᅭ
방역대책이	ᄇ ᅡ ᆼ ᄋ ᅧ ᆨ ᄄ ᅢ ᄎ ᅢ ᄀ ᅵ
이뤄졌고	ᄋ ᅵ ᄅ ᅯ ᄌ ᅥ ᆮ ᄁ ᅩ
사슬이	ᄉ ᅡ ᄉ ᅳ ᄅ ᅵ
끊어졌기	ᄁ ᅳ ᄂ ᅥ ᄌ ᅥ ᆮ ᄁ ᅵ
현대차는	ᄒ ᅧ ᆫ ᄃ ᅢ ᄎ ᅡ ᄂ ᅳ ᆫ
중국에서	ᄌ ᅮ ᆼ ᄀ ᅮ ᄀ ᅦ ᄉ ᅥ
수입하는	ᄉ ᅮ ᄋ ᅵ ᄑ ᅡ ᄂ ᅳ ᆫ
부품이	ᄇ ᅮ ᄑ ᅮ ᄆ ᅵ
바닥나서	ᄇ ᅡ ᄃ ᅡ ᆼ ᄂ ᅡ ᄉ ᅥ
자동차를	ᄌ ᅡ ᄃ ᅩ ᆼ ᄎ ᅡ ᄅ ᅳ ᆯ
만들	ᄆ ᅡ ᆫ ᄃ ᅳ ᆯ
공급망이	ᄀ ᅩ ᆼ ᄀ ᅳ ᆷ ᄆ ᅡ ᆼ ᄋ ᅵ
퍼져	ᄑ ᅥ ᄌ ᅥ
전체	ᄌ ᅥ ᆫ ᄎ ᅦ
생산활동이	ᄉ ᅢ ᆼ ᄉ ᅡ ᆫ ᄒ ᅪ ᆯ ᄃ ᅩ ᆼ ᄋ ᅵ
연쇄적으로	ᄋ ᅧ ᆫ ᄉ ᅫ ᄌ ᅥ ᄀ ᅳ ᄅ ᅩ
멈춘	ᄆ ᅥ ᆷ ᄎ ᅮ ᆫ
새로운	ᄉ ᅢ ᄅ ᅩ ᄋ ᅮ ᆫ
그물의	ᄀ ᅳ ᄆ ᅮ ᄅ ᅴ
인류는	ᄋ ᅵ ᆯ ᄅ ᅲ ᄂ ᅳ ᆫ
지구촌	ᄌ ᅵ ᄀ ᅮ ᄎ ᅩ ᆫ
마을이라	ᄆ ᅡ ᄋ ᅳ ᄅ ᅵ ᄅ ᅡ
불릴	ᄇ ᅮ ᆯ ᄅ ᅵ ᆯ
사태에서	ᄉ ᅡ ᄐ ᅢ ᄋ ᅦ ᄉ ᅥ
얻은	ᄋ ᅥ ᄃ ᅳ ᆫ
경험이	ᄀ ᅧ ᆼ ᄒ ᅥ ᄆ ᅵ
공급사슬을	ᄀ ᅩ ᆼ ᄀ ᅳ ᆸ ᄊ ᅡ ᄉ ᅳ ᄅ ᅳ ᆯ
바꾸어	ᄇ ᅡ ᄁ ᅮ ᄋ ᅥ
놓을	ᄂ ᅩ ᄋ ᅳ ᆯ
연결하는	ᄋ ᅧ ᆫ ᄀ ᅧ ᆯ ᄒ ᅡ ᄂ ᅳ ᆫ
그물망은	ᄀ ᅳ ᄆ ᅮ ᆯ ᄆ ᅡ ᆼ ᄋ ᅳ ᆫ
어	ᄋ ᅥ
좁히려고	ᄌ ᅩ ᄑ ᅵ ᄅ ᅧ ᄀ ᅩ
본국을	ᄇ ᅩ ᆫ ᄀ ᅮ ᄀ ᅳ ᆯ
좁은	ᄌ ᅩ ᄇ ᅳ ᆫ
범위에	ᄇ ᅥ ᄆ ᅱ ᄋ ᅦ
통제	ᄐ ᅩ ᆼ ᄌ ᅦ
지역의	ᄌ ᅵ ᄋ ᅧ ᄀ ᅴ
문제로	ᄆ ᅮ ᆫ ᄌ ᅦ ᄅ ᅩ
멈출	ᄆ ᅥ ᆷ ᄎ ᅮ ᆯ
가능성이	ᄀ ᅡ ᄂ ᅳ ᆼ ᄉ ᅥ ᆼ ᄋ ᅵ
작아지니까요	ᄌ ᅡ ᄀ ᅡ ᄌ ᅵ ᄂ ᅵ ᄁ ᅡ ᄋ ᅭ
그물	ᄀ ᅳ ᄆ ᅮ ᆯ
기업들은	ᄀ ᅵ ᄋ ᅥ ᆸ ᄄ ᅳ ᄅ ᅳ ᆫ
준비	ᄌ ᅮ ᆫ ᄇ ᅵ
하려고	ᄒ ᅡ ᄅ ᅧ ᄀ ᅩ
공급에	ᄀ ᅩ ᆼ ᄀ ᅳ ᄇ ᅦ
생겨도	ᄉ ᅢ ᆼ ᄀ ᅧ ᄃ ᅩ
수입하고	ᄉ ᅮ ᄋ ᅵ ᄑ ᅡ ᄀ ᅩ
제품을	ᄌ ᅦ ᄑ ᅮ ᄆ ᅳ ᆯ
피해가	ᄑ ᅵ ᄒ ᅢ ᄀ ᅡ
질	ᄌ ᅵ ᆯ
테죠	ᄐ ᅦ ᄌ ᅭ
효율성이	ᄒ ᅭ ᄋ ᅲ ᆯ ᄉ ᅥ ᆼ ᄋ ᅵ
낮아지더라도	ᄂ ᅡ ᄌ ᅡ ᄌ ᅵ ᄃ ᅥ ᄅ ᅡ ᄃ ᅩ
공급사슬	ᄀ ᅩ ᆼ ᄀ ᅳ ᆸ ᄊ ᅡ ᄉ ᅳ ᆯ
커질	ᄏ ᅥ ᄌ ᅵ ᆯ
국내로	ᄀ ᅮ ᆼ ᄂ ᅢ ᄅ ᅩ
아는	ᄋ ᅡ ᄂ ᅳ ᆫ
나라가	ᄂ ᅡ ᄅ ᅡ ᄀ ᅡ
인공호흡	ᄋ ᅵ ᆫ ᄀ ᅩ ᆼ ᄒ ᅩ ᄒ ᅳ ᆸ
제품은	ᄌ ᅦ ᄑ ᅮ ᄆ ᅳ ᆫ
해결하라는	ᄒ ᅢ ᄀ ᅧ ᆯ ᄒ ᅡ ᄅ ᅡ ᄂ ᅳ ᆫ
높아요	ᄂ ᅩ ᄑ ᅡ ᄋ ᅭ
각국	ᄀ ᅡ ᆨ ᄁ ᅮ ᆨ
정도의	ᄌ ᅥ ᆼ ᄃ ᅩ ᄋ ᅴ
필수적이라고	ᄑ ᅵ ᆯ ᄉ ᅮ ᄌ ᅥ ᄀ ᅵ ᄅ ᅡ ᄀ ᅩ
판단하느냐에	ᄑ ᅡ ᆫ ᄃ ᅡ ᆫ ᄒ ᅡ ᄂ ᅳ ᄂ ᅣ ᄋ ᅦ
달라질	ᄃ ᅡ ᆯ ᄅ ᅡ ᄌ ᅵ ᆯ
거에요	ᄀ ᅥ ᄋ ᅦ ᄋ ᅭ
공급망	ᄀ ᅩ ᆼ ᄀ ᅳ ᆷ ᄆ ᅡ ᆼ
기사는	ᄀ ᅵ ᄉ ᅡ ᄂ ᅳ ᆫ
재벌	ᄌ ᅢ ᄇ ᅥ ᆯ
닷컴이라는	ᄃ ᅡ ᆮ ᄏ ᅥ ᄆ ᅵ ᄅ ᅡ ᄂ ᅳ ᆫ
단체가	ᄃ ᅡ ᆫ ᄎ ᅦ ᄀ ᅡ
작성	ᄌ ᅡ ᆨ ᄊ ᅥ ᆼ
지난해	ᄌ ᅵ ᄂ ᅡ ᆫ ᄒ ᅢ
말과	ᄆ ᅡ ᆯ ᄀ ᅪ
주주들	ᄌ ᅮ ᄌ ᅮ ᄃ ᅳ ᆯ
가치가	ᄀ ᅡ ᄎ ᅵ ᄀ ᅡ
감소	ᄀ ᅡ ᆷ ᄉ ᅩ
했다는	ᄒ ᅢ ᆮ ᄄ ᅡ ᄂ ᅳ ᆫ
내용	ᄂ ᅢ ᄋ ᅭ ᆼ
자료를	ᄌ ᅡ ᄅ ᅭ ᄅ ᅳ ᆯ
대표	ᄃ ᅢ ᄑ ᅭ
주식가치	ᄌ ᅮ ᄉ ᅵ ᆨ ᄁ ᅡ ᄎ ᅵ
일천	ᄋ ᅵ ᆯ ᄎ ᅥ ᆫ
오백	ᄋ ᅩ ᄇ ᅢ ᆨ
팔십	ᄑ ᅡ ᆯ ᄉ ᅵ ᆸ
억	ᄋ ᅥ ᆨ
원에서	ᄋ ᅯ ᄂ ᅦ ᄉ ᅥ
칠백	ᄎ ᅵ ᆯ ᄇ ᅢ ᆨ
발견된	ᄇ ᅡ ᆯ ᄀ ᅧ ᆫ ᄃ ᅬ ᆫ
전하고	ᄌ ᅥ ᆫ ᄒ ᅡ ᄀ ᅩ
금리	ᄀ ᅳ ᆷ ᄂ ᅵ
인하	ᄋ ᅵ ᆫ ᄒ ᅡ
금값	ᄀ ᅳ ᆷ ᄀ ᅡ ᆸ
상승	ᄉ ᅡ ᆼ ᄉ ᅳ ᆼ
주식시장	ᄌ ᅮ ᄉ ᅵ ᆨ ᄊ ᅵ ᄌ ᅡ ᆼ
활황	ᄒ ᅪ ᆯ ᄒ ᅪ ᆼ
복잡해요	ᄇ ᅩ ᆨ ᄍ ᅡ ᄑ ᅢ ᄋ ᅭ
핵심만	ᄒ ᅢ ᆨ ᄊ ᅵ ᆷ ᄆ ᅡ ᆫ
알아두면	ᄋ ᅡ ᄅ ᅡ ᄃ ᅮ ᄆ ᅧ ᆫ
경제의	ᄀ ᅧ ᆼ ᄌ ᅦ ᄋ ᅴ
한눈에	ᄒ ᅡ ᆫ ᄂ ᅮ ᄂ ᅦ
거죠	ᄀ ᅥ ᄌ ᅭ
블룸버그	ᄇ ᅳ ᆯ ᄅ ᅮ ᆷ ᄇ ᅥ ᄀ ᅳ
통신	ᄐ ᅩ ᆼ ᄉ ᅵ ᆫ
뉴욕타임스	ᄂ ᅲ ᄋ ᅭ ᆨ ᄐ ᅡ ᄋ ᅵ ᆷ ᄉ ᅳ
중앙은행의	ᄌ ᅮ ᆼ ᄋ ᅡ ᆼ ᄋ ᅳ ᆫ ᄒ ᅢ ᆼ ᄋ ᅴ
역할	ᄋ ᅧ ᄏ ᅡ ᆯ
가운데	ᄀ ᅡ ᄋ ᅮ ᆫ ᄃ ᅦ
하나는	ᄒ ᅡ ᄂ ᅡ ᄂ ᅳ ᆫ
돈의	ᄃ ᅩ ᄂ ᅴ
정하는	ᄌ ᅥ ᆼ ᄒ ᅡ ᄂ ᅳ ᆫ
연준의	ᄋ ᅧ ᆫ ᄌ ᅮ ᄂ ᅴ
금리는	ᄀ ᅳ ᆷ ᄂ ᅵ ᄂ ᅳ ᆫ
미친다	ᄆ ᅵ ᄎ ᅵ ᆫ ᄃ ᅡ
금리인하	ᄀ ᅳ ᆷ ᄂ ᅵ ᄋ ᅵ ᆫ ᄒ ᅡ
확정적	ᄒ ᅪ ᆨ ᄍ ᅥ ᆼ ᄌ ᅥ ᆨ
경제활동의	ᄀ ᅧ ᆼ ᄌ ᅦ ᄒ ᅪ ᆯ ᄃ ᅩ ᆼ ᄋ ᅴ
중심인	ᄌ ᅮ ᆼ ᄉ ᅵ ᄆ ᅵ ᆫ
금리를	ᄀ ᅳ ᆷ ᄂ ᅵ ᄅ ᅳ ᆯ
시장에만	ᄉ ᅵ ᄌ ᅡ ᆼ ᄋ ᅦ ᄆ ᅡ ᆫ
맡기면	ᄆ ᅡ ᆮ ᄁ ᅵ ᄆ ᅧ ᆫ
혼란이	ᄒ ᅩ ᆯ ᄅ ᅡ ᄂ ᅵ
심하므로	ᄉ ᅵ ᆷ ᄒ ᅡ ᄆ ᅳ ᄅ ᅩ
중앙은행이	ᄌ ᅮ ᆼ ᄋ ᅡ ᆼ ᄋ ᅳ ᆫ ᄒ ᅢ ᆼ ᄋ ᅵ
기준을	ᄀ ᅵ ᄌ ᅮ ᄂ ᅳ ᆯ
정하며	ᄌ ᅥ ᆼ ᄒ ᅡ ᄆ ᅧ
이것이	ᄋ ᅵ ᄀ ᅥ ᄉ ᅵ
기준금리다	ᄀ ᅵ ᄌ ᅮ ᆫ ᄀ ᅳ ᆷ ᄂ ᅵ ᄃ ᅡ
금리의	ᄀ ᅳ ᆷ ᄂ ᅵ ᄋ ᅴ
기준이	ᄀ ᅵ ᄌ ᅮ ᄂ ᅵ
연준이	ᄋ ᅧ ᆫ ᄌ ᅮ ᄂ ᅵ
내린다고	ᄂ ᅢ ᄅ ᅵ ᆫ ᄃ ᅡ ᄀ ᅩ
내리면	ᄂ ᅢ ᄅ ᅵ ᄆ ᅧ ᆫ
떨어져	ᄄ ᅥ ᄅ ᅥ ᄌ ᅥ
빌리는데	ᄇ ᅵ ᆯ ᄅ ᅵ ᄂ ᅳ ᆫ ᄃ ᅦ
부담이	ᄇ ᅮ ᄃ ᅡ ᄆ ᅵ
적어진다	ᄌ ᅥ ᄀ ᅥ ᄌ ᅵ ᆫ ᄃ ᅡ
소비가	ᄉ ᅩ ᄇ ᅵ ᄀ ᅡ
늘어나고	ᄂ ᅳ ᄅ ᅥ ᄂ ᅡ ᄀ ᅩ
빌려	ᄇ ᅵ ᆯ ᄅ ᅧ
망설이던	ᄆ ᅡ ᆼ ᄉ ᅥ ᄅ ᅵ ᄃ ᅥ ᆫ
경제가	ᄀ ᅧ ᆼ ᄌ ᅦ ᄀ ᅡ
둔화	ᄃ ᅮ ᆫ ᄒ ᅪ
되니까	ᄃ ᅬ ᄂ ᅵ ᄁ ᅡ
낮춰서	ᄂ ᅡ ᆮ ᄎ ᅯ ᄉ ᅥ
하겠다는	ᄒ ᅡ ᄀ ᅦ ᆮ ᄄ ᅡ ᄂ ᅳ ᆫ
기준금리를	ᄀ ᅵ ᄌ ᅮ ᆫ ᄀ ᅳ ᆷ ᄂ ᅵ ᄅ ᅳ ᆯ
올리고	ᄋ ᅩ ᆯ ᄅ ᅵ ᄀ ᅩ
기본	ᄀ ᅵ ᄇ ᅩ ᆫ
단위는	ᄃ ᅡ ᄂ ᅱ ᄂ ᅳ ᆫ
포인트	ᄑ ᅩ ᄋ ᅵ ᆫ ᄐ ᅳ
급	ᄀ ᅳ ᆸ
한꺼번에	ᄒ ᅡ ᆫ ᄁ ᅥ ᄇ ᅥ ᄂ ᅦ
퍼센트의	ᄑ ᅥ ᄉ ᅦ ᆫ ᄐ ᅳ ᄋ ᅴ
배도	ᄇ ᅢ ᄃ ᅩ
조정	ᄌ ᅩ ᄌ ᅥ ᆼ
요동치면	ᄋ ᅭ ᄃ ᅩ ᆼ ᄎ ᅵ ᄆ ᅧ ᆫ
혼란을	ᄒ ᅩ ᆯ ᄅ ᅡ ᄂ ᅳ ᆯ
주기	ᄌ ᅮ ᄀ ᅵ
떨어진다	ᄄ ᅥ ᄅ ᅥ ᄌ ᅵ ᆫ ᄃ ᅡ
저축을	ᄌ ᅥ ᄎ ᅮ ᄀ ᅳ ᆯ
이자가	ᄋ ᅵ ᄌ ᅡ ᄀ ᅡ
적어진다는	ᄌ ᅥ ᄀ ᅥ ᄌ ᅵ ᆫ ᄃ ᅡ ᄂ ᅳ ᆫ
뜻이다	ᄄ ᅳ ᄉ ᅵ ᄃ ᅡ
그러니	ᄀ ᅳ ᄅ ᅥ ᄂ ᅵ
저축	ᄌ ᅥ ᄎ ᅮ ᆨ
이외에	ᄋ ᅵ ᄋ ᅬ ᄋ ᅦ
눈을	ᄂ ᅮ ᄂ ᅳ ᆯ
돌릴	ᄃ ᅩ ᆯ ᄅ ᅵ ᆯ
증권시장으로	ᄌ ᅳ ᆼ ᄀ ᅯ ᆫ ᄉ ᅵ ᄌ ᅡ ᆼ ᄋ ᅳ ᄅ ᅩ
들여오면	ᄃ ᅳ ᄅ ᅧ ᄋ ᅩ ᄆ ᅧ ᆫ
증시가	ᄌ ᅳ ᆼ ᄉ ᅵ ᄀ ᅡ
상승세를	ᄉ ᅡ ᆼ ᄉ ᅳ ᆼ ᄉ ᅦ ᄅ ᅳ ᆯ
보이게	ᄇ ᅩ ᄋ ᅵ ᄀ ᅦ
반대로	ᄇ ᅡ ᆫ ᄃ ᅢ ᄅ ᅩ
오르면	ᄋ ᅩ ᄅ ᅳ ᄆ ᅧ ᆫ
안정적이면서	ᄋ ᅡ ᆫ ᄌ ᅥ ᆼ ᄌ ᅥ ᄀ ᅵ ᄆ ᅧ ᆫ ᄉ ᅥ
이자까지	ᄋ ᅵ ᄌ ᅡ ᄁ ᅡ ᄌ ᅵ
있으니까	ᄋ ᅵ ᄊ ᅳ ᄂ ᅵ ᄁ ᅡ
금	ᄀ ᅳ ᆷ
값은	ᄀ ᅡ ᆸ ᄊ ᅳ ᆫ
올라	ᄋ ᅩ ᆯ ᄅ ᅡ
초에는	ᄎ ᅩ ᄋ ᅦ ᄂ ᅳ ᆫ
사백	ᄉ ᅡ ᄇ ᅢ ᆨ
달러를	ᄃ ᅡ ᆯ ᄅ ᅥ ᄅ ᅳ ᆯ
넘어설	ᄂ ᅥ ᄆ ᅥ ᄉ ᅥ ᆯ
금값이	ᄀ ᅳ ᆷ ᄀ ᅡ ᆸ ᄊ ᅵ
온스에	ᄋ ᅩ ᆫ ᄉ ᅳ ᄋ ᅦ
달러	ᄃ ᅡ ᆯ ᄅ ᅥ
선을	ᄉ ᅥ ᄂ ᅳ ᆯ
넘으면	ᄂ ᅥ ᄆ ᅳ ᄆ ᅧ ᆫ
이천십삼년	ᄋ ᅵ ᄎ ᅥ ᆫ ᄉ ᅵ ᆸ ᄊ ᅡ ᆷ ᄂ ᅧ ᆫ
구월에	ᄀ ᅮ ᄋ ᅯ ᄅ ᅦ
이어	ᄋ ᅵ ᄋ ᅥ
육	ᄋ ᅲ ᆨ
최고치를	ᄎ ᅬ ᄀ ᅩ ᄎ ᅵ ᄅ ᅳ ᆯ
기록하는	ᄀ ᅵ ᄅ ᅩ ᄏ ᅡ ᄂ ᅳ ᆫ
낮추는	ᄂ ᅡ ᆮ ᄎ ᅮ ᄂ ᅳ ᆫ
강세인	ᄀ ᅡ ᆼ ᄉ ᅦ ᄋ ᅵ ᆫ
연관	ᄋ ᅧ ᆫ ᄀ ᅪ ᆫ
관계가	ᄀ ᅪ ᆫ ᄀ ᅨ ᄀ ᅡ
기본적으로	ᄀ ᅵ ᄇ ᅩ ᆫ ᄌ ᅥ ᄀ ᅳ ᄅ ᅩ
금은	ᄀ ᅳ ᄆ ᅳ ᆫ
안정적인	ᄋ ᅡ ᆫ ᄌ ᅥ ᆼ ᄌ ᅥ ᄀ ᅵ ᆫ
투자방법으로	ᄐ ᅮ ᄌ ᅡ ᄇ ᅡ ᆼ ᄇ ᅥ ᄇ ᅳ ᄅ ᅩ
꼽힌다	ᄁ ᅩ ᄑ ᅵ ᆫ ᄃ ᅡ
경기가	ᄀ ᅧ ᆼ ᄀ ᅵ ᄀ ᅡ
위축	ᄋ ᅱ ᄎ ᅮ ᆨ
주식이나	ᄌ ᅮ ᄉ ᅵ ᄀ ᅵ ᄂ ᅡ
부동산의	ᄇ ᅮ ᄃ ᅩ ᆼ ᄉ ᅡ ᄂ ᅴ
변동폭이	ᄇ ᅧ ᆫ ᄃ ᅩ ᆼ ᄑ ᅩ ᄀ ᅵ
커져서	ᄏ ᅥ ᄌ ᅥ ᄉ ᅥ
손실을	ᄉ ᅩ ᆫ ᄉ ᅵ ᄅ ᅳ ᆯ
안정된	ᄋ ᅡ ᆫ ᄌ ᅥ ᆼ ᄃ ᅬ ᆫ
찾는다	ᄎ ᅡ ᆫ ᄂ ᅳ ᆫ ᄃ ᅡ
예금이나	ᄋ ᅨ ᄀ ᅳ ᄆ ᅵ ᄂ ᅡ
외환투자	ᄋ ᅬ ᄒ ᅪ ᆫ ᄐ ᅮ ᄌ ᅡ
외국	ᄋ ᅬ ᄀ ᅮ ᆨ
낮으니까	ᄂ ᅡ ᄌ ᅳ ᄂ ᅵ ᄁ ᅡ
기대하기	ᄀ ᅵ ᄃ ᅢ ᄒ ᅡ ᄀ ᅵ
어렵다	ᄋ ᅥ ᄅ ᅧ ᆸ ᄄ ᅡ
찾는	ᄎ ᅡ ᆫ ᄂ ᅳ ᆫ
금이	ᄀ ᅳ ᄆ ᅵ
이가	ᄋ ᅵ ᄀ ᅡ
금의	ᄀ ᅳ ᄆ ᅴ
생산은	ᄉ ᅢ ᆼ ᄉ ᅡ ᄂ ᅳ ᆫ
한정돼	ᄒ ᅡ ᆫ ᄌ ᅥ ᆼ ᄃ ᅫ
그러면	ᄀ ᅳ ᄅ ᅥ ᄆ ᅧ ᆫ
현상은	ᄒ ᅧ ᆫ ᄉ ᅡ ᆼ ᄋ ᅳ ᆫ
상승이다	ᄉ ᅡ ᆼ ᄉ ᅳ ᆼ ᄋ ᅵ ᄃ ᅡ
우리나라에서도	ᄋ ᅮ ᄅ ᅵ ᄂ ᅡ ᄅ ᅡ ᄋ ᅦ ᄉ ᅥ ᄃ ᅩ
거래가	ᄀ ᅥ ᄅ ᅢ ᄀ ᅡ
활발하다는	ᄒ ᅪ ᆯ ᄇ ᅡ ᆯ ᄒ ᅡ ᄃ ᅡ ᄂ ᅳ ᆫ
경향이	ᄀ ᅧ ᆼ ᄒ ᅣ ᆼ ᄋ ᅵ
반영된	ᄇ ᅡ ᄂ ᅧ ᆼ ᄃ ᅬ ᆫ
공공칠	ᄀ ᅩ ᆼ ᄀ ᅩ ᆼ ᄎ ᅵ ᆯ
만들수록	ᄆ ᅡ ᆫ ᄃ ᅳ ᆯ ᄊ ᅮ ᄅ ᅩ ᆨ
손해	ᄉ ᅩ ᆫ ᄒ ᅢ
동전	ᄃ ᅩ ᆼ ᄌ ᅥ ᆫ
어쩌지	ᄋ ᅥ ᄍ ᅥ ᄌ ᅵ
대장장이가	ᄃ ᅢ ᄌ ᅡ ᆼ ᄌ ᅡ ᆼ ᄋ ᅵ ᄀ ᅡ
금속을	ᄀ ᅳ ᆷ ᄉ ᅩ ᄀ ᅳ ᆯ
가공해서	ᄀ ᅡ ᄀ ᅩ ᆼ ᄒ ᅢ ᄉ ᅥ
동전은	ᄃ ᅩ ᆼ ᄌ ᅥ ᄂ ᅳ ᆫ
구리와	ᄀ ᅮ ᄅ ᅵ ᄋ ᅪ
니켈을	ᄂ ᅵ ᄏ ᅦ ᄅ ᅳ ᆯ
재료로	ᄌ ᅢ ᄅ ᅭ ᄅ ᅩ
만들어요	ᄆ ᅡ ᆫ ᄃ ᅳ ᄅ ᅥ ᄋ ᅭ
금속이죠	ᄀ ᅳ ᆷ ᄉ ᅩ ᄀ ᅵ ᄌ ᅭ
동전을	ᄃ ᅩ ᆼ ᄌ ᅥ ᄂ ᅳ ᆯ
만들면	ᄆ ᅡ ᆫ ᄃ ᅳ ᆯ ᄆ ᅧ ᆫ
공급되는	ᄀ ᅩ ᆼ ᄀ ᅳ ᆸ ᄄ ᅬ ᄂ ᅳ ᆫ
공급액보다	ᄀ ᅩ ᆼ ᄀ ᅳ ᄇ ᅢ ᆨ ᄈ ᅩ ᄃ ᅡ
생기고	ᄉ ᅢ ᆼ ᄀ ᅵ ᄀ ᅩ
원짜리처럼	ᄋ ᅯ ᆫ ᄍ ᅡ ᄅ ᅵ ᄎ ᅥ ᄅ ᅥ ᆷ
금액의	ᄀ ᅳ ᄆ ᅢ ᄀ ᅴ
심해져요	ᄉ ᅵ ᆷ ᄒ ᅢ ᄌ ᅥ ᄋ ᅭ
금속	ᄀ ᅳ ᆷ ᄉ ᅩ ᆨ
원이	ᄋ ᅯ ᄂ ᅵ
가공비도	ᄀ ᅡ ᄀ ᅩ ᆼ ᄇ ᅵ ᄃ ᅩ
개당	ᄀ ᅢ ᄃ ᅡ ᆼ
십오	ᄉ ᅵ ᄇ ᅩ
손해를	ᄉ ᅩ ᆫ ᄒ ᅢ ᄅ ᅳ ᆯ
한국은행이	ᄒ ᅡ ᆫ ᄀ ᅮ ᄀ ᅳ ᆫ ᄒ ᅢ ᆼ ᄋ ᅵ
발표한	ᄇ ᅡ ᆯ ᄑ ᅭ ᄒ ᅡ ᆫ
회수된	ᄒ ᅬ ᄉ ᅮ ᄃ ᅬ ᆫ
동전의	ᄃ ᅩ ᆼ ᄌ ᅥ ᄂ ᅴ
액면가는	ᄋ ᅢ ᆼ ᄆ ᅧ ᆫ ᄀ ᅡ ᄂ ᅳ ᆫ
백칠십삼억	ᄇ ᅢ ᆨ ᄎ ᅵ ᆯ ᄉ ᅵ ᆸ ᄊ ᅡ ᄆ ᅥ ᆨ
차익이	ᄎ ᅡ ᄋ ᅵ ᄀ ᅵ
육십억	ᄋ ᅲ ᆨ ᄊ ᅵ ᄇ ᅥ ᆨ
넘어요	ᄂ ᅥ ᄆ ᅥ ᄋ ᅭ
그나마	ᄀ ᅳ ᄂ ᅡ ᄆ ᅡ
이천십칠년	ᄋ ᅵ ᄎ ᅥ ᆫ ᄉ ᅵ ᆸ ᄎ ᅵ ᆯ ᄅ ᅧ ᆫ
보다는	ᄇ ᅩ ᄃ ᅡ ᄂ ᅳ ᆫ
나아진	ᄂ ᅡ ᄋ ᅡ ᄌ ᅵ ᆫ
수준이래요	ᄉ ᅮ ᄌ ᅮ ᄂ ᅵ ᄅ ᅢ ᄋ ᅭ
순	ᄉ ᅮ ᆫ
발행액은	ᄇ ᅡ ᆯ ᄒ ᅢ ᆼ ᄋ ᅢ ᄀ ᅳ ᆫ
백이십이억	ᄇ ᅢ ᄀ ᅵ ᄉ ᅵ ᄇ ᅵ ᄋ ᅥ ᆨ
원이었는데	ᄋ ᅯ ᄂ ᅵ ᄋ ᅥ ᆫ ᄂ ᅳ ᆫ ᄃ ᅦ
돈은	ᄃ ᅩ ᄂ ᅳ ᆫ
오백이십일억	ᄋ ᅩ ᄇ ᅢ ᄀ ᅵ ᄉ ᅵ ᄇ ᅵ ᄅ ᅥ ᆨ
원이나	ᄋ ᅯ ᄂ ᅵ ᄂ ᅡ
들었다고	ᄃ ᅳ ᄅ ᅥ ᆮ ᄄ ᅡ ᄀ ᅩ
뭘까요	ᄆ ᅯ ᆯ ᄁ ᅡ ᄋ ᅭ
손해가	ᄉ ᅩ ᆫ ᄒ ᅢ ᄀ ᅡ
나는	ᄂ ᅡ ᄂ ᅳ ᆫ
상황	ᄉ ᅡ ᆼ ᄒ ᅪ ᆼ
이유는	ᄋ ᅵ ᄋ ᅲ ᄂ ᅳ ᆫ
만들어야	ᄆ ᅡ ᆫ ᄃ ᅳ ᄅ ᅥ ᄋ ᅣ
잔돈이	ᄌ ᅡ ᆫ ᄃ ᅩ ᄂ ᅵ
없으면	ᄋ ᅥ ᆸ ᄊ ᅳ ᄆ ᅧ ᆫ
파는데	ᄑ ᅡ ᄂ ᅳ ᆫ ᄃ ᅦ
생기니까요	ᄉ ᅢ ᆼ ᄀ ᅵ ᄂ ᅵ ᄁ ᅡ ᄋ ᅭ
고민으로부터	ᄀ ᅩ ᄆ ᅵ ᄂ ᅳ ᄅ ᅩ ᄇ ᅮ ᄐ ᅥ
벗어나기	ᄇ ᅥ ᄉ ᅥ ᄂ ᅡ ᄀ ᅵ
궁극적인	ᄀ ᅮ ᆼ ᄀ ᅳ ᆨ ᄍ ᅥ ᄀ ᅵ ᆫ
방법은	ᄇ ᅡ ᆼ ᄇ ᅥ ᄇ ᅳ ᆫ
무엇일까요	ᄆ ᅮ ᄋ ᅥ ᄉ ᅵ ᆯ ᄁ ᅡ ᄋ ᅭ
그래요	ᄀ ᅳ ᄅ ᅢ ᄋ ᅭ
사회로	ᄉ ᅡ ᄒ ᅬ ᄅ ᅩ
넘어가는	ᄂ ᅥ ᄆ ᅥ ᄀ ᅡ ᄂ ᅳ ᆫ
것입니다	ᄀ ᅥ ᄉ ᅵ ᆷ ᄂ ᅵ ᄃ ᅡ
사회	ᄉ ᅡ ᄒ ᅬ
전자화폐	ᄌ ᅥ ᆫ ᄌ ᅡ ᄒ ᅪ ᄑ ᅨ
도입에	ᄃ ᅩ ᄋ ᅵ ᄇ ᅦ
적극	ᄌ ᅥ ᆨ ᄁ ᅳ ᆨ
나서는	ᄂ ᅡ ᄉ ᅥ ᄂ ᅳ ᆫ
가	ᄀ ᅡ
알아본	ᄋ ᅡ ᄅ ᅡ ᄇ ᅩ ᆫ
일제의	ᄋ ᅵ ᆯ ᄌ ᅦ ᄋ ᅴ
무력에	ᄆ ᅮ ᄅ ᅧ ᄀ ᅦ
의해	ᄋ ᅴ ᄒ ᅢ
을사늑약이	ᄋ ᅳ ᆯ ᄉ ᅡ ᄂ ᅳ ᄀ ᅣ ᄀ ᅵ
체결된	ᄎ ᅦ ᄀ ᅧ ᆯ ᄃ ᅬ ᆫ
장소로	ᄌ ᅡ ᆼ ᄉ ᅩ ᄅ ᅩ
유명하다	ᄋ ᅲ ᄆ ᅧ ᆼ ᄒ ᅡ ᄃ ᅡ
을사늑약	ᄋ ᅳ ᆯ ᄉ ᅡ ᄂ ᅳ ᄀ ᅣ ᆨ
천구백오	ᄎ ᅥ ᆫ ᄀ ᅮ ᄇ ᅢ ᄀ ᅩ
강제로	ᄀ ᅡ ᆼ ᄌ ᅦ ᄅ ᅩ
체결됐다	ᄎ ᅦ ᄀ ᅧ ᆯ ᄃ ᅫ ᆮ ᄄ ᅡ
최소한의	ᄎ ᅬ ᄉ ᅩ ᄒ ᅡ ᄂ ᅴ
형식	ᄒ ᅧ ᆼ ᄉ ᅵ ᆨ
도	ᄃ ᅩ
갖추지	ᄀ ᅡ ᆮ ᄎ ᅮ ᄌ ᅵ
조약이	ᄌ ᅩ ᄋ ᅣ ᄀ ᅵ
나라의	ᄂ ᅡ ᄅ ᅡ ᄋ ᅴ
통수권자	ᄐ ᅩ ᆼ ᄉ ᅮ ᄀ ᅯ ᆫ ᄌ ᅡ
대표자가	ᄃ ᅢ ᄑ ᅭ ᄌ ᅡ ᄀ ᅡ
조약	ᄌ ᅩ ᄋ ᅣ ᆨ
체결	ᄎ ᅦ ᄀ ᅧ ᆯ
당사자에게	ᄃ ᅡ ᆼ ᄉ ᅡ ᄌ ᅡ ᄋ ᅦ ᄀ ᅦ
전해주는	ᄌ ᅥ ᆫ ᄒ ᅢ ᄌ ᅮ ᄂ ᅳ ᆫ
전권위임장이	ᄌ ᅥ ᆫ ᄀ ᅯ ᄂ ᅱ ᄋ ᅵ ᆷ ᄌ ᅡ ᆼ ᄋ ᅵ
상태였다	ᄉ ᅡ ᆼ ᄐ ᅢ ᄋ ᅧ ᆮ ᄄ ᅡ
당시	ᄃ ᅡ ᆼ ᄉ ᅵ
대한민국	ᄃ ᅢ ᄒ ᅡ ᆫ ᄆ ᅵ ᆫ ᄀ ᅮ ᆨ
통수권자인	ᄐ ᅩ ᆼ ᄉ ᅮ ᄀ ᅯ ᆫ ᄌ ᅡ ᄋ ᅵ ᆫ
고종의	ᄀ ᅩ ᄌ ᅩ ᆼ ᄋ ᅴ
어세	ᄋ ᅥ ᄉ ᅦ
절차도	ᄌ ᅥ ᆯ ᄎ ᅡ ᄃ ᅩ
치러	ᄎ ᅵ ᄅ ᅥ
진	ᄌ ᅵ ᆫ
외교권	ᄋ ᅬ ᄀ ᅭ ᄀ ᅯ ᆫ
교섭을	ᄀ ᅭ ᄉ ᅥ ᄇ ᅳ ᆯ
권리를	ᄀ ᅯ ᆯ ᄅ ᅵ ᄅ ᅳ ᆯ
박	ᄇ ᅡ ᆨ
탈당한	ᄐ ᅡ ᆯ ᄃ ᅡ ᆼ ᄒ ᅡ ᆫ
고종은	ᄀ ᅩ ᄌ ᅩ ᆼ ᄋ ᅳ ᆫ
무효임을	ᄆ ᅮ ᄒ ᅭ ᄋ ᅵ ᄆ ᅳ ᆯ
선언하고	ᄉ ᅥ ᄂ ᅥ ᆫ ᄒ ᅡ ᄀ ᅩ
가져갔다	ᄀ ᅡ ᄌ ᅥ ᄀ ᅡ ᆮ ᄄ ᅡ
해외로	ᄒ ᅢ ᄋ ᅬ ᄅ ᅩ
특사를	ᄐ ᅳ ᆨ ᄊ ᅡ ᄅ ᅳ ᆯ
보내지만	ᄇ ᅩ ᄂ ᅢ ᄌ ᅵ ᄆ ᅡ ᆫ
일제에	ᄋ ᅵ ᆯ ᄌ ᅦ ᄋ ᅦ
실패했고	ᄉ ᅵ ᆯ ᄑ ᅢ ᄒ ᅢ ᆮ ᄁ ᅩ
천구백칠년	ᄎ ᅥ ᆫ ᄀ ᅮ ᄇ ᅢ ᆨ ᄎ ᅵ ᆯ ᄅ ᅧ ᆫ
퇴위	ᄐ ᅬ ᄋ ᅱ
당한다	ᄃ ᅡ ᆼ ᄒ ᅡ ᆫ ᄃ ᅡ
원래	ᄋ ᅯ ᆯ ᄅ ᅢ
였을까요	ᄋ ᅧ ᄊ ᅳ ᆯ ᄁ ᅡ ᄋ ᅭ
중명전이	ᄌ ᅮ ᆼ ᄆ ᅧ ᆼ ᄌ ᅥ ᄂ ᅵ
보관	ᄇ ᅩ ᄀ ᅪ ᆫ
됐는지	ᄃ ᅫ ᆫ ᄂ ᅳ ᆫ ᄌ ᅵ
설명으로	ᄉ ᅥ ᆯ ᄆ ᅧ ᆼ ᄋ ᅳ ᄅ ᅩ
본격적인	ᄇ ᅩ ᆫ ᄀ ᅧ ᆨ ᄍ ᅥ ᄀ ᅵ ᆫ
해설	ᄒ ᅢ ᄉ ᅥ ᆯ
프로그램이	ᄑ ᅳ ᄅ ᅩ ᄀ ᅳ ᄅ ᅢ ᄆ ᅵ
시작됐다	ᄉ ᅵ ᄌ ᅡ ᆨ ᄄ ᅫ ᆮ ᄄ ᅡ
해설사의	ᄒ ᅢ ᄉ ᅥ ᆯ ᄉ ᅡ ᄋ ᅴ
질문에	ᄌ ᅵ ᆯ ᄆ ᅮ ᄂ ᅦ
학생들은	ᄒ ᅡ ᆨ ᄊ ᅢ ᆼ ᄃ ᅳ ᄅ ᅳ ᆫ
저마다	ᄌ ᅥ ᄆ ᅡ ᄃ ᅡ
개성	ᄀ ᅢ ᄉ ᅥ ᆼ
넘치는	ᄂ ᅥ ᆷ ᄎ ᅵ ᄂ ᅳ ᆫ
답변을	ᄃ ᅡ ᆸ ᄈ ᅧ ᄂ ᅳ ᆯ
황제의	ᄒ ᅪ ᆼ ᄌ ᅦ ᄋ ᅴ
침실이었을	ᄎ ᅵ ᆷ ᄉ ᅵ ᄅ ᅵ ᄋ ᅥ ᄊ ᅳ ᆯ
옆	ᄋ ᅧ ᆸ
덕수궁보다	ᄃ ᅥ ᆨ ᄊ ᅮ ᄀ ᅮ ᆼ ᄇ ᅩ ᄃ ᅡ
서양	ᄉ ᅥ ᄋ ᅣ ᆼ
건축물의	ᄀ ᅥ ᆫ ᄎ ᅮ ᆼ ᄆ ᅮ ᄅ ᅴ
느낌이	ᄂ ᅳ ᄁ ᅵ ᄆ ᅵ
벼슬이	ᄇ ᅧ ᄉ ᅳ ᄅ ᅵ
머물렀던	ᄆ ᅥ ᄆ ᅮ ᆯ ᄅ ᅥ ᆮ ᄄ ᅥ ᆫ
호텔일	ᄒ ᅩ ᄐ ᅦ ᄅ ᅵ ᆯ
같습니다	ᄀ ᅡ ᆮ ᄊ ᅳ ᆷ ᄂ ᅵ ᄃ ᅡ
중명전은	ᄌ ᅮ ᆼ ᄆ ᅧ ᆼ ᄌ ᅥ ᄂ ᅳ ᆫ
황실의	ᄒ ᅪ ᆼ ᄉ ᅵ ᄅ ᅴ
서적	ᄉ ᅥ ᄌ ᅥ ᆨ
보물을	ᄇ ᅩ ᄆ ᅮ ᄅ ᅳ ᆯ
보관하던	ᄇ ᅩ ᄀ ᅪ ᆫ ᄒ ᅡ ᄃ ᅥ ᆫ
서재로	ᄉ ᅥ ᄌ ᅢ ᄅ ᅩ
지어졌다	ᄌ ᅵ ᄋ ᅥ ᄌ ᅥ ᆮ ᄄ ᅡ
천구백사	ᄎ ᅥ ᆫ ᄀ ᅮ ᄇ ᅢ ᆨ ᄊ ᅡ
덕수궁에	ᄃ ᅥ ᆨ ᄊ ᅮ ᄀ ᅮ ᆼ ᄋ ᅦ
화재가	ᄒ ᅪ ᄌ ᅢ ᄀ ᅡ
발생하자	ᄇ ᅡ ᆯ ᄉ ᅢ ᆼ ᄒ ᅡ ᄌ ᅡ
곳을	ᄀ ᅩ ᄉ ᅳ ᆯ
임시	ᄋ ᅵ ᆷ ᄉ ᅵ
편전	ᄑ ᅧ ᆫ ᄌ ᅥ ᆫ
임금이	ᄋ ᅵ ᆷ ᄀ ᅳ ᄆ ᅵ
거처하는	ᄀ ᅥ ᄎ ᅥ ᄒ ᅡ ᄂ ᅳ ᆫ
궁전으로	ᄀ ᅮ ᆼ ᄌ ᅥ ᄂ ᅳ ᄅ ᅩ
사용했고	ᄉ ᅡ ᄋ ᅭ ᆼ ᄒ ᅢ ᆮ ᄁ ᅩ
됐	ᄃ ᅫ ᆮ
밀랍	ᄆ ᅵ ᆯ ᄅ ᅡ ᆸ
인형으로	ᄋ ᅵ ᆫ ᄒ ᅧ ᆼ ᄋ ᅳ ᄅ ᅩ
이토	ᄋ ᅵ ᄐ ᅩ
히로부미와	ᄒ ᅵ ᄅ ᅩ ᄇ ᅮ ᄆ ᅵ ᄋ ᅪ
이완용을	ᄋ ᅵ ᄋ ᅪ ᄂ ᅭ ᆼ ᄋ ᅳ ᆯ
대신들을	ᄃ ᅢ ᄉ ᅵ ᆫ ᄃ ᅳ ᄅ ᅳ ᆯ
이야기를	ᄋ ᅵ ᄋ ᅣ ᄀ ᅵ ᄅ ᅳ ᆯ
나눴다	ᄂ ᅡ ᄂ ᅯ ᆮ ᄄ ᅡ
이완용이구나	ᄋ ᅵ ᄋ ᅪ ᄂ ᅭ ᆼ ᄋ ᅵ ᄀ ᅮ ᄂ ᅡ
친일파	ᄎ ᅵ ᄂ ᅵ ᆯ ᄑ ᅡ
답	ᄃ ᅡ ᆸ
대한제국과	ᄃ ᅢ ᄒ ᅡ ᆫ ᄌ ᅦ ᄀ ᅮ ᆨ ᄁ ᅪ
고종	ᄀ ᅩ ᄌ ᅩ ᆼ
전시실	ᄌ ᅥ ᆫ ᄉ ᅵ ᄉ ᅵ ᆯ
곳곳에	ᄀ ᅩ ᆮ ᄁ ᅩ ᄉ ᅦ
미국을	ᄆ ᅵ ᄀ ᅮ ᄀ ᅳ ᆯ
비롯한	ᄇ ᅵ ᄅ ᅩ ᄐ ᅡ ᆫ
서방국가	ᄉ ᅥ ᄇ ᅡ ᆼ ᄀ ᅮ ᆨ ᄁ ᅡ
미국과	ᄆ ᅵ ᄀ ᅮ ᆨ ᄁ ᅪ
서유럽의	ᄉ ᅥ ᄋ ᅲ ᄅ ᅥ ᄇ ᅴ
자유주의	ᄌ ᅡ ᄋ ᅲ ᄌ ᅮ ᄋ ᅴ
국가에	ᄀ ᅮ ᆨ ᄁ ᅡ ᄋ ᅦ
파견했어요	ᄑ ᅡ ᄀ ᅧ ᆫ ᄒ ᅢ ᄊ ᅥ ᄋ ᅭ
국제법상	ᄀ ᅮ ᆨ ᄍ ᅦ ᄇ ᅥ ᆸ ᄊ ᅡ ᆼ
무효라는	ᄆ ᅮ ᄒ ᅭ ᄅ ᅡ ᄂ ᅳ ᆫ
점과	ᄌ ᅥ ᆷ ᄀ ᅪ
대한제국을	ᄃ ᅢ ᄒ ᅡ ᆫ ᄌ ᅦ ᄀ ᅮ ᄀ ᅳ ᆯ
상대로	ᄉ ᅡ ᆼ ᄃ ᅢ ᄅ ᅩ
저지른	ᄌ ᅥ ᄌ ᅵ ᄅ ᅳ ᆫ
행동들을	ᄒ ᅢ ᆼ ᄃ ᅩ ᆼ ᄃ ᅳ ᄅ ᅳ ᆯ
특사인	ᄐ ᅳ ᆨ ᄊ ᅡ ᄋ ᅵ ᆫ
분함을	ᄇ ᅮ ᆫ ᄒ ᅡ ᄆ ᅳ ᆯ
감추지	ᄀ ᅡ ᆷ ᄎ ᅮ ᄌ ᅵ
저라면	ᄌ ᅥ ᄅ ᅡ ᄆ ᅧ ᆫ
창문을	ᄎ ᅡ ᆼ ᄆ ᅮ ᄂ ᅳ ᆯ
통해서	ᄐ ᅩ ᆼ ᄒ ᅢ ᄉ ᅥ
들어가	ᄃ ᅳ ᄅ ᅥ ᄀ ᅡ
대한민국의	ᄃ ᅢ ᄒ ᅡ ᆫ ᄆ ᅵ ᆫ ᄀ ᅮ ᄀ ᅴ
억울함을	ᄋ ᅥ ᄀ ᅮ ᆯ ᄒ ᅡ ᄆ ᅳ ᆯ
알렸을	ᄋ ᅡ ᆯ ᄅ ᅧ ᄊ ᅳ ᆯ
아쉬워요	ᄋ ᅡ ᄉ ᅱ ᄋ ᅯ ᄋ ᅭ
설명이	ᄉ ᅥ ᆯ ᄆ ᅧ ᆼ ᄋ ᅵ
조약이었는지	ᄌ ᅩ ᄋ ᅣ ᄀ ᅵ ᄋ ᅥ ᆫ ᄂ ᅳ ᆫ ᄌ ᅵ
확실하게	ᄒ ᅪ ᆨ ᄊ ᅵ ᆯ ᄒ ᅡ ᄀ ᅦ
일제가	ᄋ ᅵ ᆯ ᄌ ᅦ ᄀ ᅡ
행동을	ᄒ ᅢ ᆼ ᄃ ᅩ ᆼ ᄋ ᅳ ᆯ
독립을	ᄃ ᅩ ᆼ ᄂ ᅵ ᄇ ᅳ ᆯ
노력한	ᄂ ᅩ ᄅ ᅧ ᄏ ᅡ ᆫ
선조들을	ᄉ ᅥ ᆫ ᄌ ᅩ ᄃ ᅳ ᄅ ᅳ ᆯ
기도	ᄀ ᅵ ᄃ ᅩ
걸음	ᄀ ᅥ ᄅ ᅳ ᆷ
들어가보자	ᄃ ᅳ ᄅ ᅥ ᄀ ᅡ ᄇ ᅩ ᄌ ᅡ
경력단절	ᄀ ᅧ ᆼ ᄂ ᅧ ᆨ ᄄ ᅡ ᆫ ᄌ ᅥ ᆯ
여성	ᄋ ᅧ ᄉ ᅥ ᆼ
경단녀	ᄀ ᅧ ᆼ ᄃ ᅡ ᆫ ᄂ ᅧ
봤다	ᄇ ᅪ ᆮ ᄄ ᅡ
떠오른다	ᄄ ᅥ ᄋ ᅩ ᄅ ᅳ ᆫ ᄃ ᅡ
단어가	ᄃ ᅡ ᄂ ᅥ ᄀ ᅡ
경력	ᄀ ᅧ ᆼ ᄂ ᅧ ᆨ
단절	ᄃ ᅡ ᆫ ᄌ ᅥ ᆯ
여성이	ᄋ ᅧ ᄉ ᅥ ᆼ ᄋ ᅵ
경단녀라고	ᄀ ᅧ ᆼ ᄃ ᅡ ᆫ ᄂ ᅧ ᄅ ᅡ ᄀ ᅩ
그만둔	ᄀ ᅳ ᄆ ᅡ ᆫ ᄃ ᅮ ᆫ
뜻	ᄄ ᅳ ᆮ
말이다	ᄆ ᅡ ᄅ ᅵ ᄃ ᅡ
경단녀가	ᄀ ᅧ ᆼ ᄃ ᅡ ᆫ ᄂ ᅧ ᄀ ᅡ
결혼과	ᄀ ᅧ ᆯ ᄒ ᅩ ᆫ ᄀ ᅪ
탄생이다	ᄐ ᅡ ᆫ ᄉ ᅢ ᆼ ᄋ ᅵ ᄃ ᅡ
직장생활을	ᄌ ᅵ ᆨ ᄍ ᅡ ᆼ ᄉ ᅢ ᆼ ᄒ ᅪ ᄅ ᅳ ᆯ
자녀가	ᄌ ᅡ ᄂ ᅧ ᄀ ᅡ
태어나면서	ᄐ ᅢ ᄋ ᅥ ᄂ ᅡ ᄆ ᅧ ᆫ ᄉ ᅥ
가사	ᄀ ᅡ ᄉ ᅡ
집안	ᄌ ᅵ ᄇ ᅡ ᆫ
일에	ᄋ ᅵ ᄅ ᅦ
집중하게	ᄌ ᅵ ᆸ ᄍ ᅮ ᆼ ᄒ ᅡ ᄀ ᅦ
되고	ᄃ ᅬ ᄀ ᅩ
경력이	ᄀ ᅧ ᆼ ᄂ ᅧ ᄀ ᅵ
됐다는	ᄃ ᅫ ᆮ ᄄ ᅡ ᄂ ᅳ ᆫ
의미다	ᄋ ᅴ ᄆ ᅵ ᄃ ᅡ
경단녀에는	ᄀ ᅧ ᆼ ᄃ ᅡ ᆫ ᄂ ᅧ ᄋ ᅦ ᄂ ᅳ ᆫ
주부의	ᄌ ᅮ ᄇ ᅮ ᄋ ᅴ
라는	ᄅ ᅡ ᄂ ᅳ ᆫ
광고의	ᄀ ᅪ ᆼ ᄀ ᅩ ᄋ ᅴ
내용처럼	ᄂ ᅢ ᄋ ᅭ ᆼ ᄎ ᅥ ᄅ ᅥ ᆷ
엄마라는	ᄋ ᅥ ᆷ ᄆ ᅡ ᄅ ᅡ ᄂ ᅳ ᆫ
경력은	ᄀ ᅧ ᆼ ᄂ ᅧ ᄀ ᅳ ᆫ
줄의	ᄌ ᅮ ᄅ ᅴ
스펙이	ᄉ ᅳ ᄑ ᅦ ᄀ ᅵ
걸까	ᄀ ᅥ ᆯ ᄁ ᅡ
아니기	ᄋ ᅡ ᄂ ᅵ ᄀ ᅵ
때문이다	ᄄ ᅢ ᄆ ᅮ ᄂ ᅵ ᄃ ᅡ
그렇다면	ᄀ ᅳ ᄅ ᅥ ᄐ ᅡ ᄆ ᅧ ᆫ
인식은	ᄋ ᅵ ᆫ ᄉ ᅵ ᄀ ᅳ ᆫ
합당한	ᄒ ᅡ ᆸ ᄄ ᅡ ᆼ ᄒ ᅡ ᆫ
것일까	ᄀ ᅥ ᄉ ᅵ ᆯ ᄁ ᅡ
남성은	ᄂ ᅡ ᆷ ᄉ ᅥ ᆼ ᄋ ᅳ ᆫ
없지	ᄋ ᅥ ᆸ ᄍ ᅵ
합당하지	ᄒ ᅡ ᆸ ᄄ ᅡ ᆼ ᄒ ᅡ ᄌ ᅵ
않다	ᄋ ᅡ ᆫ ᄐ ᅡ
여성이란	ᄋ ᅧ ᄉ ᅥ ᆼ ᄋ ᅵ ᄅ ᅡ ᆫ
말부터	ᄆ ᅡ ᆯ ᄇ ᅮ ᄐ ᅥ
없애야	ᄋ ᅥ ᆸ ᄊ ᅢ ᄋ ᅣ
단어는	ᄃ ᅡ ᄂ ᅥ ᄂ ᅳ ᆫ
성평등에도	ᄉ ᅥ ᆼ ᄑ ᅧ ᆼ ᄃ ᅳ ᆼ ᄋ ᅦ ᄃ ᅩ
어긋난다	ᄋ ᅥ ᄀ ᅳ ᆫ ᄂ ᅡ ᆫ ᄃ ᅡ
합당하며	ᄒ ᅡ ᆸ ᄄ ᅡ ᆼ ᄒ ᅡ ᄆ ᅧ
성차별적인	ᄉ ᅥ ᆼ ᄎ ᅡ ᄇ ᅧ ᆯ ᄌ ᅥ ᄀ ᅵ ᆫ
되려면	ᄃ ᅬ ᄅ ᅧ ᄆ ᅧ ᆫ
남자가	ᄂ ᅡ ᆷ ᄌ ᅡ ᄀ ᅡ
사정으로	ᄉ ᅡ ᄌ ᅥ ᆼ ᄋ ᅳ ᄅ ᅩ
남성이	ᄂ ᅡ ᆷ ᄉ ᅥ ᆼ ᄋ ᅵ
돼야	ᄃ ᅫ ᄋ ᅣ
육아를	ᄋ ᅲ ᄀ ᅡ ᄅ ᅳ ᆯ
휴직	ᄒ ᅲ ᄌ ᅵ ᆨ
했다가	ᄒ ᅢ ᆮ ᄄ ᅡ ᄀ ᅡ
복직하는	ᄇ ᅩ ᆨ ᄍ ᅵ ᄏ ᅡ ᄂ ᅳ ᆫ
가사일을	ᄀ ᅡ ᄉ ᅡ ᄋ ᅵ ᄅ ᅳ ᆯ
가게에서	ᄀ ᅡ ᄀ ᅦ ᄋ ᅦ ᄉ ᅥ
너희	ᄂ ᅥ ᄒ ᅵ
물건이	ᄆ ᅮ ᆯ ᄀ ᅥ ᄂ ᅵ
팔리는	ᄑ ᅡ ᆯ ᄅ ᅵ ᄂ ᅳ ᆫ
봐주겠거든	ᄇ ᅪ ᄌ ᅮ ᄀ ᅦ ᆮ ᄁ ᅥ ᄃ ᅳ ᆫ
한판	ᄒ ᅡ ᆫ ᄑ ᅡ ᆫ
붙어보자	ᄇ ᅮ ᄐ ᅥ ᄇ ᅩ ᄌ ᅡ
나도	ᄂ ᅡ ᄃ ᅩ
물건	ᄆ ᅮ ᆯ ᄀ ᅥ ᆫ
미래	ᄆ ᅵ ᄅ ᅢ
충돌	ᄎ ᅮ ᆼ ᄃ ᅩ ᆯ
구글은	ᄀ ᅮ ᄀ ᅳ ᄅ ᅳ ᆫ
첨단	ᄎ ᅥ ᆷ ᄃ ᅡ ᆫ
제품과	ᄌ ᅦ ᄑ ᅮ ᆷ ᄀ ᅪ
콘텐츠를	ᄏ ᅩ ᆫ ᄐ ᅦ ᆫ ᄎ ᅳ ᄅ ᅳ ᆯ
아마존은	ᄋ ᅡ ᄆ ᅡ ᄌ ᅩ ᄂ ᅳ ᆫ
전체를	ᄌ ᅥ ᆫ ᄎ ᅦ ᄅ ᅳ ᆯ
커버하는	ᄏ ᅥ ᄇ ᅥ ᄒ ᅡ ᄂ ᅳ ᆫ
전자상거래	ᄌ ᅥ ᆫ ᄌ ᅡ ᄉ ᅡ ᆼ ᄀ ᅥ ᄅ ᅢ
네트워크가	ᄂ ᅦ ᄐ ᅳ ᄋ ᅯ ᄏ ᅳ ᄀ ᅡ
있구요	ᄋ ᅵ ᆮ ᄁ ᅮ ᄋ ᅭ
이익이겠죠	ᄋ ᅵ ᄋ ᅵ ᄀ ᅵ ᄀ ᅦ ᆮ ᄍ ᅭ
소개	ᄉ ᅩ ᄀ ᅢ
수수료를	ᄉ ᅮ ᄉ ᅮ ᄅ ᅭ ᄅ ᅳ ᆯ
받으니까요	ᄇ ᅡ ᄃ ᅳ ᄂ ᅵ ᄁ ᅡ ᄋ ᅭ
에이아이	ᄋ ᅦ ᄋ ᅵ ᄋ ᅡ ᄋ ᅵ
스피커를	ᄉ ᅳ ᄑ ᅵ ᄏ ᅥ ᄅ ᅳ ᆯ
인공지능	ᄋ ᅵ ᆫ ᄀ ᅩ ᆼ ᄌ ᅵ ᄂ ᅳ ᆼ
제품	ᄌ ᅦ ᄑ ᅮ ᆷ
사물	ᄉ ᅡ ᄆ ᅮ ᆯ
인터넷	ᄋ ᅵ ᆫ ᄐ ᅥ ᄂ ᅦ ᆮ
기기	ᄀ ᅵ ᄀ ᅵ
등장한	ᄃ ᅳ ᆼ ᄌ ᅡ ᆼ ᄒ ᅡ ᆫ
시장에서도	ᄉ ᅵ ᄌ ᅡ ᆼ ᄋ ᅦ ᄉ ᅥ ᄃ ᅩ
파이	ᄑ ᅡ ᄋ ᅵ
규모를	ᄀ ᅲ ᄆ ᅩ ᄅ ᅳ ᆯ
키우자며	ᄏ ᅵ ᄋ ᅮ ᄌ ᅡ ᄆ ᅧ
협력했죠	ᄒ ᅧ ᆷ ᄂ ᅧ ᄏ ᅢ ᆮ ᄍ ᅭ
시장에서	ᄉ ᅵ ᄌ ᅡ ᆼ ᄋ ᅦ ᄉ ᅥ
주도권을	ᄌ ᅮ ᄃ ᅩ ᄀ ᅯ ᄂ ᅳ ᆯ
싸움을	ᄊ ᅡ ᄋ ᅮ ᄆ ᅳ ᆯ
벌이게	ᄇ ᅥ ᄅ ᅵ ᄀ ᅦ
파이가	ᄑ ᅡ ᄋ ᅵ ᄀ ᅡ
커야	ᄏ ᅥ ᄋ ᅣ
공룡	ᄀ ᅩ ᆼ ᄂ ᅭ ᆼ
벌이는	ᄇ ᅥ ᄅ ᅵ ᄂ ᅳ ᆫ
갈등의	ᄀ ᅡ ᆯ ᄄ ᅳ ᆼ ᄋ ᅴ
양측이	ᄋ ᅣ ᆼ ᄎ ᅳ ᄀ ᅵ
생각하는	ᄉ ᅢ ᆼ ᄀ ᅡ ᄏ ᅡ ᄂ ᅳ ᆫ
미래의	ᄆ ᅵ ᄅ ᅢ ᄋ ᅴ
동력이	ᄃ ᅩ ᆼ ᄂ ᅧ ᄀ ᅵ
같다는	ᄀ ᅡ ᆮ ᄄ ᅡ ᄂ ᅳ ᆫ
점입니다	ᄌ ᅥ ᄆ ᅵ ᆷ ᄂ ᅵ ᄃ ᅡ
아이오티	ᄋ ᅡ ᄋ ᅵ ᄋ ᅩ ᄐ ᅵ
영상	ᄋ ᅧ ᆼ ᄉ ᅡ ᆼ
콘텐츠	ᄏ ᅩ ᆫ ᄐ ᅦ ᆫ ᄎ ᅳ
스피커	ᄉ ᅳ ᄑ ᅵ ᄏ ᅥ
회사가	ᄒ ᅬ ᄉ ᅡ ᄀ ᅡ
산업으로	ᄉ ᅡ ᄂ ᅥ ᄇ ᅳ ᄅ ᅩ
육성하고	ᄋ ᅲ ᆨ ᄊ ᅥ ᆼ ᄒ ᅡ ᄀ ᅩ
분야가	ᄇ ᅮ ᄂ ᅣ ᄀ ᅡ
갈등이	ᄀ ᅡ ᆯ ᄄ ᅳ ᆼ ᄋ ᅵ
본격화	ᄇ ᅩ ᆫ ᄀ ᅧ ᄏ ᅪ
둘이	ᄃ ᅮ ᄅ ᅵ
펼치고	ᄑ ᅧ ᆯ ᄎ ᅵ ᄀ ᅩ
공격과	ᄀ ᅩ ᆼ ᄀ ᅧ ᆨ ᄁ ᅪ
방어를	ᄇ ᅡ ᆼ ᄋ ᅥ ᄅ ᅳ ᆯ
봤어요	ᄇ ᅪ ᄊ ᅥ ᄋ ᅭ
아마존	ᄋ ᅡ ᄆ ᅡ ᄌ ᅩ ᆫ
구글이	ᄀ ᅮ ᄀ ᅳ ᄅ ᅵ
개발한	ᄀ ᅢ ᄇ ᅡ ᆯ ᄒ ᅡ ᆫ
스마트	ᄉ ᅳ ᄆ ᅡ ᄐ ᅳ
홈	ᄒ ᅩ ᆷ
신상품은	ᄉ ᅵ ᆫ ᄉ ᅡ ᆼ ᄑ ᅮ ᄆ ᅳ ᆫ
매장에서	ᄆ ᅢ ᄌ ᅡ ᆼ ᄋ ᅦ ᄉ ᅥ
우리도	ᄋ ᅮ ᄅ ᅵ ᄃ ᅩ
기술력이	ᄀ ᅵ ᄉ ᅮ ᆯ ᄅ ᅧ ᄀ ᅵ
뛰어난	ᄄ ᅱ ᄋ ᅥ ᄂ ᅡ ᆫ
스타트업	ᄉ ᅳ ᄐ ᅡ ᄐ ᅳ ᄋ ᅥ ᆸ
벤처	ᄇ ᅦ ᆫ ᄎ ᅥ
인수해서	ᄋ ᅵ ᆫ ᄉ ᅮ ᄒ ᅢ ᄉ ᅥ
진출	ᄌ ᅵ ᆫ ᄎ ᅮ ᆯ
신제품	ᄉ ᅵ ᆫ ᄌ ᅦ ᄑ ᅮ ᆷ
뿐만	ᄈ ᅮ ᆫ ᄆ ᅡ ᆫ
홈과	ᄒ ᅩ ᆷ ᄀ ᅪ
관련된	ᄀ ᅪ ᆯ ᄅ ᅧ ᆫ ᄃ ᅬ ᆫ
기존	ᄀ ᅵ ᄌ ᅩ ᆫ
아마존에서는	ᄋ ᅡ ᄆ ᅡ ᄌ ᅩ ᄂ ᅦ ᄉ ᅥ ᄂ ᅳ ᆫ
단	ᄃ ᅡ ᆫ
팔지	ᄑ ᅡ ᆯ ᄌ ᅵ
너도	ᄂ ᅥ ᄃ ᅩ
당해봐	ᄃ ᅡ ᆼ ᄒ ᅢ ᄇ ᅪ
배경이	ᄇ ᅢ ᄀ ᅧ ᆼ ᄋ ᅵ
제품군	ᄌ ᅦ ᄑ ᅮ ᆷ ᄀ ᅮ ᆫ
스피커와	ᄉ ᅳ ᄑ ᅵ ᄏ ᅥ ᄋ ᅪ
연동한	ᄋ ᅧ ᆫ ᄃ ᅩ ᆼ ᄒ ᅡ ᆫ
제품이다	ᄌ ᅦ ᄑ ᅮ ᄆ ᅵ ᄃ ᅡ
온도	ᄋ ᅩ ᆫ ᄃ ᅩ
조절기	ᄌ ᅩ ᄌ ᅥ ᆯ ᄀ ᅵ
시장에서는	ᄉ ᅵ ᄌ ᅡ ᆼ ᄋ ᅦ ᄉ ᅥ ᄂ ᅳ ᆫ
아마존의	ᄋ ᅡ ᄆ ᅡ ᄌ ᅩ ᄂ ᅴ
에코와	ᄋ ᅦ ᄏ ᅩ ᄋ ᅪ
구글의	ᄀ ᅮ ᄀ ᅳ ᄅ ᅴ
구글홈이	ᄀ ᅮ ᄀ ᅳ ᆯ ᄒ ᅩ ᄆ ᅵ
경쟁	ᄀ ᅧ ᆼ ᄌ ᅢ ᆼ
중이다	ᄌ ᅮ ᆼ ᄋ ᅵ ᄃ ᅡ
현재는	ᄒ ᅧ ᆫ ᄌ ᅢ ᄂ ᅳ ᆫ
에코	ᄋ ᅦ ᄏ ᅩ
팔리지만	ᄑ ᅡ ᆯ ᄅ ᅵ ᄌ ᅵ ᄆ ᅡ ᆫ
홈이	ᄒ ᅩ ᄆ ᅵ
성장해	ᄉ ᅥ ᆼ ᄌ ᅡ ᆼ ᄒ ᅢ
아마존이	ᄋ ᅡ ᄆ ᅡ ᄌ ᅩ ᄂ ᅵ
위협을	ᄋ ᅱ ᄒ ᅧ ᄇ ᅳ ᆯ
티브이	ᄐ ᅵ ᄇ ᅳ ᄋ ᅵ
채널	ᄎ ᅢ ᄂ ᅥ ᆯ
통해서는	ᄐ ᅩ ᆼ ᄒ ᅢ ᄉ ᅥ ᄂ ᅳ ᆫ
유튜브를	ᄋ ᅲ ᄐ ᅲ ᄇ ᅳ ᄅ ᅳ ᆯ
접속	ᄌ ᅥ ᆸ ᄊ ᅩ ᆨ
그래	ᄀ ᅳ ᄅ ᅢ
픽셀	ᄑ ᅵ ᆨ ᄊ ᅦ ᆯ
폰	ᄑ ᅩ ᆫ
홈은	ᄒ ᅩ ᄆ ᅳ ᆫ
팔지마	ᄑ ᅡ ᆯ ᄌ ᅵ ᄆ ᅡ
유튜브는	ᄋ ᅲ ᄐ ᅲ ᄇ ᅳ ᄂ ᅳ ᆫ
대표적인	ᄃ ᅢ ᄑ ᅭ ᄌ ᅥ ᄀ ᅵ ᆫ
제공	ᄌ ᅦ ᄀ ᅩ ᆼ
플랫폼	ᄑ ᅳ ᆯ ᄅ ᅢ ᆮ ᄑ ᅩ ᆷ
슈트박스와	ᄉ ᅲ ᄐ ᅳ ᄇ ᅡ ᆨ ᄊ ᅳ ᄋ ᅪ
에이아	ᄋ ᅦ ᄋ ᅵ ᄋ ᅡ
스피커에서	ᄉ ᅳ ᄑ ᅵ ᄏ ᅥ ᄋ ᅦ ᄉ ᅥ
유튜브에	ᄋ ᅲ ᄐ ᅲ ᄇ ᅳ ᄋ ᅦ
접근하지	ᄌ ᅥ ᆸ ᄁ ᅳ ᆫ ᄒ ᅡ ᄌ ᅵ
못하도록	ᄆ ᅩ ᄐ ᅡ ᄃ ᅩ ᄅ ᅩ ᆨ
차단	ᄎ ᅡ ᄃ ᅡ ᆫ
했다	ᄒ ᅢ ᆮ ᄄ ᅡ
대응하여	ᄃ ᅢ ᄋ ᅳ ᆼ ᄒ ᅡ ᄋ ᅧ
공	ᄀ ᅩ ᆼ
천국	ᄎ ᅥ ᆫ ᄀ ᅮ ᆨ
토이저러스	ᄐ ᅩ ᄋ ᅵ ᄌ ᅥ ᄅ ᅥ ᄉ ᅳ
아마존에	ᄋ ᅡ ᄆ ᅡ ᄌ ᅩ ᄂ ᅦ
밀려	ᄆ ᅵ ᆯ ᄅ ᅧ
사라질	ᄉ ᅡ ᄅ ᅡ ᄌ ᅵ ᆯ
위기	ᄋ ᅱ ᄀ ᅵ
대부분	ᄃ ᅢ ᄇ ᅮ ᄇ ᅮ ᆫ
매장에	ᄆ ᅢ ᄌ ᅡ ᆼ ᄋ ᅦ
가본	ᄀ ᅡ ᄇ ᅩ ᆫ
적이	ᄌ ᅥ ᄀ ᅵ
토이저러스는	ᄐ ᅩ ᄋ ᅵ ᄌ ᅥ ᄅ ᅥ ᄉ ᅳ ᄂ ᅳ ᆫ
완구의	ᄋ ᅪ ᆫ ᄀ ᅮ ᄋ ᅴ
슈퍼마켓을	ᄉ ᅲ ᄑ ᅥ ᄆ ᅡ ᄏ ᅦ ᄉ ᅳ ᆯ
모토	ᄆ ᅩ ᄐ ᅩ
모토로	ᄆ ᅩ ᄐ ᅩ ᄅ ᅩ
오프라인	ᄋ ᅩ ᄑ ᅳ ᄅ ᅡ ᄋ ᅵ ᆫ
매장이에요	ᄆ ᅢ ᄌ ᅡ ᆼ ᄋ ᅵ ᄋ ᅦ ᄋ ᅭ
아기용	ᄋ ᅡ ᄀ ᅵ ᄋ ᅭ ᆼ
딸랑이	ᄄ ᅡ ᆯ ᄅ ᅡ ᆼ ᄋ ᅵ
부터	ᄇ ᅮ ᄐ ᅥ
복잡한	ᄇ ᅩ ᆨ ᄍ ᅡ ᄑ ᅡ ᆫ
보드	ᄇ ᅩ ᄃ ᅳ
게임까지	ᄀ ᅦ ᄋ ᅵ ᆷ ᄁ ᅡ ᄌ ᅵ
완구를	ᄋ ᅪ ᆫ ᄀ ᅮ ᄅ ᅳ ᆯ
천구백사십팔년	ᄎ ᅥ ᆫ ᄀ ᅮ ᄇ ᅢ ᆨ ᄊ ᅡ ᄉ ᅵ ᆸ ᄑ ᅡ ᆯ ᄅ ᅧ ᆫ
미국에서	ᄆ ᅵ ᄀ ᅮ ᄀ ᅦ ᄉ ᅥ
연	ᄋ ᅧ ᆫ
성공을	ᄉ ᅥ ᆼ ᄀ ᅩ ᆼ ᄋ ᅳ ᆯ
거두었어요	ᄀ ᅥ ᄃ ᅮ ᄋ ᅥ ᄊ ᅥ ᄋ ᅭ
삼십육	ᄉ ᅡ ᆷ ᄉ ᅵ ᄇ ᅲ ᆨ
개	ᄀ ᅢ
나라에	ᄂ ᅡ ᄅ ᅡ ᄋ ᅦ
천육백	ᄎ ᅥ ᄂ ᅲ ᆨ ᄈ ᅢ ᆨ
가게를	ᄀ ᅡ ᄀ ᅦ ᄅ ᅳ ᆯ
했으니까요	ᄒ ᅢ ᄊ ᅳ ᄂ ᅵ ᄁ ᅡ ᄋ ᅭ
우리나라에도	ᄋ ᅮ ᄅ ᅵ ᄂ ᅡ ᄅ ᅡ ᄋ ᅦ ᄃ ᅩ
여럿	ᄋ ᅧ ᄅ ᅥ ᆮ
팔일	ᄑ ᅡ ᄅ ᅵ ᆯ
충격적인	ᄎ ᅮ ᆼ ᄀ ᅧ ᆨ ᄍ ᅥ ᄀ ᅵ ᆫ
소식이	ᄉ ᅩ ᄉ ᅵ ᄀ ᅵ
들려	ᄃ ᅳ ᆯ ᄅ ᅧ
왔어요	ᄋ ᅪ ᄊ ᅥ ᄋ ᅭ
토이저러스가	ᄐ ᅩ ᄋ ᅵ ᄌ ᅥ ᄅ ᅥ ᄉ ᅳ ᄀ ᅡ
매장의	ᄆ ᅢ ᄌ ᅡ ᆼ ᄋ ᅴ
닫겠다고	ᄃ ᅡ ᆮ ᄁ ᅦ ᆮ ᄄ ᅡ ᄀ ᅩ
선언한	ᄉ ᅥ ᄂ ᅥ ᆫ ᄒ ᅡ ᆫ
팔백	ᄑ ᅡ ᆯ ᄇ ᅢ ᆨ
매장을	ᄆ ᅢ ᄌ ᅡ ᆼ ᄋ ᅳ ᆯ
배제	ᄇ ᅢ ᄌ ᅦ
벌어진	ᄇ ᅥ ᄅ ᅥ ᄌ ᅵ ᆫ
걸까요	ᄀ ᅥ ᆯ ᄁ ᅡ ᄋ ᅭ
판매부진으로	ᄑ ᅡ ᆫ ᄆ ᅢ ᄇ ᅮ ᄌ ᅵ ᄂ ᅳ ᄅ ᅩ
고전	ᄀ ᅩ ᄌ ᅥ ᆫ
법원에	ᄇ ᅥ ᄇ ᅯ ᄂ ᅦ
파산보호	ᄑ ᅡ ᄉ ᅡ ᆫ ᄇ ᅩ ᄒ ᅩ
신청을	ᄉ ᅵ ᆫ ᄎ ᅥ ᆼ ᄋ ᅳ ᆯ
신청은	ᄉ ᅵ ᆫ ᄎ ᅥ ᆼ ᄋ ᅳ ᆫ
벌어	ᄇ ᅥ ᄅ ᅥ
빚을	ᄇ ᅵ ᄌ ᅳ ᆯ
갚겠다는	ᄀ ᅡ ᆸ ᄁ ᅦ ᆮ ᄄ ᅡ ᄂ ᅳ ᆫ
약속이예요	ᄋ ᅣ ᆨ ᄊ ᅩ ᄀ ᅵ ᄋ ᅨ ᄋ ᅭ
수익을	ᄉ ᅮ ᄋ ᅵ ᄀ ᅳ ᆯ
올리지	ᄋ ᅩ ᆯ ᄅ ᅵ ᄌ ᅵ
백팔십	ᄇ ᅢ ᆨ ᄑ ᅡ ᆯ ᄉ ᅵ ᆸ
여	ᄋ ᅧ
곳의	ᄀ ᅩ ᄉ ᅴ
매장	ᄆ ᅢ ᄌ ᅡ ᆼ
닫았고	ᄃ ᅡ ᄃ ᅡ ᆮ ᄁ ᅩ
승승장구하던	ᄉ ᅳ ᆼ ᄉ ᅳ ᆼ ᄌ ᅡ ᆼ ᄀ ᅮ ᄒ ᅡ ᄃ ᅥ ᆫ
천구백구십년대와	ᄎ ᅥ ᆫ ᄀ ᅮ ᄇ ᅢ ᆨ ᄁ ᅮ ᄉ ᅵ ᆷ ᄂ ᅧ ᆫ ᄃ ᅢ ᄋ ᅪ
이천십팔년을	ᄋ ᅵ ᄎ ᅥ ᆫ ᄉ ᅵ ᆸ ᄑ ᅡ ᆯ ᄅ ᅧ ᄂ ᅳ ᆯ
비교할	ᄇ ᅵ ᄀ ᅭ ᄒ ᅡ ᆯ
노는	ᄂ ᅩ ᄂ ᅳ ᆫ
달라졌어요	ᄃ ᅡ ᆯ ᄅ ᅡ ᄌ ᅥ ᄊ ᅥ ᄋ ᅭ
과거에는	ᄀ ᅪ ᄀ ᅥ ᄋ ᅦ ᄂ ᅳ ᆫ
장난감을	ᄌ ᅡ ᆼ ᄂ ᅡ ᆫ ᄀ ᅡ ᄆ ᅳ ᆯ
놀았지만	ᄂ ᅩ ᄅ ᅡ ᆮ ᄍ ᅵ ᄆ ᅡ ᆫ
자리는	ᄌ ᅡ ᄅ ᅵ ᄂ ᅳ ᆫ
스마트폰이	ᄉ ᅳ ᄆ ᅡ ᄐ ᅳ ᄑ ᅩ ᄂ ᅵ
차지하고	ᄎ ᅡ ᄌ ᅵ ᄒ ᅡ ᄀ ᅩ
놀잇감이	ᄂ ᅩ ᄅ ᅵ ᆮ ᄁ ᅡ ᄆ ᅵ
게임과	ᄀ ᅦ ᄋ ᅵ ᆷ ᄀ ᅪ
동영상으로	ᄃ ᅩ ᆼ ᄋ ᅧ ᆼ ᄉ ᅡ ᆼ ᄋ ᅳ ᄅ ᅩ
바뀌면서	ᄇ ᅡ ᄁ ᅱ ᄆ ᅧ ᆫ ᄉ ᅥ
줄어든	ᄌ ᅮ ᄅ ᅥ ᄃ ᅳ ᆫ
수요가	ᄉ ᅮ ᄋ ᅭ ᄀ ᅡ
줄어드니	ᄌ ᅮ ᄅ ᅥ ᄃ ᅳ ᄂ ᅵ
토이저러스의	ᄐ ᅩ ᄋ ᅵ ᄌ ᅥ ᄅ ᅥ ᄉ ᅳ ᄋ ᅴ
매출은	ᄆ ᅢ ᄎ ᅮ ᄅ ᅳ ᆫ
줄어들	ᄌ ᅮ ᄅ ᅥ ᄃ ᅳ ᆯ
밖에요	ᄇ ᅡ ᄁ ᅦ ᄋ ᅭ
구매방법이	ᄀ ᅮ ᄆ ᅢ ᄇ ᅡ ᆼ ᄇ ᅥ ᄇ ᅵ
달라졌다	ᄃ ᅡ ᆯ ᄅ ᅡ ᄌ ᅥ ᆮ ᄄ ᅡ
별명은	ᄇ ᅧ ᆯ ᄆ ᅧ ᆼ ᄋ ᅳ ᆫ
장난감의	ᄌ ᅡ ᆼ ᄂ ᅡ ᆫ ᄀ ᅡ ᄆ ᅴ
슈퍼마켓	ᄉ ᅲ ᄑ ᅥ ᄆ ᅡ ᄏ ᅦ ᆮ
장난감이	ᄌ ᅡ ᆼ ᄂ ᅡ ᆫ ᄀ ᅡ ᄆ ᅵ
구비돼	ᄀ ᅮ ᄇ ᅵ ᄃ ᅫ
체험	ᄎ ᅦ ᄒ ᅥ ᆷ
해보고	ᄒ ᅢ ᄇ ᅩ ᄀ ᅩ
비교하고	ᄇ ᅵ ᄀ ᅭ ᄒ ᅡ ᄀ ᅩ
드는	ᄃ ᅳ ᄂ ᅳ ᆫ
골랐어요	ᄀ ᅩ ᆯ ᄅ ᅡ ᄊ ᅥ ᄋ ᅭ
기술이	ᄀ ᅵ ᄉ ᅮ ᄅ ᅵ
발전하면서	ᄇ ᅡ ᆯ ᄍ ᅥ ᆫ ᄒ ᅡ ᄆ ᅧ ᆫ ᄉ ᅥ
변화가	ᄇ ᅧ ᆫ ᄒ ᅪ ᄀ ᅡ
생겼어요	ᄉ ᅢ ᆼ ᄀ ᅧ ᄊ ᅥ ᄋ ᅭ
쇼핑의	ᄉ ᅭ ᄑ ᅵ ᆼ ᄋ ᅴ
등장이에요	ᄃ ᅳ ᆼ ᄌ ᅡ ᆼ ᄋ ᅵ ᄋ ᅦ ᄋ ᅭ
상품에	ᄉ ᅡ ᆼ ᄑ ᅮ ᄆ ᅦ
쉬워졌고	ᄉ ᅱ ᄋ ᅯ ᄌ ᅥ ᆮ ᄁ ᅩ
집에서	ᄌ ᅵ ᄇ ᅦ ᄉ ᅥ
편하게	ᄑ ᅧ ᆫ ᄒ ᅡ ᄀ ᅦ
있게	ᄋ ᅵ ᆮ ᄁ ᅦ
가야	ᄀ ᅡ ᄋ ᅣ
이유가	ᄋ ᅵ ᄋ ᅲ ᄀ ᅡ
약해졌어요	ᄋ ᅣ ᄏ ᅢ ᄌ ᅥ ᄊ ᅥ ᄋ ᅭ
불을	ᄇ ᅮ ᄅ ᅳ ᆯ
댕긴	ᄃ ᅢ ᆼ ᄀ ᅵ ᆫ
전역에서	ᄌ ᅥ ᄂ ᅧ ᄀ ᅦ ᄉ ᅥ
평가가	ᄑ ᅧ ᆼ ᄀ ᅡ ᄀ ᅡ
올라오고	ᄋ ᅩ ᆯ ᄅ ᅡ ᄋ ᅩ ᄀ ᅩ
그것도	ᄀ ᅳ ᄀ ᅥ ᆮ ᄄ ᅩ
어디든	ᄋ ᅥ ᄃ ᅵ ᄃ ᅳ ᆫ
배달을	ᄇ ᅢ ᄃ ᅡ ᄅ ᅳ ᆯ
해주는	ᄒ ᅢ ᄌ ᅮ ᄂ ᅳ ᆫ
거대한	ᄀ ᅥ ᄃ ᅢ ᄒ ᅡ ᆫ
매장이	ᄆ ᅢ ᄌ ᅡ ᆼ ᄋ ᅵ
등장	ᄃ ᅳ ᆼ ᄌ ᅡ ᆼ
아마존이예요	ᄋ ᅡ ᄆ ᅡ ᄌ ᅩ ᄂ ᅵ ᄋ ᅨ ᄋ ᅭ
최대의	ᄎ ᅬ ᄃ ᅢ ᄋ ᅴ
수백여	ᄉ ᅮ ᄇ ᅢ ᄀ ᅧ
유지해야	ᄋ ᅲ ᄌ ᅵ ᄒ ᅢ ᄋ ᅣ
필요가	ᄑ ᅵ ᄅ ᅭ ᄀ ᅡ
토지	ᄐ ᅩ ᄌ ᅵ
임대료	ᄋ ᅵ ᆷ ᄃ ᅢ ᄅ ᅭ
전기료	ᄌ ᅥ ᆫ ᄀ ᅵ ᄅ ᅭ
유지하기	ᄋ ᅲ ᄌ ᅵ ᄒ ᅡ ᄀ ᅵ
인건비	ᄋ ᅵ ᆫ ᄀ ᅥ ᆫ ᄇ ᅵ
면에서	ᄆ ᅧ ᄂ ᅦ ᄉ ᅥ
강했어요	ᄀ ᅡ ᆼ ᄒ ᅢ ᄊ ᅥ ᄋ ᅭ
장난감이라도	ᄌ ᅡ ᆼ ᄂ ᅡ ᆫ ᄀ ᅡ ᄆ ᅵ ᄅ ᅡ ᄃ ᅩ
공간의	ᄀ ᅩ ᆼ ᄀ ᅡ ᄂ ᅴ
제한이	ᄌ ᅦ ᄒ ᅡ ᄂ ᅵ
품목을	ᄑ ᅮ ᆷ ᄆ ᅩ ᄀ ᅳ ᆯ
보여줄	ᄇ ᅩ ᄋ ᅧ ᄌ ᅮ ᆯ
소비자들은	ᄉ ᅩ ᄇ ᅵ ᄌ ᅡ ᄃ ᅳ ᄅ ᅳ ᆫ
한순간에	ᄒ ᅡ ᆫ ᄉ ᅮ ᆫ ᄀ ᅡ ᄂ ᅦ
밀려날	ᄆ ᅵ ᆯ ᄅ ᅧ ᄂ ᅡ ᆯ
교훈이죠	ᄀ ᅭ ᄒ ᅮ ᄂ ᅵ ᄌ ᅭ
변화의	ᄇ ᅧ ᆫ ᄒ ᅪ ᄋ ᅴ
여파가	ᄋ ᅧ ᄑ ᅡ ᄀ ᅡ
미국만	ᄆ ᅵ ᄀ ᅮ ᆼ ᄆ ᅡ ᆫ
해당되는	ᄒ ᅢ ᄃ ᅡ ᆼ ᄃ ᅬ ᄂ ᅳ ᆫ
이미	ᄋ ᅵ ᄆ ᅵ
곁에도	ᄀ ᅧ ᄐ ᅦ ᄃ ᅩ
다가오고	ᄃ ᅡ ᄀ ᅡ ᄋ ᅩ ᄀ ᅩ
철수하면	ᄎ ᅥ ᆯ ᄉ ᅮ ᄒ ᅡ ᄆ ᅧ ᆫ
매장도	ᄆ ᅢ ᄌ ᅡ ᆼ ᄃ ᅩ
닫을지	ᄃ ᅡ ᄃ ᅳ ᆯ ᄌ ᅵ
몰라	ᄆ ᅩ ᆯ ᄅ ᅡ
토이저러스를	ᄐ ᅩ ᄋ ᅵ ᄌ ᅥ ᄅ ᅥ ᄉ ᅳ ᄅ ᅳ ᆯ
궁지로	ᄀ ᅮ ᆼ ᄌ ᅵ ᄅ ᅩ
몰아넣은	ᄆ ᅩ ᄅ ᅡ ᄂ ᅥ ᄋ ᅳ ᆫ
쇼핑몰인	ᄉ ᅭ ᄑ ᅵ ᆼ ᄆ ᅩ ᄅ ᅵ ᆫ
거라는	ᄀ ᅥ ᄅ ᅡ ᄂ ᅳ ᆫ
끊이지	ᄁ ᅳ ᄂ ᅵ ᄌ ᅵ
유통구조로	ᄋ ᅲ ᄐ ᅩ ᆼ ᄀ ᅮ ᄌ ᅩ ᄅ ᅩ
유명한	ᄋ ᅲ ᄆ ᅧ ᆼ ᄒ ᅡ ᆫ
일본에	ᄋ ᅵ ᆯ ᄇ ᅩ ᄂ ᅦ
진출한	ᄌ ᅵ ᆫ ᄎ ᅮ ᆯ ᄒ ᅡ ᆫ
지나지	ᄌ ᅵ ᄂ ᅡ ᄌ ᅵ
쇼핑	ᄉ ᅭ ᄑ ᅵ ᆼ
업계	ᄋ ᅥ ᆸ ᄁ ᅨ
위에	ᄋ ᅱ ᄋ ᅦ
오른	ᄋ ᅩ ᄅ ᅳ ᆫ
지구상	ᄌ ᅵ ᄀ ᅮ ᄉ ᅡ ᆼ
최강의	ᄎ ᅬ ᄀ ᅡ ᆼ ᄋ ᅴ
만약	ᄆ ᅡ ᄂ ᅣ ᆨ
한다면	ᄒ ᅡ ᆫ ᄃ ᅡ ᄆ ᅧ ᆫ
될까요	ᄃ ᅬ ᆯ ᄁ ᅡ ᄋ ᅭ
영향도	ᄋ ᅧ ᆼ ᄒ ᅣ ᆼ ᄃ ᅩ
철수	ᄎ ᅥ ᆯ ᄉ ᅮ
보도가	ᄇ ᅩ ᄃ ᅩ ᄀ ᅡ
위	ᄋ ᅱ
유통업체들의	ᄋ ᅲ ᄐ ᅩ ᆼ ᄋ ᅥ ᆸ ᄎ ᅦ ᄃ ᅳ ᄅ ᅴ
주가도	ᄌ ᅮ ᄀ ᅡ ᄃ ᅩ
떨어졌어요	ᄄ ᅥ ᄅ ᅥ ᄌ ᅥ ᄊ ᅥ ᄋ ᅭ
업체인	ᄋ ᅥ ᆸ ᄎ ᅦ ᄋ ᅵ ᆫ
손오공은	ᄉ ᅩ ᄂ ᅩ ᄀ ᅩ ᆼ ᄋ ᅳ ᆫ
오히려	ᄋ ᅩ ᄒ ᅵ ᄅ ᅧ
주가가	ᄌ ᅮ ᄀ ᅡ ᄀ ᅡ
올랐어요	ᄋ ᅩ ᆯ ᄅ ᅡ ᄊ ᅥ ᄋ ᅭ
무너지면서	ᄆ ᅮ ᄂ ᅥ ᄌ ᅵ ᄆ ᅧ ᆫ ᄉ ᅥ
빈자리를	ᄇ ᅵ ᆫ ᄌ ᅡ ᄅ ᅵ ᄅ ᅳ ᆯ
채우면	ᄎ ᅢ ᄋ ᅮ ᄆ ᅧ ᆫ
성장	ᄉ ᅥ ᆼ ᄌ ᅡ ᆼ
기회를	ᄀ ᅵ ᄒ ᅬ ᄅ ᅳ ᆯ
잡을	ᄌ ᅡ ᄇ ᅳ ᆯ
분석에서	ᄇ ᅮ ᆫ ᄉ ᅥ ᄀ ᅦ ᄉ ᅥ
언론에서	ᄋ ᅥ ᆯ ᄅ ᅩ ᄂ ᅦ ᄉ ᅥ
보도하고	ᄇ ᅩ ᄃ ᅩ ᄒ ᅡ ᄀ ᅩ
전문가들의	ᄌ ᅥ ᆫ ᄆ ᅮ ᆫ ᄀ ᅡ ᄃ ᅳ ᄅ ᅴ
대담에서도	ᄃ ᅢ ᄃ ᅡ ᄆ ᅦ ᄉ ᅥ ᄃ ᅩ
다뤄지고	ᄃ ᅡ ᄅ ᅯ ᄌ ᅵ ᄀ ᅩ
머라고	ᄆ ᅥ ᄅ ᅡ ᄀ ᅩ
뉴스로	ᄂ ᅲ ᄉ ᅳ ᄅ ᅩ
다룰까요	ᄃ ᅡ ᄅ ᅮ ᆯ ᄁ ᅡ ᄋ ᅭ
엥겔	ᄋ ᅦ ᆼ ᄀ ᅦ ᆯ
지수의	ᄌ ᅵ ᄉ ᅮ ᄋ ᅴ
상승은	ᄉ ᅡ ᆼ ᄉ ᅳ ᆼ ᄋ ᅳ ᆫ
단면을	ᄃ ᅡ ᆫ ᄆ ᅧ ᄂ ᅳ ᆯ
담고	ᄃ ᅡ ᆷ ᄁ ᅩ
무엇인지	ᄆ ᅮ ᄋ ᅥ ᄉ ᅵ ᆫ ᄌ ᅵ
차근차근	ᄎ ᅡ ᄀ ᅳ ᆫ ᄎ ᅡ ᄀ ᅳ ᆫ
알아보겠습니다	ᄋ ᅡ ᄅ ᅡ ᄇ ᅩ ᄀ ᅦ ᆮ ᄊ ᅳ ᆷ ᄂ ᅵ ᄃ ᅡ
지수	ᄌ ᅵ ᄉ ᅮ
통계를	ᄐ ᅩ ᆼ ᄀ ᅨ ᄅ ᅳ ᆯ
분기	ᄇ ᅮ ᆫ ᄀ ᅵ
구월	ᄀ ᅮ ᄋ ᅯ ᆯ
소비	ᄉ ᅩ ᄇ ᅵ
지출액은	ᄌ ᅵ ᄎ ᅮ ᄅ ᅢ ᄀ ᅳ ᆫ
오백칠십삼조	ᄋ ᅩ ᄇ ᅢ ᆨ ᄎ ᅵ ᆯ ᄉ ᅵ ᆸ ᄊ ᅡ ᆷ ᄌ ᅩ
육천육	ᄋ ᅲ ᆨ ᄎ ᅥ ᄂ ᅲ ᆨ
이십육	ᄋ ᅵ ᄉ ᅵ ᄇ ᅲ ᆨ
점	ᄌ ᅥ ᆷ
퍼센트로	ᄑ ᅥ ᄉ ᅦ ᆫ ᄐ ᅳ ᄅ ᅩ
떨어졌고	ᄄ ᅥ ᄅ ᅥ ᄌ ᅥ ᆮ ᄁ ᅩ
이천년에는	ᄋ ᅵ ᄎ ᅥ ᆫ ᄂ ᅧ ᄂ ᅦ ᄂ ᅳ ᆫ
구	ᄀ ᅮ
이천칠년에는	ᄋ ᅵ ᄎ ᅥ ᆫ ᄎ ᅵ ᆯ ᄅ ᅧ ᄂ ᅦ ᄂ ᅳ ᆫ
십이	ᄉ ᅵ ᄇ ᅵ
퍼센트까지	ᄑ ᅥ ᄉ ᅦ ᆫ ᄐ ᅳ ᄁ ᅡ ᄌ ᅵ
지속적으로	ᄌ ᅵ ᄉ ᅩ ᆨ ᄍ ᅥ ᄀ ᅳ ᄅ ᅩ
떨어졌습니다	ᄄ ᅥ ᄅ ᅥ ᄌ ᅥ ᆮ ᄊ ᅳ ᆷ ᄂ ᅵ ᄃ ᅡ
지수가	ᄌ ᅵ ᄉ ᅮ ᄀ ᅡ
낮아질수록	ᄂ ᅡ ᄌ ᅡ ᄌ ᅵ ᆯ ᄊ ᅮ ᄅ ᅩ ᆨ
살게	ᄉ ᅡ ᆯ ᄀ ᅦ
뜻이며	ᄄ ᅳ ᄉ ᅵ ᄆ ᅧ
아래를	ᄋ ᅡ ᄅ ᅢ ᄅ ᅳ ᆯ
선진국으로	ᄉ ᅥ ᆫ ᄌ ᅵ ᆫ ᄀ ᅮ ᄀ ᅳ ᄅ ᅩ
분류	ᄇ ᅮ ᆯ ᄅ ᅲ
돼지고기	ᄃ ᅫ ᄌ ᅵ ᄀ ᅩ ᄀ ᅵ
먹거리	ᄆ ᅥ ᆨ ᄁ ᅥ ᄅ ᅵ
소득은	ᄉ ᅩ ᄃ ᅳ ᄀ ᅳ ᆫ
제자리	ᄌ ᅦ ᄌ ᅡ ᄅ ᅵ
걸음인데	ᄀ ᅥ ᄅ ᅳ ᄆ ᅵ ᆫ ᄃ ᅦ
식료품에	ᄉ ᅵ ᆼ ᄂ ᅭ ᄑ ᅮ ᄆ ᅦ
늘어나니까	ᄂ ᅳ ᄅ ᅥ ᄂ ᅡ ᄂ ᅵ ᄁ ᅡ
올랐다는	ᄋ ᅩ ᆯ ᄅ ᅡ ᆮ ᄄ ᅡ ᄂ ᅳ ᆫ
분석	ᄇ ᅮ ᆫ ᄉ ᅥ ᆨ
즐기자	ᄌ ᅳ ᆯ ᄀ ᅵ ᄌ ᅡ
먹을거리	ᄆ ᅥ ᄀ ᅳ ᆯ ᄀ ᅥ ᄅ ᅵ
행복을	ᄒ ᅢ ᆼ ᄇ ᅩ ᄀ ᅳ ᆯ
중요하게	ᄌ ᅮ ᆼ ᄋ ᅭ ᄒ ᅡ ᄀ ᅦ
여기면서	ᄋ ᅧ ᄀ ᅵ ᄆ ᅧ ᆫ ᄉ ᅥ
소비를	ᄉ ᅩ ᄇ ᅵ ᄅ ᅳ ᆯ
늘리는	ᄂ ᅳ ᆯ ᄅ ᅵ ᄂ ᅳ ᆫ
욜로족처럼	ᄋ ᅭ ᆯ ᄅ ᅩ ᄌ ᅩ ᆨ ᄎ ᅥ ᄅ ᅥ ᆷ
세태의	ᄉ ᅦ ᄐ ᅢ ᄋ ᅴ
변화도	ᄇ ᅧ ᆫ ᄒ ᅪ ᄃ ᅩ
요인으로	ᄋ ᅭ ᄋ ᅵ ᄂ ᅳ ᄅ ᅩ
꼽혀요	ᄁ ᅩ ᄑ ᅧ ᄋ ᅭ
재산을	ᄌ ᅢ ᄉ ᅡ ᄂ ᅳ ᆯ
모아서	ᄆ ᅩ ᄋ ᅡ ᄉ ᅥ
준비하는	ᄌ ᅮ ᆫ ᄇ ᅵ ᄒ ᅡ ᄂ ᅳ ᆫ
힘들어지다	ᄒ ᅵ ᆷ ᄃ ᅳ ᄅ ᅥ ᄌ ᅵ ᄃ ᅡ
현재를	ᄒ ᅧ ᆫ ᄌ ᅢ ᄅ ᅳ ᆯ
즐기자는	ᄌ ᅳ ᆯ ᄀ ᅵ ᄌ ᅡ ᄂ ᅳ ᆫ
욜로족이죠	ᄋ ᅭ ᆯ ᄅ ᅩ ᄌ ᅩ ᄀ ᅵ ᄌ ᅭ
유명	ᄋ ᅲ ᄆ ᅧ ᆼ
요리사가	ᄋ ᅭ ᄅ ᅵ ᄉ ᅡ ᄀ ᅡ
프로그램에서	ᄑ ᅳ ᄅ ᅩ ᄀ ᅳ ᄅ ᅢ ᄆ ᅦ ᄉ ᅥ
비중을	ᄇ ᅵ ᄌ ᅮ ᆼ ᄋ ᅳ ᆯ
에스엔에스	ᄋ ᅦ ᄉ ᅳ ᄋ ᅦ ᄂ ᅦ ᄉ ᅳ
소셜	ᄉ ᅩ ᄉ ᅧ ᆯ
네트워크	ᄂ ᅦ ᄐ ᅳ ᄋ ᅯ ᄏ ᅳ
상에서	ᄉ ᅡ ᆼ ᄋ ᅦ ᄉ ᅥ
맛집	ᄆ ᅡ ᆮ ᄍ ᅵ ᆸ
소개는	ᄉ ᅩ ᄀ ᅢ ᄂ ᅳ ᆫ
대세	ᄃ ᅢ ᄉ ᅦ
중의	ᄌ ᅮ ᆼ ᄋ ᅴ
외식	ᄋ ᅬ ᄉ ᅵ ᆨ
시장도	ᄉ ᅵ ᄌ ᅡ ᆼ ᄃ ᅩ
커지고	ᄏ ᅥ ᄌ ᅵ ᄀ ᅩ
규모는	ᄀ ᅲ ᄆ ᅩ ᄂ ᅳ ᆫ
팔조	ᄑ ᅡ ᆯ ᄌ ᅩ
구천	ᄀ ᅮ ᄎ ᅥ ᆫ
이르고	ᄋ ᅵ ᄅ ᅳ ᄀ ᅩ
쓰는	ᄊ ᅳ ᄂ ᅳ ᆫ
지수도	ᄌ ᅵ ᄉ ᅮ ᄃ ᅩ
높아지고	ᄂ ᅩ ᄑ ᅡ ᄌ ᅵ ᄀ ᅩ
먹방	ᄆ ᅥ ᆨ ᄈ ᅡ ᆼ
프로그램을	ᄑ ᅳ ᄅ ᅩ ᄀ ᅳ ᄅ ᅢ ᄆ ᅳ ᆯ
맛있다고	ᄆ ᅡ ᄉ ᅵ ᆮ ᄄ ᅡ ᄀ ᅩ
외치고	ᄋ ᅬ ᄎ ᅵ ᄀ ᅩ
방송국	ᄇ ᅡ ᆼ ᄉ ᅩ ᆼ ᄀ ᅮ ᆨ
관계자들이나	ᄀ ᅪ ᆫ ᄀ ᅨ ᄌ ᅡ ᄃ ᅳ ᄅ ᅵ ᄂ ᅡ
비제이들은	ᄇ ᅵ ᄌ ᅦ ᄋ ᅵ ᄃ ᅳ ᄅ ᅳ ᆫ
상승에	ᄉ ᅡ ᆼ ᄉ ᅳ ᆼ ᄋ ᅦ
아닐까요	ᄋ ᅡ ᄂ ᅵ ᆯ ᄁ ᅡ ᄋ ᅭ
증가해야	ᄌ ᅳ ᆼ ᄀ ᅡ ᄒ ᅢ ᄋ ᅣ
증가에	ᄌ ᅳ ᆼ ᄀ ᅡ ᄋ ᅦ
지출	ᄌ ᅵ ᄎ ᅮ ᆯ
증가	ᄌ ᅳ ᆼ ᄀ ᅡ
뜻을	ᄄ ᅳ ᄉ ᅳ ᆯ
증가라는	ᄌ ᅳ ᆼ ᄀ ᅡ ᄅ ᅡ ᄂ ᅳ ᆫ
기사에는	ᄀ ᅵ ᄉ ᅡ ᄋ ᅦ ᄂ ᅳ ᆫ
국민들의	ᄀ ᅮ ᆼ ᄆ ᅵ ᆫ ᄃ ᅳ ᄅ ᅴ
살림살이가	ᄉ ᅡ ᆯ ᄅ ᅵ ᆷ ᄉ ᅡ ᄅ ᅵ ᄀ ᅡ
힘들어	ᄒ ᅵ ᆷ ᄃ ᅳ ᄅ ᅥ
졌다는	ᄌ ᅥ ᆮ ᄄ ᅡ ᄂ ᅳ ᆫ
먹을	ᄆ ᅥ ᄀ ᅳ ᆯ
데는	ᄃ ᅦ ᄂ ᅳ ᆫ
한계가	ᄒ ᅡ ᆫ ᄀ ᅨ ᄀ ᅡ
지출은	ᄌ ᅵ ᄎ ᅮ ᄅ ᅳ ᆫ
이대로	ᄋ ᅵ ᄃ ᅢ ᄅ ᅩ
간다면	ᄀ ᅡ ᆫ ᄃ ᅡ ᄆ ᅧ ᆫ
앵겔	ᄋ ᅢ ᆼ ᄀ ᅦ ᆯ
지수는	ᄌ ᅵ ᄉ ᅮ ᄂ ᅳ ᆫ
높아지겠죠	ᄂ ᅩ ᄑ ᅡ ᄌ ᅵ ᄀ ᅦ ᆮ ᄍ ᅭ
결론은	ᄀ ᅧ ᆯ ᄅ ᅩ ᄂ ᅳ ᆫ
상처를	ᄉ ᅡ ᆼ ᄎ ᅥ ᄅ ᅳ ᆯ
입는다	ᄋ ᅵ ᆷ ᄂ ᅳ ᆫ ᄃ ᅡ
한국은행은	ᄒ ᅡ ᆫ ᄀ ᅮ ᄀ ᅳ ᆫ ᄒ ᅢ ᆼ ᄋ ᅳ ᆫ
상처가	ᄉ ᅡ ᆼ ᄎ ᅥ ᄀ ᅡ
회수해서	ᄒ ᅬ ᄉ ᅮ ᄒ ᅢ ᄉ ᅥ
폐기한다	ᄑ ᅨ ᄀ ᅵ ᄒ ᅡ ᆫ ᄃ ᅡ
폐기한	ᄑ ᅨ ᄀ ᅵ ᄒ ᅡ ᆫ
육억에	ᄋ ᅲ ᄀ ᅥ ᄀ ᅦ
액수로는	ᄋ ᅢ ᆨ ᄊ ᅮ ᄅ ᅩ ᄂ ᅳ ᆫ
삼조	ᄉ ᅡ ᆷ ᄌ ᅩ
칠천육백오십삼	ᄎ ᅵ ᆯ ᄎ ᅥ ᄂ ᅲ ᆨ ᄈ ᅢ ᄀ ᅩ ᄉ ᅵ ᆸ ᄊ ᅡ ᆷ
어치다	ᄋ ᅥ ᄎ ᅵ ᄃ ᅡ
은행권	ᄋ ᅳ ᆫ ᄒ ᅢ ᆼ ᄀ ᅯ ᆫ
지폐는	ᄌ ᅵ ᄑ ᅨ ᄂ ᅳ ᆫ
오억	ᄋ ᅩ ᄋ ᅥ ᆨ
삼천만	ᄉ ᅡ ᆷ ᄎ ᅥ ᆫ ᄆ ᅡ ᆫ
장으로	ᄌ ᅡ ᆼ ᄋ ᅳ ᄅ ᅩ
오톤	ᄋ ᅩ ᄐ ᅩ ᆫ
트럭	ᄐ ᅳ ᄅ ᅥ ᆨ
구십구대를	ᄀ ᅮ ᄉ ᅵ ᆸ ᄁ ᅮ ᄃ ᅢ ᄅ ᅳ ᆯ
채울	ᄎ ᅢ ᄋ ᅮ ᆯ
양이다	ᄋ ᅣ ᆼ ᄋ ᅵ ᄃ ᅡ
백두산	ᄇ ᅢ ᆨ ᄄ ᅮ ᄉ ᅡ ᆫ
높이의	ᄂ ᅩ ᄑ ᅵ ᄋ ᅴ
이십일	ᄋ ᅵ ᄉ ᅵ ᄇ ᅵ ᆯ
연결하면	ᄋ ᅧ ᆫ ᄀ ᅧ ᆯ ᄒ ᅡ ᄆ ᅧ ᆫ
경부고속도로를	ᄀ ᅧ ᆼ ᄇ ᅮ ᄀ ᅩ ᄉ ᅩ ᆨ ᄄ ᅩ ᄅ ᅩ ᄅ ᅳ ᆯ
칠십오	ᄎ ᅵ ᆯ ᄉ ᅵ ᄇ ᅩ
회	ᄒ ᅬ
왕복	ᄋ ᅪ ᆼ ᄇ ᅩ ᆨ
은행은	ᄋ ᅳ ᆫ ᄒ ᅢ ᆼ ᄋ ᅳ ᆫ
밝혔다	ᄇ ᅡ ᆯ ᄏ ᅧ ᆮ ᄄ ᅡ
상처	ᄉ ᅡ ᆼ ᄎ ᅥ
입은	ᄋ ᅵ ᄇ ᅳ ᆫ
불타거나	ᄇ ᅮ ᆯ ᄐ ᅡ ᄀ ᅥ ᄂ ᅡ
장판	ᄌ ᅡ ᆼ ᄑ ᅡ ᆫ
밑에	ᄆ ᅵ ᄐ ᅦ
잘못	ᄌ ᅡ ᆯ ᄆ ᅩ ᆮ
보관한	ᄇ ᅩ ᄀ ᅪ ᆫ ᄒ ᅡ ᆫ
교환해	ᄀ ᅭ ᄒ ᅪ ᆫ ᄒ ᅢ
한국은행	ᄒ ᅡ ᆫ ᄀ ᅮ ᄀ ᅳ ᆫ ᄒ ᅢ ᆼ
창구에서	ᄎ ᅡ ᆼ ᄀ ᅮ ᄋ ᅦ ᄉ ᅥ
교환한	ᄀ ᅭ ᄒ ᅪ ᆫ ᄒ ᅡ ᆫ
손상	ᄉ ᅩ ᆫ ᄉ ᅡ ᆼ
화폐는	ᄒ ᅪ ᄑ ᅨ ᄂ ᅳ ᆫ
사십육억	ᄉ ᅡ ᄉ ᅵ ᄇ ᅲ ᄀ ᅥ ᆨ
천만	ᄎ ᅥ ᆫ ᄆ ᅡ ᆫ
원이다	ᄋ ᅯ ᄂ ᅵ ᄃ ᅡ
만	ᄆ ᅡ ᆫ
원짜리	ᄋ ᅯ ᆫ ᄍ ᅡ ᄅ ᅵ
십사억	ᄉ ᅵ ᆸ ᄊ ᅡ ᄋ ᅥ ᆨ
칠천만	ᄎ ᅵ ᆯ ᄎ ᅥ ᆫ ᄆ ᅡ ᆫ
원어치로	ᄋ ᅯ ᄂ ᅥ ᄎ ᅵ ᄅ ᅩ
지폐	ᄌ ᅵ ᄑ ᅨ
교환액에	ᄀ ᅭ ᄒ ᅪ ᄂ ᅢ ᄀ ᅦ
육십구	ᄋ ᅲ ᆨ ᄊ ᅵ ᆸ ᄁ ᅮ
퍼센트를	ᄑ ᅥ ᄉ ᅦ ᆫ ᄐ ᅳ ᄅ ᅳ ᆯ
멀쩡한	ᄆ ᅥ ᆯ ᄍ ᅥ ᆼ ᄒ ᅡ ᆫ
사용해서	ᄉ ᅡ ᄋ ᅭ ᆼ ᄒ ᅢ ᄉ ᅥ
손상되	ᄉ ᅩ ᆫ ᄉ ᅡ ᆼ ᄃ ᅬ
봐꾼	ᄇ ᅪ ᄁ ᅮ ᆫ
금액도	ᄀ ᅳ ᄆ ᅢ ᆨ ᄄ ᅩ
이십칠	ᄋ ᅵ ᄉ ᅵ ᆸ ᄎ ᅵ ᆯ
퍼센트나	ᄑ ᅥ ᄉ ᅦ ᆫ ᄐ ᅳ ᄂ ᅡ
증가했다	ᄌ ᅳ ᆼ ᄀ ᅡ ᄒ ᅢ ᆮ ᄄ ᅡ
폐기된	ᄑ ᅨ ᄀ ᅵ ᄃ ᅬ ᆫ
찍어야	ᄍ ᅵ ᄀ ᅥ ᄋ ᅣ
세금이	ᄉ ᅦ ᄀ ᅳ ᄆ ᅵ
육백십	ᄋ ᅲ ᆨ ᄈ ᅢ ᆨ ᄊ ᅵ ᆸ
칠억	ᄎ ᅵ ᄅ ᅥ ᆨ
우리가	ᄋ ᅮ ᄅ ᅵ ᄀ ᅡ
깨끗하게	ᄁ ᅢ ᄁ ᅳ ᄐ ᅡ ᄀ ᅦ
사용하고	ᄉ ᅡ ᄋ ᅭ ᆼ ᄒ ᅡ ᄀ ᅩ
올바로	ᄋ ᅩ ᆯ ᄇ ᅡ ᄅ ᅩ
개인적으로	ᄀ ᅢ ᄋ ᅵ ᆫ ᄌ ᅥ ᄀ ᅳ ᄅ ᅩ
지키는	ᄌ ᅵ ᄏ ᅵ ᄂ ᅳ ᆫ
일이며	ᄋ ᅵ ᄅ ᅵ ᄆ ᅧ
세금을	ᄉ ᅦ ᄀ ᅳ ᄆ ᅳ ᆯ
아끼는	ᄋ ᅡ ᄁ ᅵ ᄂ ᅳ ᆫ
지폐의	ᄌ ᅵ ᄑ ᅨ ᄋ ᅴ
면적의	ᄆ ᅧ ᆫ ᄌ ᅥ ᄀ ᅴ
남아	ᄂ ᅡ ᄆ ᅡ
해당	ᄒ ᅢ ᄃ ᅡ ᆼ
바꿔주며	ᄇ ᅡ ᄁ ᅯ ᄌ ᅮ ᄆ ᅧ
오십에서	ᄋ ᅩ ᄉ ᅵ ᄇ ᅦ ᄉ ᅥ
칠십사	ᄎ ᅵ ᆯ ᄉ ᅵ ᆸ ᄊ ᅡ
퍼센트는	ᄑ ᅥ ᄉ ᅦ ᆫ ᄐ ᅳ ᄂ ᅳ ᆫ
바꿔준다	ᄇ ᅡ ᄁ ᅯ ᄌ ᅮ ᆫ ᄃ ᅡ
오십	ᄋ ᅩ ᄉ ᅵ ᆸ
미만은	ᄆ ᅵ ᄆ ᅡ ᄂ ᅳ ᆫ
살아가	ᄉ ᅡ ᄅ ᅡ ᄀ ᅡ
면서	ᄆ ᅧ ᆫ ᄉ ᅥ
겪는	ᄀ ᅧ ᆼ ᄂ ᅳ ᆫ
경제활동	ᄀ ᅧ ᆼ ᄌ ᅦ ᄒ ᅪ ᆯ ᄃ ᅩ ᆼ
얽혀	ᄋ ᅥ ᆯ ᄏ ᅧ
예상치	ᄋ ᅨ ᄉ ᅡ ᆼ ᄎ ᅵ
현상을	ᄒ ᅧ ᆫ ᄉ ᅡ ᆼ ᄋ ᅳ ᆯ
가져와	ᄀ ᅡ ᄌ ᅥ ᄋ ᅪ
끌고	ᄁ ᅳ ᆯ ᄀ ᅩ
택시가	ᄐ ᅢ ᆨ ᄊ ᅵ ᄀ ᅡ
어디쯤	ᄋ ᅥ ᄃ ᅵ ᄍ ᅳ ᆷ
어디	ᄋ ᅥ ᄃ ᅵ
오는지	ᄋ ᅩ ᄂ ᅳ ᆫ ᄌ ᅵ
택시	ᄐ ᅢ ᆨ ᄊ ᅵ
기사와	ᄀ ᅵ ᄉ ᅡ ᄋ ᅪ
서로를	ᄉ ᅥ ᄅ ᅩ ᄅ ᅳ ᆯ
평가해	ᄑ ᅧ ᆼ ᄀ ᅡ ᄒ ᅢ
서비스의	ᄉ ᅥ ᄇ ᅵ ᄉ ᅳ ᄋ ᅴ
질을	ᄌ ᅵ ᄅ ᅳ ᆯ
유지하는	ᄋ ᅲ ᄌ ᅵ ᄒ ᅡ ᄂ ᅳ ᆫ
설계	ᄉ ᅥ ᆯ ᄀ ᅨ
안심	ᄋ ᅡ ᆫ ᄉ ᅵ ᆷ
메시지	ᄆ ᅦ ᄉ ᅵ ᄌ ᅵ
장점이	ᄌ ᅡ ᆼ ᄌ ᅥ ᄆ ᅵ
시간만	ᄉ ᅵ ᄀ ᅡ ᆫ ᄆ ᅡ ᆫ
카카오	ᄏ ᅡ ᄏ ᅡ ᄋ ᅩ
앱이	ᄋ ᅢ ᄇ ᅵ
이용을	ᄋ ᅵ ᄋ ᅭ ᆼ ᄋ ᅳ ᆯ
곳	ᄀ ᅩ ᆮ
태울	ᄐ ᅢ ᄋ ᅮ ᆯ
자정	ᄌ ᅡ ᄌ ᅥ ᆼ
대중교통이	ᄃ ᅢ ᄌ ᅮ ᆼ ᄀ ᅭ ᄐ ᅩ ᆼ ᄋ ᅵ
멈추죠	ᄆ ᅥ ᆷ ᄎ ᅮ ᄌ ᅭ
늦게	ᄂ ᅳ ᆮ ᄁ ᅦ
귀가하면	ᄀ ᅱ ᄀ ᅡ ᄒ ᅡ ᄆ ᅧ ᆫ
택시를	ᄐ ᅢ ᆨ ᄊ ᅵ ᄅ ᅳ ᆯ
이용해요	ᄋ ᅵ ᄋ ᅭ ᆼ ᄒ ᅢ ᄋ ᅭ
앱을	ᄋ ᅢ ᄇ ᅳ ᆯ
사용하죠	ᄉ ᅡ ᄋ ᅭ ᆼ ᄒ ᅡ ᄌ ᅭ
앱은	ᄋ ᅢ ᄇ ᅳ ᆫ
목적지	ᄆ ᅩ ᆨ ᄍ ᅥ ᆨ ᄍ ᅵ
입력이	ᄋ ᅵ ᆷ ᄂ ᅧ ᄀ ᅵ
필수	ᄑ ᅵ ᆯ ᄉ ᅮ
가고	ᄀ ᅡ ᄀ ᅩ
입력	ᄋ ᅵ ᆷ ᄂ ᅧ ᆨ
가까이	ᄀ ᅡ ᄁ ᅡ ᄋ ᅵ
내용이	ᄂ ᅢ ᄋ ᅭ ᆼ ᄋ ᅵ
전송되고	ᄌ ᅥ ᆫ ᄉ ᅩ ᆼ ᄃ ᅬ ᄀ ᅩ
운전자가	ᄋ ᅮ ᆫ ᄌ ᅥ ᆫ ᄌ ᅡ ᄀ ᅡ
태울께요	ᄐ ᅢ ᄋ ᅮ ᆯ ᄁ ᅦ ᄋ ᅭ
응답해요	ᄋ ᅳ ᆼ ᄃ ᅡ ᄑ ᅢ ᄋ ᅭ
자정을	ᄌ ᅡ ᄌ ᅥ ᆼ ᄋ ᅳ ᆯ
넘어서는	ᄂ ᅥ ᄆ ᅥ ᄉ ᅥ ᄂ ᅳ ᆫ
기사들도	ᄀ ᅵ ᄉ ᅡ ᄃ ᅳ ᆯ ᄃ ᅩ
힘든	ᄒ ᅵ ᆷ ᄃ ᅳ ᆫ
시간이고	ᄉ ᅵ ᄀ ᅡ ᄂ ᅵ ᄀ ᅩ
먼	ᄆ ᅥ ᆫ
거리에	ᄀ ᅥ ᄅ ᅵ ᄋ ᅦ
손님을	ᄉ ᅩ ᆫ ᄂ ᅵ ᄆ ᅳ ᆯ
태우려고	ᄐ ᅢ ᄋ ᅮ ᄅ ᅧ ᄀ ᅩ
하죠	ᄒ ᅡ ᄌ ᅭ
기사들이	ᄀ ᅵ ᄉ ᅡ ᄃ ᅳ ᄅ ᅵ
태우는	ᄐ ᅢ ᄋ ᅮ ᄂ ᅳ ᆫ
발생	ᄇ ᅡ ᆯ ᄉ ᅢ ᆼ
기다리고	ᄀ ᅵ ᄃ ᅡ ᄅ ᅵ ᄀ ᅩ
있다가	ᄋ ᅵ ᆮ ᄄ ᅡ ᄀ ᅡ
곳으로	ᄀ ᅩ ᄉ ᅳ ᄅ ᅩ
가는	ᄀ ᅡ ᄂ ᅳ ᆫ
호출을	ᄒ ᅩ ᄎ ᅮ ᄅ ᅳ ᆯ
무시하고	ᄆ ᅮ ᄉ ᅵ ᄒ ᅡ ᄀ ᅩ
손님에게	ᄉ ᅩ ᆫ ᄂ ᅵ ᄆ ᅦ ᄀ ᅦ
응답하죠	ᄋ ᅳ ᆼ ᄃ ᅡ ᄑ ᅡ ᄌ ᅭ
이것을	ᄋ ᅵ ᄀ ᅥ ᄉ ᅳ ᆯ
잠자는	ᄌ ᅡ ᆷ ᄌ ᅡ ᄂ ᅳ ᆫ
택시라고	ᄐ ᅢ ᆨ ᄊ ᅵ ᄅ ᅡ ᄀ ᅩ
불러요	ᄇ ᅮ ᆯ ᄅ ᅥ ᄋ ᅭ
택시기사가	ᄐ ᅢ ᆨ ᄊ ᅵ ᄀ ᅵ ᄉ ᅡ ᄀ ᅡ
손님의	ᄉ ᅩ ᆫ ᄂ ᅵ ᄆ ᅴ
승차를	ᄉ ᅳ ᆼ ᄎ ᅡ ᄅ ᅳ ᆯ
거부하고	ᄀ ᅥ ᄇ ᅮ ᄒ ᅡ ᄀ ᅩ
골라서	ᄀ ᅩ ᆯ ᄅ ᅡ ᄉ ᅥ
승차	ᄉ ᅳ ᆼ ᄎ ᅡ
거부로	ᄀ ᅥ ᄇ ᅮ ᄅ ᅩ
벌금이	ᄇ ᅥ ᆯ ᄀ ᅳ ᄆ ᅵ
부과되죠	ᄇ ᅮ ᄀ ᅪ ᄃ ᅬ ᄌ ᅭ
택시에	ᄐ ᅢ ᆨ ᄊ ᅵ ᄋ ᅦ
응답	ᄋ ᅳ ᆼ ᄃ ᅡ ᆸ
여부는	ᄋ ᅧ ᄇ ᅮ ᄂ ᅳ ᆫ
기사의	ᄀ ᅵ ᄉ ᅡ ᄋ ᅴ
자유	ᄌ ᅡ ᄋ ᅲ
거부의	ᄀ ᅥ ᄇ ᅮ ᄋ ᅴ
단계로	ᄃ ᅡ ᆫ ᄀ ᅨ ᄅ ᅩ
집중적으로	ᄌ ᅵ ᆸ ᄍ ᅮ ᆼ ᄌ ᅥ ᄀ ᅳ ᄅ ᅩ
단속	ᄃ ᅡ ᆫ ᄉ ᅩ ᆨ
했으며	ᄒ ᅢ ᄊ ᅳ ᄆ ᅧ
앱	ᄋ ᅢ ᆸ
회사들에는	ᄒ ᅬ ᄉ ᅡ ᄃ ᅳ ᄅ ᅦ ᄂ ᅳ ᆫ
표시	ᄑ ᅭ ᄉ ᅵ
기능을	ᄀ ᅵ ᄂ ᅳ ᆼ ᄋ ᅳ ᆯ
개발	ᄀ ᅢ ᄇ ᅡ ᆯ
하라는	ᄒ ᅡ ᄅ ᅡ ᄂ ᅳ ᆫ
요청도	ᄋ ᅭ ᄎ ᅥ ᆼ ᄃ ᅩ
공평하게	ᄀ ᅩ ᆼ ᄑ ᅧ ᆼ ᄒ ᅡ ᄀ ᅦ
이용할	ᄋ ᅵ ᄋ ᅭ ᆼ ᄒ ᅡ ᆯ
하자는	ᄒ ᅡ ᄌ ᅡ ᄂ ᅳ ᆫ
뜻이죠	ᄄ ᅳ ᄉ ᅵ ᄌ ᅭ
개발사는	ᄀ ᅢ ᄇ ᅡ ᆯ ᄉ ᅡ ᄂ ᅳ ᆫ
늦은	ᄂ ᅳ ᄉ ᅳ ᆫ
운영하는	ᄋ ᅮ ᄂ ᅧ ᆼ ᄒ ᅡ ᄂ ᅳ ᆫ
수요	ᄉ ᅮ ᄋ ᅭ
밤	ᄇ ᅡ ᆷ
타려는	ᄐ ᅡ ᄅ ᅧ ᄂ ᅳ ᆫ
손님	ᄉ ᅩ ᆫ ᄂ ᅵ ᆷ
수도	ᄉ ᅮ ᄃ ᅩ
나올지	ᄂ ᅡ ᄋ ᅩ ᆯ ᄌ ᅵ
지켜	ᄌ ᅵ ᄏ ᅧ
역선택	ᄋ ᅧ ᆨ ᄊ ᅥ ᆫ ᄐ ᅢ ᆨ
승객이	ᄉ ᅳ ᆼ ᄀ ᅢ ᄀ ᅵ
승객은	ᄉ ᅳ ᆼ ᄀ ᅢ ᄀ ᅳ ᆫ
주변에	ᄌ ᅮ ᄇ ᅧ ᄂ ᅦ
있는지	ᄋ ᅵ ᆫ ᄂ ᅳ ᆫ ᄌ ᅵ
몰라요	ᄆ ᅩ ᆯ ᄅ ᅡ ᄋ ᅭ
공급자인	ᄀ ᅩ ᆼ ᄀ ᅳ ᆸ ᄍ ᅡ ᄋ ᅵ ᆫ
승객을	ᄉ ᅳ ᆼ ᄀ ᅢ ᄀ ᅳ ᆯ
상황이	ᄉ ᅡ ᆼ ᄒ ᅪ ᆼ ᄋ ᅵ
벌어져요	ᄇ ᅥ ᄅ ᅥ ᄌ ᅥ ᄋ ᅭ
경제학에서	ᄀ ᅧ ᆼ ᄌ ᅦ ᄒ ᅡ ᄀ ᅦ ᄉ ᅥ
역선택이라고	ᄋ ᅧ ᆨ ᄊ ᅥ ᆫ ᄐ ᅢ ᄀ ᅵ ᄅ ᅡ ᄀ ᅩ
당사자	ᄃ ᅡ ᆼ ᄉ ᅡ ᄌ ᅡ
한쪽에만	ᄒ ᅡ ᆫ ᄍ ᅩ ᄀ ᅦ ᄆ ᅡ ᆫ
정보가	ᄌ ᅥ ᆼ ᄇ ᅩ ᄀ ᅡ
제공되면서	ᄌ ᅦ ᄀ ᅩ ᆼ ᄃ ᅬ ᄆ ᅧ ᆫ ᄉ ᅥ
생기는	ᄉ ᅢ ᆼ ᄀ ᅵ ᄂ ᅳ ᆫ
정보력의	ᄌ ᅥ ᆼ ᄇ ᅩ ᄅ ᅧ ᄀ ᅴ
차이에서	ᄎ ᅡ ᄋ ᅵ ᄋ ᅦ ᄉ ᅥ
문제죠	ᄆ ᅮ ᆫ ᄌ ᅦ ᄌ ᅭ
쪽은	ᄍ ᅩ ᄀ ᅳ ᆫ
바람직하지	ᄇ ᅡ ᄅ ᅡ ᆷ ᄌ ᅵ ᄏ ᅡ ᄌ ᅵ
상대방과	ᄉ ᅡ ᆼ ᄃ ᅢ ᄇ ᅡ ᆼ ᄀ ᅪ
거래할	ᄀ ᅥ ᄅ ᅢ ᄒ ᅡ ᆯ
커져	ᄏ ᅥ ᄌ ᅥ
중고차	ᄌ ᅮ ᆼ ᄀ ᅩ ᄎ ᅡ
판매자는	ᄑ ᅡ ᆫ ᄆ ᅢ ᄌ ᅡ ᄂ ᅳ ᆫ
누구보다	ᄂ ᅮ ᄀ ᅮ ᄇ ᅩ ᄃ ᅡ
차에	ᄎ ᅡ ᄋ ᅦ
알지만	ᄋ ᅡ ᆯ ᄌ ᅵ ᄆ ᅡ ᆫ
불리한	ᄇ ᅮ ᆯ ᄅ ᅵ ᄒ ᅡ ᆫ
알릴리	ᄋ ᅡ ᆯ ᄅ ᅵ ᆯ ᄅ ᅵ
만무	ᄆ ᅡ ᆫ ᄆ ᅮ
생기죠	ᄉ ᅢ ᆼ ᄀ ᅵ ᄌ ᅭ
역	ᄋ ᅧ ᆨ
해결하기	ᄒ ᅢ ᄀ ᅧ ᆯ ᄒ ᅡ ᄀ ᅵ
정보의	ᄌ ᅥ ᆼ ᄇ ᅩ ᄋ ᅴ
격차를	ᄀ ᅧ ᆨ ᄎ ᅡ ᄅ ᅳ ᆯ
해결해야	ᄒ ᅢ ᄀ ᅧ ᆯ ᄒ ᅢ ᄋ ᅣ
앱에서	ᄋ ᅢ ᄇ ᅦ ᄉ ᅥ
표시를	ᄑ ᅭ ᄉ ᅵ ᄅ ᅳ ᆯ
없애라는	ᄋ ᅥ ᆸ ᄊ ᅢ ᄅ ᅡ ᄂ ᅳ ᆫ
것이나	ᄀ ᅥ ᄉ ᅵ ᄂ ᅡ
거래에서	ᄀ ᅥ ᄅ ᅢ ᄋ ᅦ ᄉ ᅥ
전문성을	ᄌ ᅥ ᆫ ᄆ ᅮ ᆫ ᄉ ᅥ ᆼ ᄋ ᅳ ᆯ
이력을	ᄋ ᅵ ᄅ ᅧ ᄀ ᅳ ᆯ
밝혀서	ᄇ ᅡ ᆯ ᄏ ᅧ ᄉ ᅥ
공개	ᄀ ᅩ ᆼ ᄀ ᅢ
유통점의	ᄋ ᅲ ᄐ ᅩ ᆼ ᄌ ᅥ ᄆ ᅴ
제시하는	ᄌ ᅦ ᄉ ᅵ ᄒ ᅡ ᄂ ᅳ ᆫ
고	ᄀ ᅩ
고가	ᄀ ᅩ ᄀ ᅡ
이십이	ᄋ ᅵ ᄉ ᅵ ᄇ ᅵ
시애틀에	ᄉ ᅵ ᄋ ᅢ ᄐ ᅳ ᄅ ᅦ
정식	ᄌ ᅥ ᆼ ᄉ ᅵ ᆨ
오픈	ᄋ ᅩ ᄑ ᅳ ᆫ
유수	ᄋ ᅲ ᄉ ᅮ
꼽을	ᄁ ᅩ ᄇ ᅳ ᆯ
만한	ᄆ ᅡ ᆫ ᄒ ᅡ ᆫ
언론의	ᄋ ᅥ ᆯ ᄅ ᅩ ᄂ ᅴ
시선은	ᄉ ᅵ ᄉ ᅥ ᄂ ᅳ ᆫ
고로	ᄀ ᅩ ᄅ ᅩ
향했습니다	ᄒ ᅣ ᆼ ᄒ ᅢ ᆮ ᄊ ᅳ ᆷ ᄂ ᅵ ᄃ ᅡ
완벽한	ᄋ ᅪ ᆫ ᄇ ᅧ ᄏ ᅡ ᆫ
무인	ᄆ ᅮ ᄋ ᅵ ᆫ
시스템을	ᄉ ᅵ ᄉ ᅳ ᄐ ᅦ ᄆ ᅳ ᆯ
도입했기	ᄃ ᅩ ᄋ ᅵ ᄑ ᅢ ᆮ ᄁ ᅵ
때문	ᄄ ᅢ ᄆ ᅮ ᆫ
편의점이나	ᄑ ᅧ ᄂ ᅴ ᄌ ᅥ ᄆ ᅵ ᄂ ᅡ
마트를	ᄆ ᅡ ᄐ ᅳ ᄅ ᅳ ᆯ
고르고	ᄀ ᅩ ᄅ ᅳ ᄀ ᅩ
계산대로	ᄀ ᅨ ᄉ ᅡ ᆫ ᄃ ᅢ ᄅ ᅩ
향합니다	ᄒ ᅣ ᆼ ᄒ ᅡ ᆷ ᄂ ᅵ ᄃ ᅡ
주말이나	ᄌ ᅮ ᄆ ᅡ ᄅ ᅵ ᄂ ᅡ
휴가철에는	ᄒ ᅲ ᄀ ᅡ ᄎ ᅥ ᄅ ᅦ ᄂ ᅳ ᆫ
계산대	ᄀ ᅨ ᄉ ᅡ ᆫ ᄃ ᅢ
길게	ᄀ ᅵ ᆯ ᄀ ᅦ
늘어선	ᄂ ᅳ ᄅ ᅥ ᄉ ᅥ ᆫ
줄을	ᄌ ᅮ ᄅ ᅳ ᆯ
기다려야	ᄀ ᅵ ᄃ ᅡ ᄅ ᅧ ᄋ ᅣ
할인	ᄒ ᅡ ᄅ ᅵ ᆫ
카드를	ᄏ ᅡ ᄃ ᅳ ᄅ ᅳ ᆯ
꺼내느라	ᄁ ᅥ ᄂ ᅢ ᄂ ᅳ ᄅ ᅡ
들어설	ᄃ ᅳ ᄅ ᅥ ᄉ ᅥ ᆯ
스마트폰을	ᄉ ᅳ ᄆ ᅡ ᄐ ᅳ ᄑ ᅩ ᄂ ᅳ ᆯ
애플리케이션	ᄋ ᅢ ᄑ ᅳ ᆯ ᄅ ᅵ ᄏ ᅦ ᄋ ᅵ ᄉ ᅧ ᆫ
앱만	ᄋ ᅢ ᆷ ᄆ ᅡ ᆫ
실행	ᄉ ᅵ ᆯ ᄒ ᅢ ᆼ
시키고	ᄉ ᅵ ᄏ ᅵ ᄀ ᅩ
기술을	ᄀ ᅵ ᄉ ᅮ ᄅ ᅳ ᆯ
접목	ᄌ ᅥ ᆷ ᄆ ᅩ ᆨ
저스트	ᄌ ᅥ ᄉ ᅳ ᄐ ᅳ
워크	ᄋ ᅯ ᄏ ᅳ
아웃	ᄋ ᅡ ᄋ ᅮ ᆮ
멈춤	ᄆ ᅥ ᆷ ᄎ ᅮ ᆷ
쇼핑이	ᄉ ᅭ ᄑ ᅵ ᆼ ᄋ ᅵ
가능했을까요	ᄀ ᅡ ᄂ ᅳ ᆼ ᄒ ᅢ ᄊ ᅳ ᆯ ᄁ ᅡ ᄋ ᅭ
정답은	ᄌ ᅥ ᆼ ᄃ ᅡ ᄇ ᅳ ᆫ
첨단기술의	ᄎ ᅥ ᆷ ᄃ ᅡ ᆫ ᄀ ᅵ ᄉ ᅮ ᄅ ᅴ
접목에	ᄌ ᅥ ᆷ ᄆ ᅩ ᄀ ᅦ
고에는	ᄀ ᅩ ᄋ ᅦ ᄂ ᅳ ᆫ
비전	ᄇ ᅵ ᄌ ᅥ ᆫ
딥러닝	ᄃ ᅵ ᆷ ᄂ ᅥ ᄂ ᅵ ᆼ
알고리즘	ᄋ ᅡ ᆯ ᄀ ᅩ ᄅ ᅵ ᄌ ᅳ ᆷ
센서	ᄉ ᅦ ᆫ ᄉ ᅥ
퓨전	ᄑ ᅲ ᄌ ᅥ ᆫ
자율	ᄌ ᅡ ᄋ ᅲ ᆯ
주행차	ᄌ ᅮ ᄒ ᅢ ᆼ ᄎ ᅡ
기술	ᄀ ᅵ ᄉ ᅮ ᆯ
적용했습니다	ᄌ ᅥ ᄀ ᅭ ᆼ ᄒ ᅢ ᆮ ᄊ ᅳ ᆷ ᄂ ᅵ ᄃ ᅡ
고객이	ᄀ ᅩ ᄀ ᅢ ᄀ ᅵ
고르는	ᄀ ᅩ ᄅ ᅳ ᄂ ᅳ ᆫ
상점	ᄉ ᅡ ᆼ ᄌ ᅥ ᆷ
선반	ᄉ ᅥ ᆫ ᄇ ᅡ ᆫ
위에서는	ᄋ ᅱ ᄋ ᅦ ᄉ ᅥ ᄂ ᅳ ᆫ
자율주행	ᄌ ᅡ ᄋ ᅲ ᆯ ᄌ ᅮ ᄒ ᅢ ᆼ
센서가	ᄉ ᅦ ᆫ ᄉ ᅥ ᄀ ᅡ
부착	ᄇ ᅮ ᄎ ᅡ ᆨ
카메라가	ᄏ ᅡ ᄆ ᅦ ᄅ ᅡ ᄀ ᅡ
쇼핑객	ᄉ ᅭ ᄑ ᅵ ᆼ ᄀ ᅢ ᆨ
동선을	ᄃ ᅩ ᆼ ᄉ ᅥ ᄂ ᅳ ᆯ
따라다니며	ᄄ ᅡ ᄅ ᅡ ᄃ ᅡ ᄂ ᅵ ᄆ ᅧ
목록을	ᄆ ᅩ ᆼ ᄂ ᅩ ᄀ ᅳ ᆯ
인식합니다	ᄋ ᅵ ᆫ ᄉ ᅵ ᄏ ᅡ ᆷ ᄂ ᅵ ᄃ ᅡ
나서면	ᄂ ᅡ ᄉ ᅥ ᄆ ᅧ ᆫ
앱에	ᄋ ᅢ ᄇ ᅦ
등록된	ᄃ ᅳ ᆼ ᄂ ᅩ ᆨ ᄄ ᅬ ᆫ
결제수단	ᄀ ᅧ ᆯ ᄌ ᅦ ᄉ ᅮ ᄃ ᅡ ᆫ
카드	ᄏ ᅡ ᄃ ᅳ
등으로	ᄃ ᅳ ᆼ ᄋ ᅳ ᄅ ᅩ
결제되는	ᄀ ᅧ ᆯ ᄌ ᅦ ᄃ ᅬ ᄂ ᅳ ᆫ
방식이죠	ᄇ ᅡ ᆼ ᄉ ᅵ ᄀ ᅵ ᄌ ᅭ
훔치는	ᄒ ᅮ ᆷ ᄎ ᅵ ᄂ ᅳ ᆫ
가능하지	ᄀ ᅡ ᄂ ᅳ ᆼ ᄒ ᅡ ᄌ ᅵ
않을까요	ᄋ ᅡ ᄂ ᅳ ᆯ ᄁ ᅡ ᄋ ᅭ
일부	ᄋ ᅵ ᆯ ᄇ ᅮ
시도를	ᄉ ᅵ ᄃ ᅩ ᄅ ᅳ ᆯ
해봤지만	ᄒ ᅢ ᄇ ᅪ ᆮ ᄍ ᅵ ᄆ ᅡ ᆫ
여지	ᄋ ᅧ ᄌ ᅵ
됐다고	ᄃ ᅫ ᆮ ᄄ ᅡ ᄀ ᅩ
걱정은	ᄀ ᅥ ᆨ ᄍ ᅥ ᆼ ᄋ ᅳ ᆫ
않아도	ᄋ ᅡ ᄂ ᅡ ᄃ ᅩ
되겠죠	ᄃ ᅬ ᄀ ᅦ ᆮ ᄍ ᅭ
걱정거리	ᄀ ᅥ ᆨ ᄍ ᅥ ᆼ ᄀ ᅥ ᄅ ᅵ
유통매장은	ᄋ ᅲ ᄐ ᅩ ᆼ ᄆ ᅢ ᄌ ᅡ ᆼ ᄋ ᅳ ᆫ
혁신적	ᄒ ᅧ ᆨ ᄊ ᅵ ᆫ ᄌ ᅥ ᆨ
있으나	ᄋ ᅵ ᄊ ᅳ ᄂ ᅡ
누군가에게는	ᄂ ᅮ ᄀ ᅮ ᆫ ᄀ ᅡ ᄋ ᅦ ᄀ ᅦ ᄂ ᅳ ᆫ
재앙으로	ᄌ ᅢ ᄋ ᅡ ᆼ ᄋ ᅳ ᄅ ᅩ
다가올	ᄃ ᅡ ᄀ ᅡ ᄋ ᅩ ᆯ
이천십육년	ᄋ ᅵ ᄎ ᅥ ᆫ ᄉ ᅵ ᄇ ᅲ ᆼ ᄂ ᅧ ᆫ
삼백	ᄉ ᅡ ᆷ ᄇ ᅢ ᆨ
오십만	ᄋ ᅩ ᄉ ᅵ ᆷ ᄆ ᅡ ᆫ
계산원이	ᄀ ᅨ ᄉ ᅡ ᄂ ᅯ ᄂ ᅵ
확산에	ᄒ ᅪ ᆨ ᄊ ᅡ ᄂ ᅦ
위험에	ᄋ ᅱ ᄒ ᅥ ᄆ ᅦ
처할	ᄎ ᅥ ᄒ ᅡ ᆯ
보도	ᄇ ᅩ ᄃ ᅩ
하기도	ᄒ ᅡ ᄀ ᅵ ᄃ ᅩ
고는	ᄀ ᅩ ᄂ ᅳ ᆫ
단순히	ᄃ ᅡ ᆫ ᄉ ᅮ ᆫ ᄒ ᅵ
마트에서	ᄆ ᅡ ᄐ ᅳ ᄋ ᅦ ᄉ ᅥ
계산하던	ᄀ ᅨ ᄉ ᅡ ᆫ ᄒ ᅡ ᄃ ᅥ ᆫ
업무	ᄋ ᅥ ᆷ ᄆ ᅮ
업무에	ᄋ ᅥ ᆷ ᄆ ᅮ ᄋ ᅦ
투입	ᄐ ᅮ ᄋ ᅵ ᆸ
물품을	ᄆ ᅮ ᆯ ᄑ ᅮ ᄆ ᅳ ᆯ
고객을	ᄀ ᅩ ᄀ ᅢ ᄀ ᅳ ᆯ
돕는	ᄃ ᅩ ᆷ ᄂ ᅳ ᆫ
직원이	ᄌ ᅵ ᄀ ᅯ ᄂ ᅵ
음식을	ᄋ ᅳ ᆷ ᄉ ᅵ ᄀ ᅳ ᆯ
쉐프가	ᄉ ᅰ ᄑ ᅳ ᄀ ᅡ
누구나	ᄂ ᅮ ᄀ ᅮ ᄂ ᅡ
나갈	ᄂ ᅡ ᄀ ᅡ ᆯ
가져가려고	ᄀ ᅡ ᄌ ᅥ ᄀ ᅡ ᄅ ᅧ ᄀ ᅩ
때에는	ᄄ ᅢ ᄋ ᅦ ᄂ ᅳ ᆫ
신분증을	ᄉ ᅵ ᆫ ᄇ ᅮ ᆫ ᄌ ᅳ ᆼ ᄋ ᅳ ᆯ
검사해야	ᄀ ᅥ ᆷ ᄉ ᅡ ᄒ ᅢ ᄋ ᅣ
인원도	ᄋ ᅵ ᄂ ᅯ ᆫ ᄃ ᅩ
필요하죠	ᄑ ᅵ ᄅ ᅭ ᄒ ᅡ ᄌ ᅭ
무인화를	ᄆ ᅮ ᄋ ᅵ ᆫ ᄒ ᅪ ᄅ ᅳ ᆯ
내세웠지만	ᄂ ᅢ ᄉ ᅦ ᄋ ᅯ ᆮ ᄍ ᅵ ᄆ ᅡ ᆫ
직원들만	ᄌ ᅵ ᄀ ᅯ ᆫ ᄃ ᅳ ᆯ ᄆ ᅡ ᆫ
편의점	ᄑ ᅧ ᄂ ᅴ ᄌ ᅥ ᆷ
사용이	ᄉ ᅡ ᄋ ᅭ ᆼ ᄋ ᅵ
가능하며	ᄀ ᅡ ᄂ ᅳ ᆼ ᄒ ᅡ ᄆ ᅧ
진열	ᄌ ᅵ ᄂ ᅧ ᆯ
전반적인	ᄌ ᅥ ᆫ ᄇ ᅡ ᆫ ᄌ ᅥ ᄀ ᅵ ᆫ
관리는	ᄀ ᅪ ᆯ ᄅ ᅵ ᄂ ᅳ ᆫ
나라와	ᄂ ᅡ ᄅ ᅡ ᄋ ᅪ
비교하면	ᄇ ᅵ ᄀ ᅭ ᄒ ᅡ ᄆ ᅧ ᆫ
완전한	ᄋ ᅪ ᆫ ᄌ ᅥ ᆫ ᄒ ᅡ ᆫ
편의점과는	ᄑ ᅧ ᄂ ᅴ ᄌ ᅥ ᆷ ᄀ ᅪ ᄂ ᅳ ᆫ
발전하고	ᄇ ᅡ ᆯ ᄍ ᅥ ᆫ ᄒ ᅡ ᄀ ᅩ
플랫폼으로	ᄑ ᅳ ᆯ ᄅ ᅢ ᆮ ᄑ ᅩ ᄆ ᅳ ᄅ ᅩ
시작한	ᄉ ᅵ ᄌ ᅡ ᄏ ᅡ ᆫ
사물이나	ᄉ ᅡ ᄆ ᅮ ᄅ ᅵ ᄂ ᅡ
데이터를	ᄃ ᅦ ᄋ ᅵ ᄐ ᅥ ᄅ ᅳ ᆯ
군집화	ᄀ ᅮ ᆫ ᄌ ᅵ ᄑ ᅪ
유사한	ᄋ ᅲ ᄉ ᅡ ᄒ ᅡ ᆫ
것들이	ᄀ ᅥ ᆮ ᄄ ᅳ ᄅ ᅵ
묶어서	ᄆ ᅮ ᄁ ᅥ ᄉ ᅥ
기억하려는	ᄀ ᅵ ᄋ ᅥ ᄏ ᅡ ᄅ ᅧ ᄂ ᅳ ᆫ
경향	ᄀ ᅧ ᆼ ᄒ ᅣ ᆼ
하거나	ᄒ ᅡ ᄀ ᅥ ᄂ ᅡ
분류하는	ᄇ ᅮ ᆯ ᄅ ᅲ ᄒ ᅡ ᄂ ᅳ ᆫ
사용하는	ᄉ ᅡ ᄋ ᅭ ᆼ ᄒ ᅡ ᄂ ᅳ ᆫ
의미한다	ᄋ ᅴ ᄆ ᅵ ᄒ ᅡ ᆫ ᄃ ᅡ
컴퓨터가	ᄏ ᅥ ᆷ ᄑ ᅲ ᄐ ᅥ ᄀ ᅡ
사물을	ᄉ ᅡ ᄆ ᅮ ᄅ ᅳ ᆯ
분별	ᄇ ᅮ ᆫ ᄇ ᅧ ᆯ
하도록	ᄒ ᅡ ᄃ ᅩ ᄅ ᅩ ᆨ
축적해	ᄎ ᅮ ᆨ ᄍ ᅥ ᄏ ᅢ
기계를	ᄀ ᅵ ᄀ ᅨ ᄅ ᅳ ᆯ
학습시키는	ᄒ ᅡ ᆨ ᄊ ᅳ ᆸ ᄊ ᅵ ᄏ ᅵ ᄂ ᅳ ᆫ
이세돌	ᄋ ᅵ ᄉ ᅦ ᄃ ᅩ ᆯ
구단과의	ᄀ ᅮ ᄃ ᅡ ᆫ ᄀ ᅪ ᄋ ᅴ
바둑	ᄇ ᅡ ᄃ ᅮ ᆨ
대결로	ᄃ ᅢ ᄀ ᅧ ᆯ ᄅ ᅩ
알파고도	ᄋ ᅡ ᆯ ᄑ ᅡ ᄀ ᅩ ᄃ ᅩ
또와	ᄄ ᅩ ᄋ ᅪ
물리적인	ᄆ ᅮ ᆯ ᄅ ᅵ ᄌ ᅥ ᄀ ᅵ ᆫ
전기적인	ᄌ ᅥ ᆫ ᄀ ᅵ ᄌ ᅥ ᄀ ᅵ ᆫ
신호로	ᄉ ᅵ ᆫ ᄒ ᅩ ᄅ ᅩ
바꿔주는	ᄇ ᅡ ᄁ ᅯ ᄌ ᅮ ᄂ ᅳ ᆫ
장치를	ᄌ ᅡ ᆼ ᄎ ᅵ ᄅ ᅳ ᆯ
곰	ᄀ ᅩ ᆷ
아저씨	ᄋ ᅡ ᄌ ᅥ ᄊ ᅵ
사과	ᄉ ᅡ ᄀ ᅪ
농장을	ᄂ ᅩ ᆼ ᄌ ᅡ ᆼ ᄋ ᅳ ᆯ
보호	ᄇ ᅩ ᄒ ᅩ
세이프	ᄉ ᅦ ᄋ ᅵ ᄑ ᅳ
가드를	ᄀ ᅡ ᄃ ᅳ ᄅ ᅳ ᆯ
시행	ᄉ ᅵ ᄒ ᅢ ᆼ
가드	ᄀ ᅡ ᄃ ᅳ
뭐죠	ᄆ ᅯ ᄌ ᅭ
참새	ᄎ ᅡ ᆷ ᄉ ᅢ
데이트	ᄃ ᅦ ᄋ ᅵ ᄐ ᅳ
가든은	ᄀ ᅡ ᄃ ᅳ ᄂ ᅳ ᆫ
들의	ᄃ ᅳ ᄅ ᅴ
심각	ᄉ ᅵ ᆷ ᄀ ᅡ ᆨ
무역	ᄆ ᅮ ᄋ ᅧ ᆨ
협정을	ᄒ ᅧ ᆸ ᄍ ᅥ ᆼ ᄋ ᅳ ᆯ
위반	ᄋ ᅱ ᄇ ᅡ ᆫ
대비해	ᄃ ᅢ ᄇ ᅵ ᄒ ᅢ
제도를	ᄌ ᅦ ᄃ ᅩ ᄅ ᅳ ᆯ
규정	ᄀ ᅲ ᄌ ᅥ ᆼ
해둔	ᄒ ᅢ ᄃ ᅮ ᆫ
답니다	ᄃ ᅡ ᆷ ᄂ ᅵ ᄃ ᅡ
조항을	ᄌ ᅩ ᄒ ᅡ ᆼ ᄋ ᅳ ᆯ
이제부터	ᄋ ᅵ ᄌ ᅦ ᄇ ᅮ ᄐ ᅥ
수입을	ᄉ ᅮ ᄋ ᅵ ᄇ ᅳ ᆯ
제한	ᄌ ᅦ ᄒ ᅡ ᆫ
닫아야	ᄃ ᅡ ᄃ ᅡ ᄋ ᅣ
농장이	ᄂ ᅩ ᆼ ᄌ ᅡ ᆼ ᄋ ᅵ
많아져서	ᄆ ᅡ ᄂ ᅡ ᄌ ᅥ ᄉ ᅥ
수입량을	ᄉ ᅮ ᄋ ᅵ ᆷ ᄂ ᅣ ᆼ ᄋ ᅳ ᆯ
일정	ᄋ ᅵ ᆯ ᄌ ᅥ ᆼ
수준으로	ᄉ ᅮ ᄌ ᅮ ᄂ ᅳ ᄅ ᅩ
정하고	ᄌ ᅥ ᆼ ᄒ ᅡ ᄀ ᅩ
국가에서	ᄀ ᅮ ᆨ ᄁ ᅡ ᄋ ᅦ ᄉ ᅥ
국가	ᄀ ᅮ ᆨ ᄁ ᅡ
농장의	ᄂ ᅩ ᆼ ᄌ ᅡ ᆼ ᄋ ᅴ
지원금도	ᄌ ᅵ ᄋ ᅯ ᆫ ᄀ ᅳ ᆷ ᄃ ᅩ
준다고	ᄌ ᅮ ᆫ ᄃ ᅡ ᄀ ᅩ
하네요	ᄒ ᅡ ᄂ ᅦ ᄋ ᅭ
음	ᄋ ᅳ ᆷ
다행입니다	ᄃ ᅡ ᄒ ᅢ ᆼ ᄋ ᅵ ᆷ ᄂ ᅵ ᄃ ᅡ
진작	ᄌ ᅵ ᆫ ᄌ ᅡ ᆨ
참	ᄎ ᅡ ᆷ
안타까운	ᄋ ᅡ ᆫ ᄐ ᅡ ᄁ ᅡ ᄋ ᅮ ᆫ
점이지만	ᄌ ᅥ ᄆ ᅵ ᄌ ᅵ ᄆ ᅡ ᆫ
세이프가드는	ᄉ ᅦ ᄋ ᅵ ᄑ ᅳ ᄀ ᅡ ᄃ ᅳ ᄂ ᅳ ᆫ
무역협정을	ᄆ ᅮ ᄋ ᅧ ᄏ ᅧ ᆸ ᄍ ᅥ ᆼ ᄋ ᅳ ᆯ
맺은	ᄆ ᅢ ᄌ ᅳ ᆫ
나라끼리	ᄂ ᅡ ᄅ ᅡ ᄁ ᅵ ᄅ ᅵ
정당한	ᄌ ᅥ ᆼ ᄃ ᅡ ᆼ ᄒ ᅡ ᆫ
규제하는	ᄀ ᅲ ᄌ ᅦ ᄒ ᅡ ᄂ ᅳ ᆫ
제도라서	ᄌ ᅦ ᄃ ᅩ ᄅ ᅡ ᄉ ᅥ
조건이	ᄌ ᅩ ᄀ ᅥ ᄂ ᅵ
엄격해요	ᄋ ᅥ ᆷ ᄀ ᅧ ᄏ ᅢ ᄋ ᅭ
하더라도	ᄒ ᅡ ᄃ ᅥ ᄅ ᅡ ᄃ ᅩ
심각한	ᄉ ᅵ ᆷ ᄀ ᅡ ᄏ ᅡ ᆫ
예방	ᄋ ᅨ ᄇ ᅡ ᆼ
산업이	ᄉ ᅡ ᄂ ᅥ ᄇ ᅵ
원만하게	ᄋ ᅯ ᆫ ᄆ ᅡ ᆫ ᄒ ᅡ ᄀ ᅦ
회복되는	ᄒ ᅬ ᄇ ᅩ ᆨ ᄄ ᅬ ᄂ ᅳ ᆫ
정도로만	ᄌ ᅥ ᆼ ᄃ ᅩ ᄅ ᅩ ᄆ ᅡ ᆫ
투입을	ᄐ ᅮ ᄋ ᅵ ᄇ ᅳ ᆯ
제한할	ᄌ ᅦ ᄒ ᅡ ᆫ ᄒ ᅡ ᆯ
무역을	ᄆ ᅮ ᄋ ᅧ ᄀ ᅳ ᆯ
제한하는	ᄌ ᅦ ᄒ ᅡ ᆫ ᄒ ᅡ ᄂ ᅳ ᆫ
것이기	ᄀ ᅥ ᄉ ᅵ ᄀ ᅵ
시행하고	ᄉ ᅵ ᄒ ᅢ ᆼ ᄒ ᅡ ᄀ ᅩ
상대	ᄉ ᅡ ᆼ ᄃ ᅢ
보상을	ᄇ ᅩ ᄉ ᅡ ᆼ ᄋ ᅳ ᆯ
아주머니의	ᄋ ᅡ ᄌ ᅮ ᄆ ᅥ ᄂ ᅵ ᄋ ᅴ
설명에	ᄉ ᅥ ᆯ ᄆ ᅧ ᆼ ᄋ ᅦ
아저씨는	ᄋ ᅡ ᄌ ᅥ ᄊ ᅵ ᄂ ᅳ ᆫ
속내를	ᄉ ᅩ ᆼ ᄂ ᅢ ᄅ ᅳ ᆯ
드러냈습니다	ᄃ ᅳ ᄅ ᅥ ᄂ ᅢ ᆮ ᄊ ᅳ ᆷ ᄂ ᅵ ᄃ ᅡ
무역은	ᄆ ᅮ ᄋ ᅧ ᄀ ᅳ ᆫ
효율성을	ᄒ ᅭ ᄋ ᅲ ᆯ ᄉ ᅥ ᆼ ᄋ ᅳ ᆯ
자국민이	ᄌ ᅡ ᄀ ᅮ ᆼ ᄆ ᅵ ᄂ ᅵ
보기도	ᄇ ᅩ ᄀ ᅵ ᄃ ᅩ
고려해야	ᄀ ᅩ ᄅ ᅧ ᄒ ᅢ ᄋ ᅣ
점도	ᄌ ᅥ ᆷ ᄃ ᅩ
많네요	ᄆ ᅡ ᆫ ᄂ ᅦ ᄋ ᅭ
서로에게	ᄉ ᅥ ᄅ ᅩ ᄋ ᅦ ᄀ ᅦ
손해지만	ᄉ ᅩ ᆫ ᄒ ᅢ ᄌ ᅵ ᄆ ᅡ ᆫ
무역한다고	ᄆ ᅮ ᄋ ᅧ ᄏ ᅡ ᆫ ᄃ ᅡ ᄀ ᅩ
아니구요	ᄋ ᅡ ᄂ ᅵ ᄀ ᅮ ᄋ ᅭ
앞으로는	ᄋ ᅡ ᄑ ᅳ ᄅ ᅩ ᄂ ᅳ ᆫ
적당한	ᄌ ᅥ ᆨ ᄄ ᅡ ᆼ ᄒ ᅡ ᆫ
무역이	ᄆ ᅮ ᄋ ᅧ ᄀ ᅵ
이루어져	ᄋ ᅵ ᄅ ᅮ ᄋ ᅥ ᄌ ᅥ
최소화	ᄎ ᅬ ᄉ ᅩ ᄒ ᅪ
되었으면	ᄃ ᅬ ᄋ ᅥ ᄊ ᅳ ᄆ ᅧ ᆫ
좋겠네요	ᄌ ᅩ ᄏ ᅦ ᆫ ᄂ ᅦ ᄋ ᅭ
아무튼	ᄋ ᅡ ᄆ ᅮ ᄐ ᅳ ᆫ
이제라도	ᄋ ᅵ ᄌ ᅦ ᄅ ᅡ ᄃ ᅩ
사과를	ᄉ ᅡ ᄀ ᅪ ᄅ ᅳ ᆯ
제한한다니	ᄌ ᅦ ᄒ ᅡ ᆫ ᄒ ᅡ ᆫ ᄃ ᅡ ᄂ ᅵ
다행이에요	ᄃ ᅡ ᄒ ᅢ ᆼ ᄋ ᅵ ᄋ ᅦ ᄋ ᅭ
알려주셔서	ᄋ ᅡ ᆯ ᄅ ᅧ ᄌ ᅮ ᄉ ᅧ ᄉ ᅥ
고맙긴요	ᄀ ᅩ ᄆ ᅡ ᆸ ᄁ ᅵ ᄂ ᅭ
힘내시고	ᄒ ᅵ ᆷ ᄂ ᅢ ᄉ ᅵ ᄀ ᅩ
소식	ᄉ ᅩ ᄉ ᅵ ᆨ
찾아뵐게요	ᄎ ᅡ ᄌ ᅡ ᄇ ᅬ ᆯ ᄀ ᅦ ᄋ ᅭ
마친	ᄆ ᅡ ᄎ ᅵ ᆫ
아주머니는	ᄋ ᅡ ᄌ ᅮ ᄆ ᅥ ᄂ ᅵ ᄂ ᅳ ᆫ
바퀴	ᄇ ᅡ ᄏ ᅱ
돌고	ᄃ ᅩ ᆯ ᄀ ᅩ
멀리	ᄆ ᅥ ᆯ ᄅ ᅵ
사라졌습니다	ᄉ ᅡ ᄅ ᅡ ᄌ ᅥ ᆮ ᄊ ᅳ ᆷ ᄂ ᅵ ᄃ ᅡ
세이프가드	ᄉ ᅦ ᄋ ᅵ ᄑ ᅳ ᄀ ᅡ ᄃ ᅳ
품목의	ᄑ ᅮ ᆷ ᄆ ᅩ ᄀ ᅴ
수입이	ᄉ ᅮ ᄋ ᅵ ᄇ ᅵ
급증하여	ᄀ ᅳ ᆸ ᄍ ᅳ ᆼ ᄒ ᅡ ᄋ ᅧ
산업에	ᄉ ᅡ ᄂ ᅥ ᄇ ᅦ
우려가	ᄋ ᅮ ᄅ ᅧ ᄀ ᅡ
수입국이	ᄉ ᅮ ᄋ ᅵ ᆸ ᄁ ᅮ ᄀ ᅵ
관세인상이나	ᄀ ᅪ ᆫ ᄉ ᅦ ᄋ ᅵ ᆫ ᄉ ᅡ ᆼ ᄋ ᅵ ᄂ ᅡ
수입량	ᄉ ᅮ ᄋ ᅵ ᆷ ᄂ ᅣ ᆼ
시행하는	ᄉ ᅵ ᄒ ᅢ ᆼ ᄒ ᅡ ᄂ ᅳ ᆫ
긴급	ᄀ ᅵ ᆫ ᄀ ᅳ ᆸ
관세를	ᄀ ᅪ ᆫ ᄉ ᅦ ᄅ ᅳ ᆯ
부과하는	ᄇ ᅮ ᄀ ᅪ ᄒ ᅡ ᄂ ᅳ ᆫ
방안을	ᄇ ᅡ ᆼ ᄋ ᅡ ᄂ ᅳ ᆯ
추진	ᄎ ᅮ ᄌ ᅵ ᆫ
삼성과	ᄉ ᅡ ᆷ ᄉ ᅥ ᆼ ᄀ ᅪ
엘지가	ᄋ ᅦ ᆯ ᄌ ᅵ ᄀ ᅡ
예상	ᄋ ᅨ ᄉ ᅡ ᆼ
면책	ᄆ ᅧ ᆫ ᄎ ᅢ ᆨ
조항	ᄌ ᅩ ᄒ ᅡ ᆼ
책임의	ᄎ ᅢ ᄀ ᅵ ᄆ ᅴ
면제에	ᄆ ᅧ ᆫ ᄌ ᅦ ᄋ ᅦ
사항을	ᄉ ᅡ ᄒ ᅡ ᆼ ᄋ ᅳ ᆯ
규정한	ᄀ ᅲ ᄌ ᅥ ᆼ ᄒ ᅡ ᆫ
조항이	ᄌ ᅩ ᄒ ᅡ ᆼ ᄋ ᅵ
국제조약에는	ᄀ ᅮ ᆨ ᄍ ᅦ ᄌ ᅩ ᄋ ᅣ ᄀ ᅦ ᄂ ᅳ ᆫ
조약상	ᄌ ᅩ ᄋ ᅣ ᆨ ᄊ ᅡ ᆼ
의무를	ᄋ ᅴ ᄆ ᅮ ᄅ ᅳ ᆯ
면제	ᄆ ᅧ ᆫ ᄌ ᅦ
두는	ᄃ ᅮ ᄂ ᅳ ᆫ
경우가	ᄀ ᅧ ᆼ ᄋ ᅮ ᄀ ᅡ
관세나	ᄀ ᅪ ᆫ ᄉ ᅦ ᄂ ᅡ
무역에	ᄆ ᅮ ᄋ ᅧ ᄀ ᅦ
예외적	ᄋ ᅨ ᄋ ᅬ ᄌ ᅥ ᆨ
상황에서	ᄉ ᅡ ᆼ ᄒ ᅪ ᆼ ᄋ ᅦ ᄉ ᅥ
지켜야	ᄌ ᅵ ᄏ ᅧ ᄋ ᅣ
약속을	ᄋ ᅣ ᆨ ᄊ ᅩ ᄀ ᅳ ᆯ
포기할	ᄑ ᅩ ᄀ ᅵ ᄒ ᅡ ᆯ
규정하고	ᄀ ᅲ ᄌ ᅥ ᆼ ᄒ ᅡ ᄀ ᅩ
공일구	ᄀ ᅩ ᆼ ᄋ ᅵ ᆯ ᄀ ᅮ
인기	ᄋ ᅵ ᆫ ᄀ ᅵ
장래	ᄌ ᅡ ᆼ ᄂ ᅢ
희망	ᄒ ᅵ ᄆ ᅡ ᆼ
크리에이터	ᄏ ᅳ ᄅ ᅵ ᄋ ᅦ ᄋ ᅵ ᄐ ᅥ
일인	ᄋ ᅵ ᄅ ᅵ ᆫ
미디어	ᄆ ᅵ ᄃ ᅵ ᄋ ᅥ
전성시대	ᄌ ᅥ ᆫ ᄉ ᅥ ᆼ ᄉ ᅵ ᄃ ᅢ
활짝	ᄒ ᅪ ᆯ ᄍ ᅡ ᆨ
초등	ᄎ ᅩ ᄃ ᅳ ᆼ
학생들	ᄒ ᅡ ᆨ ᄊ ᅢ ᆼ ᄃ ᅳ ᆯ
비제이는	ᄇ ᅵ ᄌ ᅦ ᄋ ᅵ ᄂ ᅳ ᆫ
떠오르는	ᄄ ᅥ ᄋ ᅩ ᄅ ᅳ ᄂ ᅳ ᆫ
하나다	ᄒ ᅡ ᄂ ᅡ ᄃ ᅡ
크리에이터란	ᄏ ᅳ ᄅ ᅵ ᄋ ᅦ ᄋ ᅵ ᄐ ᅥ ᄅ ᅡ ᆫ
창작	ᄎ ᅡ ᆼ ᄌ ᅡ ᆨ
사람이다	ᄉ ᅡ ᄅ ᅡ ᄆ ᅵ ᄃ ᅡ
개인방송을	ᄀ ᅢ ᄋ ᅵ ᆫ ᄇ ᅡ ᆼ ᄉ ᅩ ᆼ ᄋ ᅳ ᆯ
진행하는	ᄌ ᅵ ᆫ ᄒ ᅢ ᆼ ᄒ ᅡ ᄂ ᅳ ᆫ
사람으로	ᄉ ᅡ ᄅ ᅡ ᄆ ᅳ ᄅ ᅩ
상상	ᄉ ᅡ ᆼ ᄉ ᅡ ᆼ
조차	ᄌ ᅩ ᄎ ᅡ
직업이	ᄌ ᅵ ᄀ ᅥ ᄇ ᅵ
비제이의	ᄇ ᅵ ᄌ ᅦ ᄋ ᅵ ᄋ ᅴ
나이는	ᄂ ᅡ ᄋ ᅵ ᄂ ᅳ ᆫ
갈수록	ᄀ ᅡ ᆯ ᄊ ᅮ ᄅ ᅩ ᆨ
낮아지고	ᄂ ᅡ ᄌ ᅡ ᄌ ᅵ ᄀ ᅩ
미만의	ᄆ ᅵ ᄆ ᅡ ᄂ ᅴ
크리에이터도	ᄏ ᅳ ᄅ ᅵ ᄋ ᅦ ᄋ ᅵ ᄐ ᅥ ᄃ ᅩ
등장한다	ᄃ ᅳ ᆼ ᄌ ᅡ ᆼ ᄒ ᅡ ᆫ ᄃ ᅡ
구독	ᄀ ᅮ ᄃ ᅩ ᆨ
자수	ᄌ ᅡ ᄉ ᅮ
이십만을	ᄋ ᅵ ᄉ ᅵ ᆷ ᄆ ᅡ ᄂ ᅳ ᆯ
넘기는	ᄂ ᅥ ᆷ ᄀ ᅵ ᄂ ᅳ ᆫ
경우도	ᄀ ᅧ ᆼ ᄋ ᅮ ᄃ ᅩ
적지	ᄌ ᅥ ᆨ ᄍ ᅵ
이천십칠년에	ᄋ ᅵ ᄎ ᅥ ᆫ ᄉ ᅵ ᆸ ᄎ ᅵ ᆯ ᄅ ᅧ ᄂ ᅦ
열린	ᄋ ᅧ ᆯ ᄅ ᅵ ᆫ
키즈	ᄏ ᅵ ᄌ ᅳ
선발대회에	ᄉ ᅥ ᆫ ᄇ ᅡ ᆯ ᄃ ᅢ ᄒ ᅬ ᄋ ᅦ
구백	ᄀ ᅮ ᄇ ᅢ ᆨ
어린이가	ᄋ ᅥ ᄅ ᅵ ᄂ ᅵ ᄀ ᅡ
천사백	ᄎ ᅥ ᆫ ᄉ ᅡ ᄇ ᅢ ᆨ
건의	ᄀ ᅥ ᄂ ᅴ
영상을	ᄋ ᅧ ᆼ ᄉ ᅡ ᆼ ᄋ ᅳ ᆯ
선보였을	ᄉ ᅥ ᆫ ᄇ ᅩ ᄋ ᅧ ᄊ ᅳ ᆯ
높다	ᄂ ᅩ ᆸ ᄄ ᅡ
창의력을	ᄎ ᅡ ᆼ ᄋ ᅴ ᄅ ᅧ ᄀ ᅳ ᆯ
채널을	ᄎ ᅢ ᄂ ᅥ ᄅ ᅳ ᆯ
전성시대가	ᄌ ᅥ ᆫ ᄉ ᅥ ᆼ ᄉ ᅵ ᄃ ᅢ ᄀ ᅡ
있	ᄋ ᅵ ᆮ
기기가	ᄀ ᅵ ᄀ ᅵ ᄀ ᅡ
세상과	ᄉ ᅦ ᄉ ᅡ ᆼ ᄀ ᅪ
소통하는	ᄉ ᅩ ᄐ ᅩ ᆼ ᄒ ᅡ ᄂ ᅳ ᆫ
세대다	ᄉ ᅦ ᄃ ᅢ ᄃ ᅡ
이들은	ᄋ ᅵ ᄃ ᅳ ᄅ ᅳ ᆫ
속	ᄉ ᅩ ᆨ
가수	ᄀ ᅡ ᄉ ᅮ
못지	ᄆ ᅩ ᆮ ᄍ ᅵ
콘덴츠	ᄏ ᅩ ᆫ ᄃ ᅦ ᆫ ᄎ ᅳ
크리에이터에	ᄏ ᅳ ᄅ ᅵ ᄋ ᅦ ᄋ ᅵ ᄐ ᅥ ᄋ ᅦ
열광한다	ᄋ ᅧ ᆯ ᄀ ᅪ ᆼ ᄒ ᅡ ᆫ ᄃ ᅡ
소개하는	ᄉ ᅩ ᄀ ᅢ ᄒ ᅡ ᄂ ᅳ ᆫ
테리와	ᄐ ᅦ ᄅ ᅵ ᄋ ᅪ
친구들은	ᄎ ᅵ ᆫ ᄀ ᅮ ᄃ ᅳ ᄅ ᅳ ᆫ
누적	ᄂ ᅮ ᄌ ᅥ ᆨ
조회수	ᄌ ᅩ ᄒ ᅬ ᄉ ᅮ
십억	ᄉ ᅵ ᄇ ᅥ ᆨ
뷰를	ᄇ ᅲ ᄅ ᅳ ᆯ
돌파해	ᄃ ᅩ ᆯ ᄑ ᅡ ᄒ ᅢ
이천십오년	ᄋ ᅵ ᄎ ᅥ ᆫ ᄉ ᅵ ᄇ ᅩ ᄂ ᅧ ᆫ
출범	ᄎ ᅮ ᆯ ᄇ ᅥ ᆷ
게임인	ᄀ ᅦ ᄋ ᅵ ᄆ ᅵ ᆫ
마인크래프트를	ᄆ ᅡ ᄋ ᅵ ᆫ ᄏ ᅳ ᄅ ᅢ ᄑ ᅳ ᄐ ᅳ ᄅ ᅳ ᆯ
전문적으로	ᄌ ᅥ ᆫ ᄆ ᅮ ᆫ ᄌ ᅥ ᄀ ᅳ ᄅ ᅩ
방송하고	ᄇ ᅡ ᆼ ᄉ ᅩ ᆼ ᄒ ᅡ ᄀ ᅩ
이들의	ᄋ ᅵ ᄃ ᅳ ᄅ ᅴ
수익은	ᄉ ᅮ ᄋ ᅵ ᄀ ᅳ ᆫ
대기업	ᄃ ᅢ ᄀ ᅵ ᄋ ᅥ ᆸ
임원	ᄋ ᅵ ᄆ ᅯ ᆫ
추정	ᄎ ᅮ ᄌ ᅥ ᆼ
방송매체에도	ᄇ ᅡ ᆼ ᄉ ᅩ ᆼ ᄆ ᅢ ᄎ ᅦ ᄋ ᅦ ᄃ ᅩ
등장하고	ᄃ ᅳ ᆼ ᄌ ᅡ ᆼ ᄒ ᅡ ᄀ ᅩ
크리에이터가	ᄏ ᅳ ᄅ ᅵ ᄋ ᅦ ᄋ ᅵ ᄐ ᅥ ᄀ ᅡ
직업으로	ᄌ ᅵ ᄀ ᅥ ᄇ ᅳ ᄅ ᅩ
자리를	ᄌ ᅡ ᄅ ᅵ ᄅ ᅳ ᆯ
잡아가고	ᄌ ᅡ ᄇ ᅡ ᄀ ᅡ ᄀ ᅩ
늘어나는	ᄂ ᅳ ᄅ ᅥ ᄂ ᅡ ᄂ ᅳ ᆫ
추세다	ᄎ ᅮ ᄉ ᅦ ᄃ ᅡ
유튜	ᄋ ᅲ ᄐ ᅲ
촬영한	ᄎ ᅪ ᄅ ᅧ ᆼ ᄒ ᅡ ᆫ
업로드	ᄋ ᅥ ᆷ ᄂ ᅩ ᄃ ᅳ
유튜버	ᄋ ᅲ ᄐ ᅲ ᄇ ᅥ
길라임	ᄀ ᅵ ᆯ ᄅ ᅡ ᄋ ᅵ ᆷ
양은	ᄋ ᅣ ᆼ ᄋ ᅳ ᆫ
사십만	ᄉ ᅡ ᄉ ᅵ ᆷ ᄆ ᅡ ᆫ
구독자를	ᄀ ᅮ ᄃ ᅩ ᆨ ᄍ ᅡ ᄅ ᅳ ᆯ
보유하고	ᄇ ᅩ ᄋ ᅲ ᄒ ᅡ ᄀ ᅩ
다섯	ᄃ ᅡ ᄉ ᅥ ᆮ
살의	ᄉ ᅡ ᄅ ᅴ
라임	ᄅ ᅡ ᄋ ᅵ ᆷ
튜브를	ᄐ ᅲ ᄇ ᅳ ᄅ ᅳ ᆯ
운영하며	ᄋ ᅮ ᄂ ᅧ ᆼ ᄒ ᅡ ᄆ ᅧ
이천십사년부터	ᄋ ᅵ ᄎ ᅥ ᆫ ᄉ ᅵ ᆸ ᄊ ᅡ ᄂ ᅧ ᆫ ᄇ ᅮ ᄐ ᅥ
과학	ᄀ ᅪ ᄒ ᅡ ᆨ
실험을	ᄉ ᅵ ᆯ ᄒ ᅥ ᄆ ᅳ ᆯ
주제로	ᄌ ᅮ ᄌ ᅦ ᄅ ᅩ
동영상만	ᄃ ᅩ ᆼ ᄋ ᅧ ᆼ ᄉ ᅡ ᆼ ᄆ ᅡ ᆫ
편이며	ᄑ ᅧ ᄂ ᅵ ᄆ ᅧ
조회	ᄌ ᅩ ᄒ ᅬ
육억	ᄋ ᅲ ᄀ ᅥ ᆨ
뷰에	ᄇ ᅲ ᄋ ᅦ
달한다	ᄃ ᅡ ᆯ ᄒ ᅡ ᆫ ᄃ ᅡ
최연소	ᄎ ᅬ ᄋ ᅧ ᆫ ᄉ ᅩ
신서은양은	ᄉ ᅵ ᆫ ᄉ ᅥ ᄋ ᅳ ᄂ ᅣ ᆼ ᄋ ᅳ ᆫ
서은	ᄉ ᅥ ᄋ ᅳ ᆫ
구독자	ᄀ ᅮ ᄃ ᅩ ᆨ ᄍ ᅡ
명을	ᄆ ᅧ ᆼ ᄋ ᅳ ᆯ
넘었다	ᄂ ᅥ ᄆ ᅥ ᆮ ᄄ ᅡ
마이린	ᄆ ᅡ ᄋ ᅵ ᄅ ᅵ ᆫ
티브이도	ᄐ ᅵ ᄇ ᅳ ᄋ ᅵ ᄃ ᅩ
인기다	ᄋ ᅵ ᆫ ᄀ ᅵ ᄃ ᅡ
크리에이터는	ᄏ ᅳ ᄅ ᅵ ᄋ ᅦ ᄋ ᅵ ᄐ ᅥ ᄂ ᅳ ᆫ
평가를	ᄑ ᅧ ᆼ ᄀ ᅡ ᄅ ᅳ ᆯ
얻고	ᄋ ᅥ ᆮ ᄁ ᅩ
성장하는	ᄉ ᅥ ᆼ ᄌ ᅡ ᆼ ᄒ ᅡ ᄂ ᅳ ᆫ
카메라로	ᄏ ᅡ ᄆ ᅦ ᄅ ᅡ ᄅ ᅩ
기록하고	ᄀ ᅵ ᄅ ᅩ ᄏ ᅡ ᄀ ᅩ
재능을	ᄌ ᅢ ᄂ ᅳ ᆼ ᄋ ᅳ ᆯ
껏	ᄁ ᅥ ᆮ
뽐낼	ᄈ ᅩ ᆷ ᄂ ᅢ ᆯ
스스로	ᄉ ᅳ ᄉ ᅳ ᄅ ᅩ
제작하고	ᄌ ᅦ ᄌ ᅡ ᄏ ᅡ ᄀ ᅩ
자녀들을	ᄌ ᅡ ᄂ ᅧ ᄃ ᅳ ᄅ ᅳ ᆯ
지원하는	ᄌ ᅵ ᄋ ᅯ ᆫ ᄒ ᅡ ᄂ ᅳ ᆫ
부모들도	ᄇ ᅮ ᄆ ᅩ ᄃ ᅳ ᆯ ᄃ ᅩ
많아지고	ᄆ ᅡ ᄂ ᅡ ᄌ ᅵ ᄀ ᅩ
비제이	ᄇ ᅵ ᄌ ᅦ ᄋ ᅵ
뿐	ᄈ ᅮ ᆫ
초등학	ᄎ ᅩ ᄃ ᅳ ᆼ ᄒ ᅡ ᆨ
교에서	ᄀ ᅭ ᄋ ᅦ ᄉ ᅥ
직업	ᄌ ᅵ ᄀ ᅥ ᆸ
활동에	ᄒ ᅪ ᆯ ᄃ ᅩ ᆼ ᄋ ᅦ
대상을	ᄃ ᅢ ᄉ ᅡ ᆼ ᄋ ᅳ ᆯ
낮추고	ᄂ ᅡ ᆮ ᄎ ᅮ ᄀ ᅩ
각별한	ᄀ ᅡ ᆨ ᄈ ᅧ ᆯ ᄒ ᅡ ᆫ
주의	ᄌ ᅮ ᄋ ᅴ
필요해	ᄑ ᅵ ᄅ ᅭ ᄒ ᅢ
방송통신심의위원회의	ᄇ ᅡ ᆼ ᄉ ᅩ ᆼ ᄐ ᅩ ᆼ ᄉ ᅵ ᆫ ᄉ ᅵ ᄆ ᅴ ᄋ ᅱ ᄋ ᅯ ᆫ ᄒ ᅬ ᄋ ᅴ
조사를	ᄌ ᅩ ᄉ ᅡ ᄅ ᅳ ᆯ
폭력적인	ᄑ ᅩ ᆼ ᄂ ᅧ ᆨ ᄍ ᅥ ᄀ ᅵ ᆫ
접한	ᄌ ᅥ ᄑ ᅡ ᆫ
칠십구	ᄎ ᅵ ᆯ ᄉ ᅵ ᆸ ᄁ ᅮ
자극적인	ᄌ ᅡ ᄀ ᅳ ᆨ ᄍ ᅥ ᄀ ᅵ ᆫ
이들을	ᄋ ᅵ ᄃ ᅳ ᄅ ᅳ ᆯ
모방하는	ᄆ ᅩ ᄇ ᅡ ᆼ ᄒ ᅡ ᄂ ᅳ ᆫ
늘어가는	ᄂ ᅳ ᄅ ᅥ ᄀ ᅡ ᄂ ᅳ ᆫ
추세에	ᄎ ᅮ ᄉ ᅦ ᄋ ᅦ
시장이	ᄉ ᅵ ᄌ ᅡ ᆼ ᄋ ᅵ
자리잡은	ᄌ ᅡ ᄅ ᅵ ᄌ ᅡ ᄇ ᅳ ᆫ
기간은	ᄀ ᅵ ᄀ ᅡ ᄂ ᅳ ᆫ
길지	ᄀ ᅵ ᆯ ᄌ ᅵ
변화하며	ᄇ ᅧ ᆫ ᄒ ᅪ ᄒ ᅡ ᄆ ᅧ
인	ᄋ ᅵ ᆫ
주의를	ᄌ ᅮ ᄋ ᅴ ᄅ ᅳ ᆯ
올바른	ᄋ ᅩ ᆯ ᄇ ᅡ ᄅ ᅳ ᆫ
생산과	ᄉ ᅢ ᆼ ᄉ ᅡ ᆫ ᄀ ᅪ
관리가	ᄀ ᅪ ᆯ ᄅ ᅵ ᄀ ᅡ
시점이	ᄉ ᅵ ᄌ ᅥ ᄆ ᅵ
공이공	ᄀ ᅩ ᆼ ᄋ ᅵ ᄀ ᅩ ᆼ
비트코인	ᄇ ᅵ ᄐ ᅳ ᄏ ᅩ ᄋ ᅵ ᆫ
투자인가	ᄐ ᅮ ᄌ ᅡ ᄋ ᅵ ᆫ ᄀ ᅡ
제이의	ᄌ ᅦ ᄋ ᅵ ᄋ ᅴ
튤립인가	ᄐ ᅲ ᆯ ᄅ ᅵ ᄇ ᅵ ᆫ ᄀ ᅡ
예사롭지	ᄋ ᅨ ᄉ ᅡ ᄅ ᅩ ᆸ ᄍ ᅵ
가상화폐인	ᄀ ᅡ ᄉ ᅡ ᆼ ᄒ ᅪ ᄑ ᅨ ᄋ ᅵ ᆫ
비트코인을	ᄇ ᅵ ᄐ ᅳ ᄏ ᅩ ᄋ ᅵ ᄂ ᅳ ᆯ
생성	ᄉ ᅢ ᆼ ᄉ ᅥ ᆼ
생산하기	ᄉ ᅢ ᆼ ᄉ ᅡ ᆫ ᄒ ᅡ ᄀ ᅵ
슈퍼	ᄉ ᅲ ᄑ ᅥ
동원	ᄃ ᅩ ᆼ ᄋ ᅯ ᆫ
사기	ᄉ ᅡ ᄀ ᅵ
움직임은	ᄋ ᅮ ᆷ ᄌ ᅵ ᄀ ᅵ ᄆ ᅳ ᆫ
지나	ᄌ ᅵ ᄂ ᅡ
투기라는	ᄐ ᅮ ᄀ ᅵ ᄅ ᅡ ᄂ ᅳ ᆫ
지적이	ᄌ ᅵ ᄌ ᅥ ᄀ ᅵ
나오고	ᄂ ᅡ ᄋ ᅩ ᄀ ᅩ
형체도	ᄒ ᅧ ᆼ ᄎ ᅦ ᄃ ᅩ
과연	ᄀ ᅪ ᄋ ᅧ ᆫ
갖는	ᄀ ᅡ ᆫ ᄂ ᅳ ᆫ
합당한가에	ᄒ ᅡ ᆸ ᄄ ᅡ ᆼ ᄒ ᅡ ᆫ ᄀ ᅡ ᄋ ᅦ
의문과	ᄋ ᅴ ᄆ ᅮ ᆫ ᄀ ᅪ
첨단기술을	ᄎ ᅥ ᆷ ᄃ ᅡ ᆫ ᄀ ᅵ ᄉ ᅮ ᄅ ᅳ ᆯ
미래기술이라는	ᄆ ᅵ ᄅ ᅢ ᄀ ᅵ ᄉ ᅮ ᄅ ᅵ ᄅ ᅡ ᄂ ᅳ ᆫ
지적도	ᄌ ᅵ ᄌ ᅥ ᆨ ᄄ ᅩ
강하다	ᄀ ᅡ ᆼ ᄒ ᅡ ᄃ ᅡ
공식	ᄀ ᅩ ᆼ ᄉ ᅵ ᆨ
화폐로	ᄒ ᅪ ᄑ ᅨ ᄅ ᅩ
인정	ᄋ ᅵ ᆫ ᄌ ᅥ ᆼ
비트코인에	ᄇ ᅵ ᄐ ᅳ ᄏ ᅩ ᄋ ᅵ ᄂ ᅦ
열기는	ᄋ ᅧ ᆯ ᄀ ᅵ ᄂ ᅳ ᆫ
수그러들지	ᄉ ᅮ ᄀ ᅳ ᄅ ᅥ ᄃ ᅳ ᆯ ᄌ ᅵ
천육백삼십년대	ᄎ ᅥ ᄂ ᅲ ᆨ ᄈ ᅢ ᆨ ᄊ ᅡ ᆷ ᄉ ᅵ ᆷ ᄂ ᅧ ᆫ ᄃ ᅢ
네덜란드를	ᄂ ᅦ ᄃ ᅥ ᆯ ᄅ ᅡ ᆫ ᄃ ᅳ ᄅ ᅳ ᆯ
광풍으로	ᄀ ᅪ ᆼ ᄑ ᅮ ᆼ ᄋ ᅳ ᄅ ᅩ
몰아친	ᄆ ᅩ ᄅ ᅡ ᄎ ᅵ ᆫ
튤립	ᄐ ᅲ ᆯ ᄅ ᅵ ᆸ
투기가	ᄐ ᅮ ᄀ ᅵ ᄀ ᅡ
세기의	ᄉ ᅦ ᄀ ᅵ ᄋ ᅴ
키워	ᄏ ᅵ ᄋ ᅯ
대대적으로	ᄃ ᅢ ᄃ ᅢ ᄌ ᅥ ᄀ ᅳ ᄅ ᅩ
번지는	ᄇ ᅥ ᆫ ᄌ ᅵ ᄂ ᅳ ᆫ
아니냐는	ᄋ ᅡ ᄂ ᅵ ᄂ ᅣ ᄂ ᅳ ᆫ
지적까지	ᄌ ᅵ ᄌ ᅥ ᆨ ᄁ ᅡ ᄌ ᅵ
금과	ᄀ ᅳ ᆷ ᄀ ᅪ
발행량의	ᄇ ᅡ ᆯ ᄒ ᅢ ᆼ ᄂ ᅣ ᆼ ᄋ ᅴ
한계와	ᄒ ᅡ ᆫ ᄀ ᅨ ᄋ ᅪ
교환가치를	ᄀ ᅭ ᄒ ᅪ ᆫ ᄀ ᅡ ᄎ ᅵ ᄅ ᅳ ᆯ
쥐는	ᄌ ᅱ ᄂ ᅳ ᆫ
화폐나	ᄒ ᅪ ᄑ ᅨ ᄂ ᅡ
역사적으로	ᄋ ᅧ ᆨ ᄊ ᅡ ᄌ ᅥ ᄀ ᅳ ᄅ ᅩ
오직	ᄋ ᅩ ᄌ ᅵ ᆨ
정부에	ᄌ ᅥ ᆼ ᄇ ᅮ ᄋ ᅦ
의해서만	ᄋ ᅴ ᄒ ᅢ ᄉ ᅥ ᄆ ᅡ ᆫ
발행	ᄇ ᅡ ᆯ ᄒ ᅢ ᆼ
됐지만	ᄃ ᅫ ᆮ ᄍ ᅵ ᄆ ᅡ ᆫ
가상화폐는	ᄀ ᅡ ᄉ ᅡ ᆼ ᄒ ᅪ ᄑ ᅨ ᄂ ᅳ ᆫ
통제에서	ᄐ ᅩ ᆼ ᄌ ᅦ ᄋ ᅦ ᄉ ᅥ
벗어나	ᄇ ᅥ ᄉ ᅥ ᄂ ᅡ
화폐를	ᄒ ᅪ ᄑ ᅨ ᄅ ᅳ ᆯ
발행한다	ᄇ ᅡ ᆯ ᄒ ᅢ ᆼ ᄒ ᅡ ᆫ ᄃ ᅡ
가상	ᄀ ᅡ ᄉ ᅡ ᆼ
채굴	ᄎ ᅢ ᄀ ᅮ ᆯ
중앙은행을	ᄌ ᅮ ᆼ ᄋ ᅡ ᆼ ᄋ ᅳ ᆫ ᄒ ᅢ ᆼ ᄋ ᅳ ᆯ
거치지	ᄀ ᅥ ᄎ ᅵ ᄌ ᅵ
않더라도	ᄋ ᅡ ᆫ ᄐ ᅥ ᄅ ᅡ ᄃ ᅩ
개인의	ᄀ ᅢ ᄋ ᅵ ᄂ ᅴ
지갑	ᄌ ᅵ ᄀ ᅡ ᆸ
블록	ᄇ ᅳ ᆯ ᄅ ᅩ ᆨ
체인을	ᄎ ᅦ ᄋ ᅵ ᄂ ᅳ ᆯ
정부의	ᄌ ᅥ ᆼ ᄇ ᅮ ᄋ ᅴ
벗어날	ᄇ ᅥ ᄉ ᅥ ᄂ ᅡ ᆯ
이천구년	ᄋ ᅵ ᄎ ᅥ ᆫ ᄀ ᅮ ᄂ ᅧ ᆫ
처음으로	ᄎ ᅥ ᄋ ᅳ ᄆ ᅳ ᄅ ᅩ
탄생한	ᄐ ᅡ ᆫ ᄉ ᅢ ᆼ ᄒ ᅡ ᆫ
비트코인은	ᄇ ᅵ ᄐ ᅳ ᄏ ᅩ ᄋ ᅵ ᄂ ᅳ ᆫ
수단으로	ᄉ ᅮ ᄃ ᅡ ᄂ ᅳ ᄅ ᅩ
받고	ᄇ ᅡ ᆮ ᄁ ᅩ
과정은	ᄀ ᅪ ᄌ ᅥ ᆼ ᄋ ᅳ ᆫ
복잡해지며	ᄇ ᅩ ᆨ ᄍ ᅡ ᄑ ᅢ ᄌ ᅵ ᄆ ᅧ
자본이	ᄌ ᅡ ᄇ ᅩ ᄂ ᅵ
필요해졌다	ᄑ ᅵ ᄅ ᅭ ᄒ ᅢ ᄌ ᅥ ᆮ ᄄ ᅡ
일반인이	ᄋ ᅵ ᆯ ᄇ ᅡ ᄂ ᅵ ᄂ ᅵ
현실적으로	ᄒ ᅧ ᆫ ᄉ ᅵ ᆯ ᄌ ᅥ ᄀ ᅳ ᄅ ᅩ
거래소에서	ᄀ ᅥ ᄅ ᅢ ᄉ ᅩ ᄋ ᅦ ᄉ ᅥ
구매하는	ᄀ ᅮ ᄆ ᅢ ᄒ ᅡ ᄂ ᅳ ᆫ
뿐이다	ᄈ ᅮ ᄂ ᅵ ᄃ ᅡ
채굴의	ᄎ ᅢ ᄀ ᅮ ᄅ ᅴ
어려움	ᄋ ᅥ ᄅ ᅧ ᄋ ᅮ ᆷ
부실한	ᄇ ᅮ ᄉ ᅵ ᆯ ᄒ ᅡ ᆫ
틈을	ᄐ ᅳ ᄆ ᅳ ᆯ
타	ᄐ ᅡ
비트코인의	ᄇ ᅵ ᄐ ᅳ ᄏ ᅩ ᄋ ᅵ ᄂ ᅴ
급등락을	ᄀ ᅳ ᆸ ᄄ ᅳ ᆼ ᄂ ᅡ ᄀ ᅳ ᆯ
반복하고	ᄇ ᅡ ᆫ ᄇ ᅩ ᄏ ᅡ ᄀ ᅩ
십칠	ᄉ ᅵ ᆸ ᄎ ᅵ ᆯ
세기	ᄉ ᅦ ᄀ ᅵ
버블	ᄇ ᅥ ᄇ ᅳ ᆯ
수천	ᄉ ᅮ ᄎ ᅥ ᆫ
뛰었다	ᄄ ᅱ ᄋ ᅥ ᆮ ᄄ ᅡ
이천십년	ᄋ ᅵ ᄎ ᅥ ᆫ ᄉ ᅵ ᆷ ᄂ ᅧ ᆫ
플로리다에서	ᄑ ᅳ ᆯ ᄅ ᅩ ᄅ ᅵ ᄃ ᅡ ᄋ ᅦ ᄉ ᅥ
비트코인으로	ᄇ ᅵ ᄐ ᅳ ᄏ ᅩ ᄋ ᅵ ᄂ ᅳ ᄅ ᅩ
피자	ᄑ ᅵ ᄌ ᅡ
판을	ᄑ ᅡ ᄂ ᅳ ᆯ
주문	ᄌ ᅮ ᄆ ᅮ ᆫ
이천억에	ᄋ ᅵ ᄎ ᅥ ᄂ ᅥ ᄀ ᅦ
이른다	ᄋ ᅵ ᄅ ᅳ ᆫ ᄃ ᅡ
배가	ᄇ ᅢ ᄀ ᅡ
급등	ᄀ ᅳ ᆸ ᄄ ᅳ ᆼ
벌어지고	ᄇ ᅥ ᄅ ᅥ ᄌ ᅵ ᄀ ᅩ
변동으로	ᄇ ᅧ ᆫ ᄃ ᅩ ᆼ ᄋ ᅳ ᄅ ᅩ
섣불리	ᄉ ᅥ ᆮ ᄈ ᅮ ᆯ ᄅ ᅵ
투자한	ᄐ ᅮ ᄌ ᅡ ᄒ ᅡ ᆫ
일반인들이	ᄋ ᅵ ᆯ ᄇ ᅡ ᄂ ᅵ ᆫ ᄃ ᅳ ᄅ ᅵ
입을	ᄋ ᅵ ᄇ ᅳ ᆯ
가상화폐라는	ᄀ ᅡ ᄉ ᅡ ᆼ ᄒ ᅪ ᄑ ᅨ ᄅ ᅡ ᄂ ᅳ ᆫ
퍼지면	ᄑ ᅥ ᄌ ᅵ ᄆ ᅧ ᆫ
투자자는	ᄐ ᅮ ᄌ ᅡ ᄌ ᅡ ᄂ ᅳ ᆫ
보게	ᄇ ᅩ ᄀ ᅦ
경제적으로도	ᄀ ᅧ ᆼ ᄌ ᅦ ᄌ ᅥ ᄀ ᅳ ᄅ ᅩ ᄃ ᅩ
어려움에	ᄋ ᅥ ᄅ ᅧ ᄋ ᅮ ᄆ ᅦ
빠질	ᄈ ᅡ ᄌ ᅵ ᆯ
네덜란드	ᄂ ᅦ ᄃ ᅥ ᆯ ᄅ ᅡ ᆫ ᄃ ᅳ
광풍	ᄀ ᅪ ᆼ ᄑ ᅮ ᆼ
튤립은	ᄐ ᅲ ᆯ ᄅ ᅵ ᄇ ᅳ ᆫ
중앙아시아	ᄌ ᅮ ᆼ ᄋ ᅡ ᆼ ᄋ ᅡ ᄉ ᅵ ᄋ ᅡ
고원	ᄀ ᅩ ᄋ ᅯ ᆫ
지대에서	ᄌ ᅵ ᄃ ᅢ ᄋ ᅦ ᄉ ᅥ
야생으로	ᄋ ᅣ ᄉ ᅢ ᆼ ᄋ ᅳ ᄅ ᅩ
자라는	ᄌ ᅡ ᄅ ᅡ ᄂ ᅳ ᆫ
꽃이	ᄁ ᅩ ᄎ ᅵ
터키로	ᄐ ᅥ ᄏ ᅵ ᄅ ᅩ
전해졌고	ᄌ ᅥ ᆫ ᄒ ᅢ ᄌ ᅥ ᆮ ᄁ ᅩ
동서향	ᄃ ᅩ ᆼ ᄉ ᅥ ᄒ ᅣ ᆼ
항로	ᄒ ᅡ ᆼ ᄂ ᅩ
뱃길가	ᄇ ᅢ ᆮ ᄁ ᅵ ᆯ ᄁ ᅡ
천오백구십오년	ᄎ ᅥ ᄂ ᅩ ᄇ ᅢ ᆨ ᄁ ᅮ ᄉ ᅵ ᄇ ᅩ ᄂ ᅧ ᆫ
네덜란드에	ᄂ ᅦ ᄃ ᅥ ᆯ ᄅ ᅡ ᆫ ᄃ ᅳ ᄋ ᅦ
상륙	ᄉ ᅡ ᆼ ᄂ ᅲ ᆨ
화려함으로	ᄒ ᅪ ᄅ ᅧ ᄒ ᅡ ᄆ ᅳ ᄅ ᅩ
귀족들의	ᄀ ᅱ ᄌ ᅩ ᆨ ᄄ ᅳ ᄅ ᅴ
정원에서	ᄌ ᅥ ᆼ ᄋ ᅯ ᄂ ᅦ ᄉ ᅥ
끈	ᄁ ᅳ ᆫ
화초였다	ᄒ ᅪ ᄎ ᅩ ᄋ ᅧ ᆮ ᄄ ᅡ
튤립에	ᄐ ᅲ ᆯ ᄅ ᅵ ᄇ ᅦ
천육백년대	ᄎ ᅥ ᄂ ᅲ ᆨ ᄈ ᅢ ᆼ ᄂ ᅧ ᆫ ᄃ ᅢ
부근만	ᄇ ᅮ ᄀ ᅳ ᆫ ᄆ ᅡ ᆫ
색깔의	ᄉ ᅢ ᆨ ᄁ ᅡ ᄅ ᅴ
꽃인지	ᄁ ᅩ ᄎ ᅵ ᆫ ᄌ ᅵ
알	ᄋ ᅡ ᆯ
그러자	ᄀ ᅳ ᄅ ᅥ ᄌ ᅡ
여유	ᄋ ᅧ ᄋ ᅲ
귀족들은	ᄀ ᅱ ᄌ ᅩ ᆨ ᄄ ᅳ ᄅ ᅳ ᆫ
뿌리를	ᄈ ᅮ ᄅ ᅵ ᄅ ᅳ ᆯ
무더기로	ᄆ ᅮ ᄃ ᅥ ᄀ ᅵ ᄅ ᅩ
사들이기	ᄉ ᅡ ᄃ ᅳ ᄅ ᅵ ᄀ ᅵ
시작했다	ᄉ ᅵ ᄌ ᅡ ᄏ ᅢ ᆮ ᄄ ᅡ
시작된	ᄉ ᅵ ᄌ ᅡ ᆨ ᄄ ᅬ ᆫ
투기	ᄐ ᅮ ᄀ ᅵ
열풍은	ᄋ ᅧ ᆯ ᄑ ᅮ ᆼ ᄋ ᅳ ᆫ
귀족을	ᄀ ᅱ ᄌ ᅩ ᄀ ᅳ ᆯ
거쳐	ᄀ ᅥ ᄎ ᅥ
중산층과	ᄌ ᅮ ᆼ ᄉ ᅡ ᆫ ᄎ ᅳ ᆼ ᄀ ᅪ
서민층으로	ᄉ ᅥ ᄆ ᅵ ᆫ ᄎ ᅳ ᆼ ᄋ ᅳ ᄅ ᅩ
퍼졌다	ᄑ ᅥ ᄌ ᅥ ᆮ ᄄ ᅡ
광풍이	ᄀ ᅪ ᆼ ᄑ ᅮ ᆼ ᄋ ᅵ
불었다	ᄇ ᅮ ᄅ ᅥ ᆮ ᄄ ᅡ
천육백삼십삼	ᄎ ᅥ ᄂ ᅲ ᆨ ᄈ ᅢ ᆨ ᄊ ᅡ ᆷ ᄉ ᅵ ᆸ ᄊ ᅡ ᆷ
년부터	ᄂ ᅧ ᆫ ᄇ ᅮ ᄐ ᅥ
바람으로	ᄇ ᅡ ᄅ ᅡ ᄆ ᅳ ᄅ ᅩ
하늘	ᄒ ᅡ ᄂ ᅳ ᆯ
지금으로	ᄌ ᅵ ᄀ ᅳ ᄆ ᅳ ᄅ ᅩ
원하던	ᄋ ᅯ ᆫ ᄒ ᅡ ᄃ ᅥ ᆫ
알뿌리	ᄋ ᅡ ᆯ ᄈ ᅮ ᄅ ᅵ
하나가	ᄒ ᅡ ᄂ ᅡ ᄀ ᅡ
사천만에서	ᄉ ᅡ ᄎ ᅥ ᆫ ᄆ ᅡ ᄂ ᅦ ᄉ ᅥ
오천만	ᄋ ᅩ ᄎ ᅥ ᆫ ᄆ ᅡ ᆫ
원까지	ᄋ ᅯ ᆫ ᄁ ᅡ ᄌ ᅵ
비슷하다고	ᄇ ᅵ ᄉ ᅳ ᄐ ᅡ ᄃ ᅡ ᄀ ᅩ
필립의	ᄑ ᅵ ᆯ ᄅ ᅵ ᄇ ᅴ
거품이	ᄀ ᅥ ᄑ ᅮ ᄆ ᅵ
빠지기	ᄈ ᅡ ᄌ ᅵ ᄀ ᅵ
시작했고	ᄉ ᅵ ᄌ ᅡ ᄏ ᅢ ᆮ ᄁ ᅩ
폭락해	ᄑ ᅩ ᆼ ᄂ ᅡ ᄏ ᅢ
경제는	ᄀ ᅧ ᆼ ᄌ ᅦ ᄂ ᅳ ᆫ
빠졌다	ᄈ ᅡ ᄌ ᅥ ᆮ ᄄ ᅡ
조처를	ᄌ ᅩ ᄎ ᅥ ᄅ ᅳ ᆯ
내린다	ᄂ ᅢ ᄅ ᅵ ᆫ ᄃ ᅡ
오에서	ᄋ ᅩ ᄋ ᅦ ᄉ ᅥ
꽃인	ᄁ ᅩ ᄎ ᅵ ᆫ
바람이	ᄇ ᅡ ᄅ ᅡ ᄆ ᅵ
들어가면	ᄃ ᅳ ᄅ ᅥ ᄀ ᅡ ᄆ ᅧ ᆫ
가져온다	ᄀ ᅡ ᄌ ᅥ ᄋ ᅩ ᆫ ᄃ ᅡ
불고	ᄇ ᅮ ᆯ ᄀ ᅩ
열풍에서	ᄋ ᅧ ᆯ ᄑ ᅮ ᆼ ᄋ ᅦ ᄉ ᅥ
튤립을	ᄐ ᅲ ᆯ ᄅ ᅵ ᄇ ᅳ ᆯ
형체라도	ᄒ ᅧ ᆼ ᄎ ᅦ ᄅ ᅡ ᄃ ᅩ
필립	ᄑ ᅵ ᆯ ᄅ ᅵ ᆸ
재판	ᄌ ᅢ ᄑ ᅡ ᆫ
천육백삼십칠년	ᄎ ᅥ ᄂ ᅲ ᆨ ᄈ ᅢ ᆨ ᄊ ᅡ ᆷ ᄉ ᅵ ᆸ ᄎ ᅵ ᆯ ᄅ ᅧ ᆫ
세르반테스라는	ᄉ ᅦ ᄅ ᅳ ᄇ ᅡ ᆫ ᄐ ᅦ ᄉ ᅳ ᄅ ᅡ ᄂ ᅳ ᆫ
선원은	ᄉ ᅥ ᄂ ᅯ ᄂ ᅳ ᆫ
오랜만에	ᄋ ᅩ ᄅ ᅢ ᆫ ᄆ ᅡ ᄂ ᅦ
고국에	ᄀ ᅩ ᄀ ᅮ ᄀ ᅦ
돌아와	ᄃ ᅩ ᄅ ᅡ ᄋ ᅪ
암스테르담의	ᄋ ᅡ ᆷ ᄉ ᅳ ᄐ ᅦ ᄅ ᅳ ᄃ ᅡ ᄆ ᅴ
머물고	ᄆ ᅥ ᄆ ᅮ ᆯ ᄀ ᅩ
양파인	ᄋ ᅣ ᆼ ᄑ ᅡ ᄋ ᅵ ᆫ
법정에	ᄇ ᅥ ᆸ ᄍ ᅥ ᆼ ᄋ ᅦ
서게	ᄉ ᅥ ᄀ ᅦ
개는	ᄀ ᅢ ᄂ ᅳ ᆫ
채의	ᄎ ᅢ ᄋ ᅴ
있었던	ᄋ ᅵ ᄊ ᅥ ᆮ ᄄ ᅥ ᆫ
몰랐던	ᄆ ᅩ ᆯ ᄅ ᅡ ᆮ ᄄ ᅥ ᆫ
당연히	ᄃ ᅡ ᆼ ᄋ ᅧ ᆫ ᄒ ᅵ
재판에서	ᄌ ᅢ ᄑ ᅡ ᄂ ᅦ ᄉ ᅥ
졌	ᄌ ᅥ ᆮ
배상해야	ᄇ ᅢ ᄉ ᅡ ᆼ ᄒ ᅢ ᄋ ᅣ
판결이	ᄑ ᅡ ᆫ ᄀ ᅧ ᄅ ᅵ
나왔다	ᄂ ᅡ ᄋ ᅪ ᆮ ᄄ ᅡ
소송을	ᄉ ᅩ ᄉ ᅩ ᆼ ᄋ ᅳ ᆯ
계기로	ᄀ ᅨ ᄀ ᅵ ᄅ ᅩ
튤립이	ᄐ ᅲ ᆯ ᄅ ᅵ ᄇ ᅵ
있느냐는	ᄋ ᅵ ᆫ ᄂ ᅳ ᄂ ᅣ ᄂ ᅳ ᆫ
반성이	ᄇ ᅡ ᆫ ᄉ ᅥ ᆼ ᄋ ᅵ
일어나기	ᄋ ᅵ ᄅ ᅥ ᄂ ᅡ ᄀ ᅵ
재판은	ᄌ ᅢ ᄑ ᅡ ᄂ ᅳ ᆫ
폭락하면서	ᄑ ᅩ ᆼ ᄂ ᅡ ᄏ ᅡ ᄆ ᅧ ᆫ ᄉ ᅥ
공황을	ᄀ ᅩ ᆼ ᄒ ᅪ ᆼ ᄋ ᅳ ᆯ
일으키는	ᄋ ᅵ ᄅ ᅳ ᄏ ᅵ ᄂ ᅳ ᆫ
출발점이	ᄎ ᅮ ᆯ ᄇ ᅡ ᆯ ᄌ ᅥ ᄆ ᅵ
공이	ᄀ ᅩ ᆼ ᄋ ᅵ
예약하고	ᄋ ᅨ ᄋ ᅣ ᄏ ᅡ ᄀ ᅩ
오지	ᄋ ᅩ ᄌ ᅵ
노쇼	ᄂ ᅩ ᄉ ᅭ
명준이는	ᄆ ᅧ ᆼ ᄌ ᅮ ᄂ ᅵ ᄂ ᅳ ᆫ
학교를	ᄒ ᅡ ᆨ ᄁ ᅭ ᄅ ᅳ ᆯ
치과에	ᄎ ᅵ ᄀ ᅪ ᄋ ᅦ
가기로	ᄀ ᅡ ᄀ ᅵ ᄅ ᅩ
취소하면	ᄎ ᅱ ᄉ ᅩ ᄒ ᅡ ᄆ ᅧ ᆫ
어떡하니	ᄋ ᅥ ᄄ ᅥ ᄏ ᅡ ᄂ ᅵ
한둘이	ᄒ ᅡ ᆫ ᄃ ᅮ ᄅ ᅵ
아니란다	ᄋ ᅡ ᄂ ᅵ ᄅ ᅡ ᆫ ᄃ ᅡ
급한	ᄀ ᅳ ᄑ ᅡ ᆫ
아니라면	ᄋ ᅡ ᄂ ᅵ ᄅ ᅡ ᄆ ᅧ ᆫ
예약을	ᄋ ᅨ ᄋ ᅣ ᄀ ᅳ ᆯ
취소	ᄎ ᅱ ᄉ ᅩ
이기적인	ᄋ ᅵ ᄀ ᅵ ᄌ ᅥ ᄀ ᅵ ᆫ
행동이야	ᄒ ᅢ ᆼ ᄃ ᅩ ᆼ ᄋ ᅵ ᄋ ᅣ
예약해	ᄋ ᅨ ᄋ ᅣ ᄏ ᅢ
둔	ᄃ ᅮ ᆫ
진료가	ᄌ ᅵ ᆯ ᄅ ᅭ ᄀ ᅡ
진료를	ᄌ ᅵ ᆯ ᄅ ᅭ ᄅ ᅳ ᆯ
병원	ᄇ ᅧ ᆼ ᄋ ᅯ ᆫ
측에서도	ᄎ ᅳ ᄀ ᅦ ᄉ ᅥ ᄃ ᅩ
의미	ᄋ ᅴ ᄆ ᅵ
빈	ᄇ ᅵ ᆫ
시각이	ᄉ ᅵ ᄀ ᅡ ᄀ ᅵ
잖아	ᄌ ᅡ ᄂ ᅡ
다음부터는	ᄃ ᅡ ᄋ ᅳ ᆷ ᄇ ᅮ ᄐ ᅥ ᄂ ᅳ ᆫ
절대로	ᄌ ᅥ ᆯ ᄃ ᅢ ᄅ ᅩ
영준이도	ᄋ ᅧ ᆼ ᄌ ᅮ ᄂ ᅵ ᄃ ᅩ
잘못했다는	ᄌ ᅡ ᆯ ᄆ ᅩ ᄐ ᅢ ᆮ ᄄ ᅡ ᄂ ᅳ ᆫ
들었고	ᄃ ᅳ ᄅ ᅥ ᆮ ᄁ ᅩ
반성	ᄇ ᅡ ᆫ ᄉ ᅥ ᆼ
중이었죠	ᄌ ᅮ ᆼ ᄋ ᅵ ᄋ ᅥ ᆮ ᄍ ᅭ
영준	ᄋ ᅧ ᆼ ᄌ ᅮ ᆫ
죄송해요	ᄌ ᅬ ᄉ ᅩ ᆼ ᄒ ᅢ ᄋ ᅭ
번쯤은	ᄇ ᅥ ᆫ ᄍ ᅳ ᄆ ᅳ ᆫ
괜찮을	ᄀ ᅫ ᆫ ᄎ ᅡ ᄂ ᅳ ᆯ
생각했어요	ᄉ ᅢ ᆼ ᄀ ᅡ ᄏ ᅢ ᄊ ᅥ ᄋ ᅭ
피해	ᄑ ᅵ ᄒ ᅢ
생각은	ᄉ ᅢ ᆼ ᄀ ᅡ ᄀ ᅳ ᆫ
노쇼가	ᄂ ᅩ ᄉ ᅭ ᄀ ᅡ
말하는	ᄆ ᅡ ᆯ ᄒ ᅡ ᄂ ᅳ ᆫ
건가요	ᄀ ᅥ ᆫ ᄀ ᅡ ᄋ ᅭ
노쇼는	ᄂ ᅩ ᄉ ᅭ ᄂ ᅳ ᆫ
않거나	ᄋ ᅡ ᆫ ᄏ ᅥ ᄂ ᅡ
되어갈	ᄃ ᅬ ᄋ ᅥ ᄀ ᅡ ᆯ
취소하는	ᄎ ᅱ ᄉ ᅩ ᄒ ᅡ ᄂ ᅳ ᆫ
글자	ᄀ ᅳ ᆯ ᄌ ᅡ
나타나지	ᄂ ᅡ ᄐ ᅡ ᄂ ᅡ ᄌ ᅵ
않는다라는	ᄋ ᅡ ᆫ ᄂ ᅳ ᆫ ᄃ ᅡ ᄅ ᅡ ᄂ ᅳ ᆫ
뜻이야	ᄄ ᅳ ᄉ ᅵ ᄋ ᅣ
노쇼족은	ᄂ ᅩ ᄉ ᅭ ᄌ ᅩ ᄀ ᅳ ᆫ
행위를	ᄒ ᅢ ᆼ ᄋ ᅱ ᄅ ᅳ ᆯ
말하고	ᄆ ᅡ ᆯ ᄒ ᅡ ᄀ ᅩ
일찍	ᄋ ᅵ ᆯ ᄍ ᅵ ᆨ
알려주면	ᄋ ᅡ ᆯ ᄅ ᅧ ᄌ ᅮ ᄆ ᅧ ᆫ
상관이	ᄉ ᅡ ᆼ ᄀ ᅪ ᄂ ᅵ
뒤늦게	ᄃ ᅱ ᄂ ᅳ ᆮ ᄁ ᅦ
영업에	ᄋ ᅧ ᆼ ᄋ ᅥ ᄇ ᅦ
주게	ᄌ ᅮ ᄀ ᅦ
치과는	ᄎ ᅵ ᄀ ᅪ ᄂ ᅳ ᆫ
물론이고	ᄆ ᅮ ᆯ ᄅ ᅩ ᄂ ᅵ ᄀ ᅩ
음식점	ᄋ ᅳ ᆷ ᄉ ᅵ ᆨ ᄍ ᅥ ᆷ
영화관	ᄋ ᅧ ᆼ ᄒ ᅪ ᄀ ᅪ ᆫ
고속버스	ᄀ ᅩ ᄉ ᅩ ᆨ ᄈ ᅥ ᄉ ᅳ
일어나고	ᄋ ᅵ ᄅ ᅥ ᄂ ᅡ ᄀ ᅩ
점을	ᄌ ᅥ ᄆ ᅳ ᆯ
가겠다고	ᄀ ᅡ ᄀ ᅦ ᆮ ᄄ ᅡ ᄀ ᅩ
해놓고	ᄒ ᅢ ᄂ ᅩ ᄏ ᅩ
입장에서는	ᄋ ᅵ ᆸ ᄍ ᅡ ᆼ ᄋ ᅦ ᄉ ᅥ ᄂ ᅳ ᆫ
손해겠네요	ᄉ ᅩ ᆫ ᄒ ᅢ ᄀ ᅦ ᆫ ᄂ ᅦ ᄋ ᅭ
그렇지	ᄀ ᅳ ᄅ ᅥ ᄎ ᅵ
수에	ᄉ ᅮ ᄋ ᅦ
막	ᄆ ᅡ ᆨ
보상금을	ᄇ ᅩ ᄉ ᅡ ᆼ ᄀ ᅳ ᄆ ᅳ ᆯ
받기도	ᄇ ᅡ ᆮ ᄁ ᅵ ᄃ ᅩ
한단다	ᄒ ᅡ ᆫ ᄃ ᅡ ᆫ ᄃ ᅡ
영화관에서의	ᄋ ᅧ ᆼ ᄒ ᅪ ᄀ ᅪ ᄂ ᅦ ᄉ ᅥ ᄋ ᅴ
뭔가요	ᄆ ᅯ ᆫ ᄀ ᅡ ᄋ ᅭ
최근에	ᄎ ᅬ ᄀ ᅳ ᄂ ᅦ
나타난	ᄂ ᅡ ᄐ ᅡ ᄂ ᅡ ᆫ
현상인데	ᄒ ᅧ ᆫ ᄉ ᅡ ᆼ ᄋ ᅵ ᆫ ᄃ ᅦ
앉지	ᄋ ᅡ ᆫ ᄍ ᅵ
못하게	ᄆ ᅩ ᄐ ᅡ ᄀ ᅦ
씨지브이는	ᄊ ᅵ ᄌ ᅵ ᄇ ᅳ ᄋ ᅵ ᄂ ᅳ ᆫ
예매	ᄋ ᅨ ᄆ ᅢ
취소율의	ᄎ ᅱ ᄉ ᅩ ᄋ ᅲ ᄅ ᅴ
상영	ᄉ ᅡ ᆼ ᄋ ᅧ ᆼ
십오에서	ᄉ ᅵ ᄇ ᅩ ᄋ ᅦ ᄉ ᅥ
이루어진다고	ᄋ ᅵ ᄅ ᅮ ᄋ ᅥ ᄌ ᅵ ᆫ ᄃ ᅡ ᄀ ᅩ
하더구나	ᄒ ᅡ ᄃ ᅥ ᄀ ᅮ ᄂ ᅡ
이기적이네요	ᄋ ᅵ ᄀ ᅵ ᄌ ᅥ ᄀ ᅵ ᄂ ᅦ ᄋ ᅭ
시작이	ᄉ ᅵ ᄌ ᅡ ᄀ ᅵ
임박해서	ᄋ ᅵ ᆷ ᄇ ᅡ ᄏ ᅢ ᄉ ᅥ
예매하기	ᄋ ᅨ ᄆ ᅢ ᄒ ᅡ ᄀ ᅵ
힘들잖아요	ᄒ ᅵ ᆷ ᄃ ᅳ ᆯ ᄌ ᅡ ᄂ ᅡ ᄋ ᅭ
고속	ᄀ ᅩ ᄉ ᅩ ᆨ
버스도	ᄇ ᅥ ᄉ ᅳ ᄃ ᅩ
마찬가지야	ᄆ ᅡ ᄎ ᅡ ᆫ ᄀ ᅡ ᄌ ᅵ ᄋ ᅣ
양쪽	ᄋ ᅣ ᆼ ᄍ ᅩ ᆨ
예매하고	ᄋ ᅨ ᄆ ᅢ ᄒ ᅡ ᄀ ᅩ
출발	ᄎ ᅮ ᆯ ᄇ ᅡ ᆯ
직전에	ᄌ ᅵ ᆨ ᄍ ᅥ ᄂ ᅦ
많단다	ᄆ ᅡ ᆫ ᄐ ᅡ ᆫ ᄃ ᅡ
철도의	ᄎ ᅥ ᆯ ᄃ ᅩ ᄋ ᅴ
설	ᄉ ᅥ ᆯ
명절	ᄆ ᅧ ᆼ ᄌ ᅥ ᆯ
당일	ᄃ ᅡ ᆼ ᄋ ᅵ ᆯ
취소가	ᄎ ᅱ ᄉ ᅩ ᄀ ᅡ
무려	ᄆ ᅮ ᄅ ᅧ
육십칠	ᄋ ᅲ ᆨ ᄊ ᅵ ᆸ ᄎ ᅵ ᆯ
택시의	ᄐ ᅢ ᆨ ᄊ ᅵ ᄋ ᅴ
불러놓고	ᄇ ᅮ ᆯ ᄅ ᅥ ᄂ ᅩ ᄏ ᅩ
지나가면	ᄌ ᅵ ᄂ ᅡ ᄀ ᅡ ᄆ ᅧ ᆫ
타고	ᄐ ᅡ ᄀ ᅩ
시간과	ᄉ ᅵ ᄀ ᅡ ᆫ ᄀ ᅪ
빼앗는	ᄈ ᅢ ᄋ ᅡ ᆫ ᄂ ᅳ ᆫ
명준이의	ᄆ ᅧ ᆼ ᄌ ᅮ ᄂ ᅵ ᄋ ᅴ
쓰다듬으며	ᄊ ᅳ ᄃ ᅡ ᄃ ᅳ ᄆ ᅳ ᄆ ᅧ
말했어요	ᄆ ᅡ ᆯ ᄒ ᅢ ᄊ ᅥ ᄋ ᅭ
지키지	ᄌ ᅵ ᄏ ᅵ ᄌ ᅵ
예약했기	ᄋ ᅨ ᄋ ᅣ ᄏ ᅢ ᆮ ᄁ ᅵ
손님들은	ᄉ ᅩ ᆫ ᄂ ᅵ ᆷ ᄃ ᅳ ᄅ ᅳ ᆫ
예약했을	ᄋ ᅨ ᄋ ᅣ ᄏ ᅢ ᄊ ᅳ ᆯ
어머니의	ᄋ ᅥ ᄆ ᅥ ᄂ ᅵ ᄋ ᅴ
깊이	ᄀ ᅵ ᄑ ᅵ
반성했습니다	ᄇ ᅡ ᆫ ᄉ ᅥ ᆼ ᄒ ᅢ ᆮ ᄊ ᅳ ᆷ ᄂ ᅵ ᄃ ᅡ
한정된	ᄒ ᅡ ᆫ ᄌ ᅥ ᆼ ᄃ ᅬ ᆫ
인원에게	ᄋ ᅵ ᄂ ᅯ ᄂ ᅦ ᄀ ᅦ
제공할	ᄌ ᅦ ᄀ ᅩ ᆼ ᄒ ᅡ ᆯ
밖에	ᄇ ᅡ ᄁ ᅦ
서비스	ᄉ ᅥ ᄇ ᅵ ᄉ ᅳ
업계에서	ᄋ ᅥ ᆸ ᄁ ᅨ ᄋ ᅦ ᄉ ᅥ
문제이다	ᄆ ᅮ ᆫ ᄌ ᅦ ᄋ ᅵ ᄃ ᅡ
강남	ᄀ ᅡ ᆼ ᄂ ᅡ ᆷ
재건축	ᄌ ᅢ ᄀ ᅥ ᆫ ᄎ ᅮ ᆨ
수주	ᄉ ᅮ ᄌ ᅮ
주문을	ᄌ ᅮ ᄆ ᅮ ᄂ ᅳ ᆯ
받는	ᄇ ᅡ ᆫ ᄂ ᅳ ᆫ
것에	ᄀ ᅥ ᄉ ᅦ
실패한	ᄉ ᅵ ᆯ ᄑ ᅢ ᄒ ᅡ ᆫ
롯데건설이	ᄅ ᅩ ᆮ ᄄ ᅦ ᄀ ᅥ ᆫ ᄉ ᅥ ᄅ ᅵ
앞서	ᄋ ᅡ ᆸ ᄊ ᅥ
승리를	ᄉ ᅳ ᆼ ᄂ ᅵ ᄅ ᅳ ᆯ
자축하며	ᄌ ᅡ ᄎ ᅮ ᄏ ᅡ ᄆ ᅧ
걸었다가	ᄀ ᅥ ᄅ ᅥ ᆮ ᄄ ᅡ ᄀ ᅡ
취소해	ᄎ ᅱ ᄉ ᅩ ᄒ ᅢ
논란이	ᄂ ᅩ ᆯ ᄅ ᅡ ᄂ ᅵ
바	ᄇ ᅡ
롯데건설측은	ᄅ ᅩ ᆮ ᄄ ᅦ ᄀ ᅥ ᆫ ᄉ ᅥ ᆯ ᄎ ᅳ ᄀ ᅳ ᆫ
처음	ᄎ ᅥ ᄋ ᅳ ᆷ
때에	ᄄ ᅢ ᄋ ᅦ
사정을	ᄉ ᅡ ᄌ ᅥ ᆼ ᄋ ᅳ ᆯ
밝히며	ᄇ ᅡ ᆯ ᄏ ᅵ ᄆ ᅧ
보증금	ᄇ ᅩ ᄌ ᅳ ᆼ ᄀ ᅳ ᆷ
백만	ᄇ ᅢ ᆼ ᄆ ᅡ ᆫ
원과	ᄋ ᅯ ᆫ ᄀ ᅪ
보상비를	ᄇ ᅩ ᄉ ᅡ ᆼ ᄇ ᅵ ᄅ ᅳ ᆯ
지급했다고	ᄌ ᅵ ᄀ ᅳ ᄑ ᅢ ᆮ ᄄ ᅡ ᄀ ᅩ
해명했다	ᄒ ᅢ ᄆ ᅧ ᆼ ᄒ ᅢ ᆮ ᄄ ᅡ
엔피그룹	ᄋ ᅦ ᆫ ᄑ ᅵ ᄀ ᅳ ᄅ ᅮ ᆸ
오너	ᄋ ᅩ ᄂ ᅥ
일가가	ᄋ ᅵ ᆯ ᄀ ᅡ ᄀ ᅡ
경영에서	ᄀ ᅧ ᆼ ᄋ ᅧ ᆼ ᄋ ᅦ ᄉ ᅥ
뗀다	ᄄ ᅦ ᆫ ᄃ ᅡ
정우현	ᄌ ᅥ ᆼ ᄋ ᅮ ᄒ ᅧ ᆫ
엔피	ᄋ ᅦ ᆫ ᄑ ᅵ
그룹	ᄀ ᅳ ᄅ ᅮ ᆸ
회장에	ᄒ ᅬ ᄌ ᅡ ᆼ ᄋ ᅦ
아들인	ᄋ ᅡ ᄃ ᅳ ᄅ ᅵ ᆫ
정순민	ᄌ ᅥ ᆼ ᄉ ᅮ ᆫ ᄆ ᅵ ᆫ
부회장도	ᄇ ᅮ ᄒ ᅬ ᄌ ᅡ ᆼ ᄃ ᅩ
에스비에스	ᄋ ᅦ ᄉ ᅳ ᄇ ᅵ ᄋ ᅦ ᄉ ᅳ
주요	ᄌ ᅮ ᄋ ᅭ
물러나기로	ᄆ ᅮ ᆯ ᄅ ᅥ ᄂ ᅡ ᄀ ᅵ ᄅ ᅩ
윤	ᄋ ᅲ ᆫ
회장은	ᄒ ᅬ ᄌ ᅡ ᆼ ᄋ ᅳ ᆫ
이날	ᄋ ᅵ ᄂ ᅡ ᆯ
사내	ᄉ ᅡ ᄂ ᅢ
방송에서	ᄇ ᅡ ᆼ ᄉ ᅩ ᆼ ᄋ ᅦ ᄉ ᅥ
회장과	ᄒ ᅬ ᄌ ᅡ ᆼ ᄀ ᅪ
의장직을	ᄋ ᅴ ᄌ ᅡ ᆼ ᄌ ᅵ ᄀ ᅳ ᆯ
사임하고	ᄉ ᅡ ᄋ ᅵ ᆷ ᄒ ᅡ ᄀ ᅩ
소유와	ᄉ ᅩ ᄋ ᅲ ᄋ ᅪ
경영의	ᄀ ᅧ ᆼ ᄋ ᅧ ᆼ ᄋ ᅴ
분리를	ᄇ ᅮ ᆯ ᄅ ᅵ ᄅ ᅳ ᆯ
선언한다라고	ᄉ ᅥ ᄂ ᅥ ᆫ ᄒ ᅡ ᆫ ᄃ ᅡ ᄅ ᅡ ᄀ ᅩ
연이어	ᄋ ᅧ ᄂ ᅵ ᄋ ᅥ
뉴스의	ᄂ ᅲ ᄉ ᅳ ᄋ ᅴ
공통점을	ᄀ ᅩ ᆼ ᄐ ᅩ ᆼ ᄌ ᅥ ᄆ ᅳ ᆯ
한마디로	ᄒ ᅡ ᆫ ᄆ ᅡ ᄃ ᅵ ᄅ ᅩ
말하면	ᄆ ᅡ ᆯ ᄒ ᅡ ᄆ ᅧ ᆫ
분리다	ᄇ ᅮ ᆯ ᄅ ᅵ ᄃ ᅡ
표현하면	ᄑ ᅭ ᄒ ᅧ ᆫ ᄒ ᅡ ᄆ ᅧ ᆫ
회사의	ᄒ ᅬ ᄉ ᅡ ᄋ ᅴ
소유권	ᄉ ᅩ ᄋ ᅲ ᄀ ᅯ ᆫ
주식은	ᄌ ᅮ ᄉ ᅵ ᄀ ᅳ ᆫ
유지하되	ᄋ ᅲ ᄌ ᅵ ᄒ ᅡ ᄃ ᅬ
경영	ᄀ ᅧ ᆼ ᄋ ᅧ ᆼ
운영은	ᄋ ᅮ ᄂ ᅧ ᆼ ᄋ ᅳ ᆫ
않겠다는	ᄋ ᅡ ᆫ ᄏ ᅦ ᆮ ᄄ ᅡ ᄂ ᅳ ᆫ
뜻일	ᄄ ᅳ ᄉ ᅵ ᆯ
소유는	ᄉ ᅩ ᄋ ᅲ ᄂ ᅳ ᆫ
주인이라는	ᄌ ᅮ ᄋ ᅵ ᄂ ᅵ ᄅ ᅡ ᄂ ᅳ ᆫ
주식회사에서	ᄌ ᅮ ᄉ ᅵ ᄏ ᅬ ᄉ ᅡ ᄋ ᅦ ᄉ ᅥ
주인이냐	ᄌ ᅮ ᄋ ᅵ ᄂ ᅵ ᄂ ᅣ
아니냐의	ᄋ ᅡ ᄂ ᅵ ᄂ ᅣ ᄋ ᅴ
기준은	ᄀ ᅵ ᄌ ᅮ ᄂ ᅳ ᆫ
주식이	ᄌ ᅮ ᄉ ᅵ ᄀ ᅵ
주라도	ᄌ ᅮ ᄅ ᅡ ᄃ ᅩ
주인이며	ᄌ ᅮ ᄋ ᅵ ᄂ ᅵ ᄆ ᅧ
주주라고	ᄌ ᅮ ᄌ ᅮ ᄅ ᅡ ᄀ ᅩ
부른다	ᄇ ᅮ ᄅ ᅳ ᆫ ᄃ ᅡ
오너라고	ᄋ ᅩ ᄂ ᅥ ᄅ ᅡ ᄀ ᅩ
창업하고	ᄎ ᅡ ᆼ ᄋ ᅥ ᄑ ᅡ ᄀ ᅩ
보유한	ᄇ ᅩ ᄋ ᅲ ᄒ ᅡ ᆫ
주주를	ᄌ ᅮ ᄌ ᅮ ᄅ ᅳ ᆯ
소유하고	ᄉ ᅩ ᄋ ᅲ ᄒ ᅡ ᄀ ᅩ
있는지는	ᄋ ᅵ ᆫ ᄂ ᅳ ᆫ ᄌ ᅵ ᄂ ᅳ ᆫ
겉으로	ᄀ ᅥ ᄐ ᅳ ᄅ ᅩ
드러나지	ᄃ ᅳ ᄅ ᅥ ᄂ ᅡ ᄌ ᅵ
명부로	ᄆ ᅧ ᆼ ᄇ ᅮ ᄅ ᅩ
확인할	ᄒ ᅪ ᄀ ᅵ ᆫ ᄒ ᅡ ᆯ
경영자	ᄀ ᅧ ᆼ ᄋ ᅧ ᆼ ᄌ ᅡ
경영은	ᄀ ᅧ ᆼ ᄋ ᅧ ᆼ ᄋ ᅳ ᆫ
무엇일까	ᄆ ᅮ ᄋ ᅥ ᄉ ᅵ ᆯ ᄁ ᅡ
경영자는	ᄀ ᅧ ᆼ ᄋ ᅧ ᆼ ᄌ ᅡ ᄂ ᅳ ᆫ
대표이사	ᄃ ᅢ ᄑ ᅭ ᄋ ᅵ ᄉ ᅡ
등기이사	ᄃ ᅳ ᆼ ᄀ ᅵ ᄋ ᅵ ᄉ ᅡ
재무이사	ᄌ ᅢ ᄆ ᅮ ᄋ ᅵ ᄉ ᅡ
등은	ᄃ ᅳ ᆼ ᄋ ᅳ ᆫ
경영과	ᄀ ᅧ ᆼ ᄋ ᅧ ᆼ ᄀ ᅪ
직책이다	ᄌ ᅵ ᆨ ᄎ ᅢ ᄀ ᅵ ᄃ ᅡ
이사에	ᄋ ᅵ ᄉ ᅡ ᄋ ᅦ
회장이란	ᄒ ᅬ ᄌ ᅡ ᆼ ᄋ ᅵ ᄅ ᅡ ᆫ
대표하는	ᄃ ᅢ ᄑ ᅭ ᄒ ᅡ ᄂ ᅳ ᆫ
경영자로	ᄀ ᅧ ᆼ ᄋ ᅧ ᆼ ᄌ ᅡ ᄅ ᅩ
그의	ᄀ ᅳ ᄋ ᅴ
직책	ᄌ ᅵ ᆨ ᄎ ᅢ ᆨ
계급이	ᄀ ᅨ ᄀ ᅳ ᄇ ᅵ
회장에서	ᄒ ᅬ ᄌ ᅡ ᆼ ᄋ ᅦ ᄉ ᅥ
대표이사는	ᄃ ᅢ ᄑ ᅭ ᄋ ᅵ ᄉ ᅡ ᄂ ᅳ ᆫ
경영자의	ᄀ ᅧ ᆼ ᄋ ᅧ ᆼ ᄌ ᅡ ᄋ ᅴ
직급은	ᄌ ᅵ ᆨ ᄁ ᅳ ᄇ ᅳ ᆫ
대표이사의	ᄃ ᅢ ᄑ ᅭ ᄋ ᅵ ᄉ ᅡ ᄋ ᅴ
회장	ᄒ ᅬ ᄌ ᅡ ᆼ
사장	ᄉ ᅡ ᄌ ᅡ ᆼ
법무이사	ᄇ ᅥ ᆷ ᄆ ᅮ ᄋ ᅵ ᄉ ᅡ
뗀다라거나	ᄄ ᅦ ᆫ ᄃ ᅡ ᄅ ᅡ ᄀ ᅥ ᄂ ᅡ
일선에서	ᄋ ᅵ ᆯ ᄉ ᅥ ᄂ ᅦ ᄉ ᅥ
물러난다	ᄆ ᅮ ᆯ ᄅ ᅥ ᄂ ᅡ ᆫ ᄃ ᅡ
책임을	ᄎ ᅢ ᄀ ᅵ ᄆ ᅳ ᆯ
맡지	ᄆ ᅡ ᆮ ᄍ ᅵ
구체적으로는	ᄀ ᅮ ᄎ ᅦ ᄌ ᅥ ᄀ ᅳ ᄅ ᅩ ᄂ ᅳ ᆫ
등기이사가	ᄃ ᅳ ᆼ ᄀ ᅵ ᄋ ᅵ ᄉ ᅡ ᄀ ᅡ
아니라는	ᄋ ᅡ ᄂ ᅵ ᄅ ᅡ ᄂ ᅳ ᆫ
소유의	ᄉ ᅩ ᄋ ᅲ ᄋ ᅴ
배당금과	ᄇ ᅢ ᄃ ᅡ ᆼ ᄀ ᅳ ᆷ ᄀ ᅪ
임금	ᄋ ᅵ ᆷ ᄀ ᅳ ᆷ
경영을	ᄀ ᅧ ᆼ ᄋ ᅧ ᆼ ᄋ ᅳ ᆯ
분리하면	ᄇ ᅮ ᆯ ᄅ ᅵ ᄒ ᅡ ᄆ ᅧ ᆫ
회사로부터	ᄒ ᅬ ᄉ ᅡ ᄅ ᅩ ᄇ ᅮ ᄐ ᅥ
소득이	ᄉ ᅩ ᄃ ᅳ ᄀ ᅵ
없어진다는	ᄋ ᅥ ᆸ ᄊ ᅥ ᄌ ᅵ ᆫ ᄃ ᅡ ᄂ ᅳ ᆫ
뜻일까	ᄄ ᅳ ᄉ ᅵ ᆯ ᄁ ᅡ
그건	ᄀ ᅳ ᄀ ᅥ ᆫ
경영하지	ᄀ ᅧ ᆼ ᄋ ᅧ ᆼ ᄒ ᅡ ᄌ ᅵ
않으니까	ᄋ ᅡ ᄂ ᅳ ᄂ ᅵ ᄁ ᅡ
월급은	ᄋ ᅯ ᆯ ᄀ ᅳ ᄇ ᅳ ᆫ
없어진다	ᄋ ᅥ ᆸ ᄊ ᅥ ᄌ ᅵ ᆫ ᄃ ᅡ
이사	ᄋ ᅵ ᄉ ᅡ
회장도	ᄒ ᅬ ᄌ ᅡ ᆼ ᄃ ᅩ
정해진	ᄌ ᅥ ᆼ ᄒ ᅢ ᄌ ᅵ ᆫ
월급을	ᄋ ᅯ ᆯ ᄀ ᅳ ᄇ ᅳ ᆯ
받는데	ᄇ ᅡ ᆫ ᄂ ᅳ ᆫ ᄃ ᅦ
주주로서	ᄌ ᅮ ᄌ ᅮ ᄅ ᅩ ᄉ ᅥ
년에	ᄂ ᅧ ᄂ ᅦ
번씩	ᄇ ᅥ ᆫ ᄊ ᅵ ᆨ
배당금	ᄇ ᅢ ᄃ ᅡ ᆼ ᄀ ᅳ ᆷ
주식의	ᄌ ᅮ ᄉ ᅵ ᄀ ᅴ
배당소득은	ᄇ ᅢ ᄃ ᅡ ᆼ ᄉ ᅩ ᄃ ᅳ ᄀ ᅳ ᆫ
유지된다	ᄋ ᅲ ᄌ ᅵ ᄃ ᅬ ᆫ ᄃ ᅡ
회장들은	ᄒ ᅬ ᄌ ᅡ ᆼ ᄃ ᅳ ᄅ ᅳ ᆫ
배당금을	ᄇ ᅢ ᄃ ᅡ ᆼ ᄀ ᅳ ᄆ ᅳ ᆯ
소득을	ᄉ ᅩ ᄃ ᅳ ᄀ ᅳ ᆯ
팔아치우지	ᄑ ᅡ ᄅ ᅡ ᄎ ᅵ ᄋ ᅮ ᄌ ᅵ
경영활동과	ᄀ ᅧ ᆼ ᄋ ᅧ ᆼ ᄒ ᅪ ᆯ ᄃ ᅩ ᆼ ᄀ ᅪ
관계없이	ᄀ ᅪ ᆫ ᄀ ᅨ ᄋ ᅥ ᆸ ᄊ ᅵ
배당금은	ᄇ ᅢ ᄃ ᅡ ᆼ ᄀ ᅳ ᄆ ᅳ ᆫ
받는다	ᄇ ᅡ ᆫ ᄂ ᅳ ᆫ ᄃ ᅡ
장단점이	ᄌ ᅡ ᆼ ᄃ ᅡ ᆫ ᄌ ᅥ ᄆ ᅵ
분리는	ᄇ ᅮ ᆯ ᄅ ᅵ ᄂ ᅳ ᆫ
일일까	ᄋ ᅵ ᄅ ᅵ ᆯ ᄁ ᅡ
경영이	ᄀ ᅧ ᆼ ᄋ ᅧ ᆼ ᄋ ᅵ
분리되면	ᄇ ᅮ ᆯ ᄅ ᅵ ᄃ ᅬ ᄆ ᅧ ᆫ
능력	ᄂ ᅳ ᆼ ᄂ ᅧ ᆨ
경영인들이	ᄀ ᅧ ᆼ ᄋ ᅧ ᆼ ᄋ ᅵ ᆫ ᄃ ᅳ ᄅ ᅵ
나서서	ᄂ ᅡ ᄉ ᅥ ᄉ ᅥ
과감한	ᄀ ᅪ ᄀ ᅡ ᆷ ᄒ ᅡ ᆫ
확대와	ᄒ ᅪ ᆨ ᄄ ᅢ ᄋ ᅪ
같	ᄀ ᅡ ᆮ
은	ᄋ ᅳ ᆫ
소유처럼	ᄉ ᅩ ᄋ ᅲ ᄎ ᅥ ᄅ ᅥ ᆷ
운영해	ᄋ ᅮ ᄂ ᅧ ᆼ ᄒ ᅢ
일으킬	ᄋ ᅵ ᄅ ᅳ ᄏ ᅵ ᆯ
제도	ᄌ ᅦ ᄃ ᅩ
자체보다	ᄌ ᅡ ᄎ ᅦ ᄇ ᅩ ᄃ ᅡ
운영이	ᄋ ᅮ ᄂ ᅧ ᆼ ᄋ ᅵ
비	ᄇ ᅵ
공오육	ᄀ ᅩ ᆼ ᄋ ᅩ ᄋ ᅲ ᆨ
생활	ᄉ ᅢ ᆼ ᄒ ᅪ ᆯ
장애인	ᄌ ᅡ ᆼ ᄋ ᅢ ᄋ ᅵ ᆫ
차별적었던	ᄎ ᅡ ᄇ ᅧ ᆯ ᄌ ᅥ ᄀ ᅥ ᆮ ᄄ ᅥ ᆫ
조선	ᄌ ᅩ ᄉ ᅥ ᆫ
시대에	ᄉ ᅵ ᄃ ᅢ ᄋ ᅦ
하나인	ᄒ ᅡ ᄂ ᅡ ᄋ ᅵ ᆫ
차별	ᄎ ᅡ ᄇ ᅧ ᆯ
지금보다	ᄌ ᅵ ᄀ ᅳ ᆷ ᄇ ᅩ ᄃ ᅡ
옛날인	ᄋ ᅨ ᆫ ᄂ ᅡ ᄅ ᅵ ᆫ
시대에는	ᄉ ᅵ ᄃ ᅢ ᄋ ᅦ ᄂ ᅳ ᆫ
차별이	ᄎ ᅡ ᄇ ᅧ ᄅ ᅵ
적었다고	ᄌ ᅥ ᄀ ᅥ ᆮ ᄄ ᅡ ᄀ ᅩ
자세히	ᄌ ᅡ ᄉ ᅦ ᄒ ᅵ
조선시대의	ᄌ ᅩ ᄉ ᅥ ᆫ ᄉ ᅵ ᄃ ᅢ ᄋ ᅴ
장애인은	ᄌ ᅡ ᆼ ᄋ ᅢ ᄋ ᅵ ᄂ ᅳ ᆫ
진출에	ᄌ ᅵ ᆫ ᄎ ᅮ ᄅ ᅦ
거의	ᄀ ᅥ ᄋ ᅴ
그들	ᄀ ᅳ ᄃ ᅳ ᆯ
훌륭한	ᄒ ᅮ ᆯ ᄅ ᅲ ᆼ ᄒ ᅡ ᆫ
업적을	ᄋ ᅥ ᆸ ᄍ ᅥ ᄀ ᅳ ᆯ
세운	ᄉ ᅦ ᄋ ᅮ ᆫ
대표적으로	ᄃ ᅢ ᄑ ᅭ ᄌ ᅥ ᄀ ᅳ ᄅ ᅩ
허조	ᄒ ᅥ ᄌ ᅩ
이원익	ᄋ ᅵ ᄋ ᅯ ᄂ ᅵ ᆨ
윤지완	ᄋ ᅲ ᆫ ᄌ ᅵ ᄋ ᅪ ᆫ
채제공	ᄎ ᅢ ᄌ ᅦ ᄀ ᅩ ᆼ
장만	ᄌ ᅡ ᆼ ᄆ ᅡ ᆫ
권균	ᄀ ᅯ ᆫ ᄀ ᅲ ᆫ
인지	ᄋ ᅵ ᆫ ᄌ ᅵ
잠깐	ᄌ ᅡ ᆷ ᄁ ᅡ ᆫ
알아봐요	ᄋ ᅡ ᄅ ᅡ ᄇ ᅪ ᄋ ᅭ
장애	ᄌ ᅡ ᆼ ᄋ ᅢ
척추	ᄎ ᅥ ᆨ ᄎ ᅮ
회수	ᄒ ᅬ ᄉ ᅮ
양반과	ᄋ ᅣ ᆼ ᄇ ᅡ ᆫ ᄀ ᅪ
평민	ᄑ ᅧ ᆼ ᄆ ᅵ ᆫ
복지	ᄇ ᅩ ᆨ ᄍ ᅵ
제도는	ᄌ ᅦ ᄃ ᅩ ᄂ ᅳ ᆫ
어땠을까요	ᄋ ᅥ ᄄ ᅢ ᄊ ᅳ ᆯ ᄁ ᅡ ᄋ ᅭ
일단	ᄋ ᅵ ᆯ ᄃ ᅡ ᆫ
몸이	ᄆ ᅩ ᄆ ᅵ
불편한	ᄇ ᅮ ᆯ ᄑ ᅧ ᆫ ᄒ ᅡ ᆫ
독질인	ᄃ ᅩ ᆨ ᄍ ᅵ ᄅ ᅵ ᆫ
잔질인	ᄌ ᅡ ᆫ ᄌ ᅵ ᄅ ᅵ ᆫ
폐질인으로	ᄑ ᅨ ᄌ ᅵ ᄅ ᅵ ᄂ ᅳ ᄅ ᅩ
구분을	ᄀ ᅮ ᄇ ᅮ ᄂ ᅳ ᆯ
복질인은	ᄇ ᅩ ᆨ ᄍ ᅵ ᄅ ᅵ ᄂ ᅳ ᆫ
생명이	ᄉ ᅢ ᆼ ᄆ ᅧ ᆼ ᄋ ᅵ
위독한	ᄋ ᅱ ᄃ ᅩ ᄏ ᅡ ᆫ
병에	ᄇ ᅧ ᆼ ᄋ ᅦ
걸려	ᄀ ᅥ ᆯ ᄅ ᅧ
잔질인은	ᄌ ᅡ ᆫ ᄌ ᅵ ᄅ ᅵ ᄂ ᅳ ᆫ
병이	ᄇ ᅧ ᆼ ᄋ ᅵ
마지막으로	ᄆ ᅡ ᄌ ᅵ ᄆ ᅡ ᄀ ᅳ ᄅ ᅩ
폐질인은	ᄑ ᅨ ᄌ ᅵ ᄅ ᅵ ᄂ ᅳ ᆫ
불치병에	ᄇ ᅮ ᆯ ᄎ ᅵ ᄇ ᅧ ᆼ ᄋ ᅦ
말해요	ᄆ ᅡ ᆯ ᄒ ᅢ ᄋ ᅭ
조선시대에는	ᄌ ᅩ ᄉ ᅥ ᆫ ᄉ ᅵ ᄃ ᅢ ᄋ ᅦ ᄂ ᅳ ᆫ
장애를	ᄌ ᅡ ᆼ ᄋ ᅢ ᄅ ᅳ ᆯ
병으로	ᄇ ᅧ ᆼ ᄋ ᅳ ᄅ ᅩ
구분해서	ᄀ ᅮ ᄇ ᅮ ᆫ ᄒ ᅢ ᄉ ᅥ
질병에	ᄌ ᅵ ᆯ ᄇ ᅧ ᆼ ᄋ ᅦ
걸린	ᄀ ᅥ ᆯ ᄅ ᅵ ᆫ
하나의	ᄒ ᅡ ᄂ ᅡ ᄋ ᅴ
인정하며	ᄋ ᅵ ᆫ ᄌ ᅥ ᆼ ᄒ ᅡ ᄆ ᅧ
보살펴야	ᄇ ᅩ ᄉ ᅡ ᆯ ᄑ ᅧ ᄋ ᅣ
대상으로	ᄃ ᅢ ᄉ ᅡ ᆼ ᄋ ᅳ ᄅ ᅩ
세종	ᄉ ᅦ ᄌ ᅩ ᆼ
십사년의	ᄉ ᅵ ᆸ ᄊ ᅡ ᄂ ᅧ ᄂ ᅴ
일흔세	ᄋ ᅵ ᆯ ᄒ ᅳ ᆫ ᄉ ᅦ
사람과	ᄉ ᅡ ᄅ ᅡ ᆷ ᄀ ᅪ
독질이	ᄃ ᅩ ᆨ ᄍ ᅵ ᄅ ᅵ
나이가	ᄂ ᅡ ᄋ ᅵ ᄀ ᅡ
일흔세가	ᄋ ᅵ ᆯ ᄒ ᅳ ᆫ ᄉ ᅦ ᄀ ᅡ
차지	ᄎ ᅡ ᄌ ᅵ
않았더라도	ᄋ ᅡ ᄂ ᅡ ᆮ ᄄ ᅥ ᄅ ᅡ ᄃ ᅩ
시정	ᄉ ᅵ ᄌ ᅥ ᆼ
주고라는	ᄌ ᅮ ᄀ ᅩ ᄅ ᅡ ᄂ ᅳ ᆫ
기록이	ᄀ ᅵ ᄅ ᅩ ᄀ ᅵ
시정이란	ᄉ ᅵ ᄌ ᅥ ᆼ ᄋ ᅵ ᄅ ᅡ ᆫ
부모를	ᄇ ᅮ ᄆ ᅩ ᄅ ᅳ ᆯ
간호하기	ᄀ ᅡ ᆫ ᄒ ᅩ ᄒ ᅡ ᄀ ᅵ
위하여	ᄋ ᅱ ᄒ ᅡ ᄋ ᅧ
군역에서	ᄀ ᅮ ᄂ ᅧ ᄀ ᅦ ᄉ ᅥ
장애가	ᄌ ᅡ ᆼ ᄋ ᅢ ᄀ ᅡ
자나	ᄌ ᅡ ᄂ ᅡ
그를	ᄀ ᅳ ᄅ ᅳ ᆯ
간호하는	ᄀ ᅡ ᆫ ᄒ ᅩ ᄒ ᅡ ᄂ ᅳ ᆫ
자에게는	ᄌ ᅡ ᄋ ᅦ ᄀ ᅦ ᄂ ᅳ ᆫ
부역과	ᄇ ᅮ ᄋ ᅧ ᆨ ᄁ ᅪ
잡역들	ᄌ ᅡ ᄇ ᅧ ᆨ ᄄ ᅳ ᆯ
장애인을	ᄌ ᅡ ᆼ ᄋ ᅢ ᄋ ᅵ ᄂ ᅳ ᆯ
도움만	ᄃ ᅩ ᄋ ᅮ ᆷ ᄆ ᅡ ᆫ
살아갈	ᄉ ᅡ ᄅ ᅡ ᄀ ᅡ ᆯ
전문적인	ᄌ ᅥ ᆫ ᄆ ᅮ ᆫ ᄌ ᅥ ᄀ ᅵ ᆫ
일자리를	ᄋ ᅵ ᆯ ᄌ ᅡ ᄅ ᅵ ᄅ ᅳ ᆯ
주었어요	ᄌ ᅮ ᄋ ᅥ ᄊ ᅥ ᄋ ᅭ
시각장애인을	ᄉ ᅵ ᄀ ᅡ ᆨ ᄍ ᅡ ᆼ ᄋ ᅢ ᄋ ᅵ ᄂ ᅳ ᆯ
명통시라는	ᄆ ᅧ ᆼ ᄐ ᅩ ᆼ ᄉ ᅵ ᄅ ᅡ ᄂ ᅳ ᆫ
단체를	ᄃ ᅡ ᆫ ᄎ ᅦ ᄅ ᅳ ᆯ
만들어서	ᄆ ᅡ ᆫ ᄃ ᅳ ᄅ ᅥ ᄉ ᅥ
명통시에	ᄆ ᅧ ᆼ ᄐ ᅩ ᆼ ᄉ ᅵ ᄋ ᅦ
소속된	ᄉ ᅩ ᄉ ᅩ ᆨ ᄄ ᅬ ᆫ
장애인들은	ᄌ ᅡ ᆼ ᄋ ᅢ ᄋ ᅵ ᆫ ᄃ ᅳ ᄅ ᅳ ᆫ
기우제와	ᄀ ᅵ ᄋ ᅮ ᄌ ᅦ ᄋ ᅪ
행사를	ᄒ ᅢ ᆼ ᄉ ᅡ ᄅ ᅳ ᆯ
담당하며	ᄃ ᅡ ᆷ ᄃ ᅡ ᆼ ᄒ ᅡ ᄆ ᅧ
대가로	ᄃ ᅢ ᄀ ᅡ ᄅ ᅩ
노비와	ᄂ ᅩ ᄇ ᅵ ᄋ ᅪ
쌀을	ᄊ ᅡ ᄅ ᅳ ᆯ
하였답니다	ᄒ ᅡ ᄋ ᅧ ᆮ ᄄ ᅡ ᆷ ᄂ ᅵ ᄃ ᅡ
장애인에	ᄌ ᅡ ᆼ ᄋ ᅢ ᄋ ᅵ ᄂ ᅦ
부정적	ᄇ ᅮ ᄌ ᅥ ᆼ ᄌ ᅥ ᆨ
인식의	ᄋ ᅵ ᆫ ᄉ ᅵ ᄀ ᅴ
장애인에게	ᄌ ᅡ ᆼ ᄋ ᅢ ᄋ ᅵ ᄂ ᅦ ᄀ ᅦ
생겨난	ᄉ ᅢ ᆼ ᄀ ᅧ ᄂ ᅡ ᆫ
바야	ᄇ ᅡ ᄋ ᅣ
흐로	ᄒ ᅳ ᄅ ᅩ
일제강점기인	ᄋ ᅵ ᆯ ᄌ ᅦ ᄀ ᅡ ᆼ ᄌ ᅥ ᆷ ᄀ ᅵ ᄋ ᅵ ᆫ
불구자라는	ᄇ ᅮ ᆯ ᄀ ᅮ ᄌ ᅡ ᄅ ᅡ ᄂ ᅳ ᆫ
용어가	ᄋ ᅭ ᆼ ᄋ ᅥ ᄀ ᅡ
생겨나고	ᄉ ᅢ ᆼ ᄀ ᅧ ᄂ ᅡ ᄀ ᅩ
사회의	ᄉ ᅡ ᄒ ᅬ ᄋ ᅴ
편견과	ᄑ ᅧ ᆫ ᄀ ᅧ ᆫ ᄀ ᅪ
많아지기	ᄆ ᅡ ᄂ ᅡ ᄌ ᅵ ᄀ ᅵ
뼈가	ᄈ ᅧ ᄀ ᅡ
굽은	ᄀ ᅮ ᄇ ᅳ ᆫ
일명	ᄋ ᅵ ᆯ ᄆ ᅧ ᆼ
곱추	ᄀ ᅩ ᆸ ᄎ ᅮ
뇌신경세포가	ᄂ ᅬ ᄉ ᅵ ᆫ ᄀ ᅧ ᆼ ᄉ ᅦ ᄑ ᅩ ᄀ ᅡ
일시적으로	ᄋ ᅵ ᆯ ᄊ ᅵ ᄌ ᅥ ᄀ ᅳ ᄅ ᅩ
이상을	ᄋ ᅵ ᄉ ᅡ ᆼ ᄋ ᅳ ᆯ
일으켜	ᄋ ᅵ ᄅ ᅳ ᄏ ᅧ
과도한	ᄀ ᅪ ᄃ ᅩ ᄒ ᅡ ᆫ
흥분	ᄒ ᅳ ᆼ ᄇ ᅮ ᆫ
상태로	ᄉ ᅡ ᆼ ᄐ ᅢ ᄅ ᅩ
발작	ᄇ ᅡ ᆯ ᄌ ᅡ ᆨ
일어나는	ᄋ ᅵ ᄅ ᅥ ᄂ ᅡ ᄂ ᅳ ᆫ
뇌	ᄂ ᅬ
기능의	ᄀ ᅵ ᄂ ᅳ ᆼ ᄋ ᅴ
마비가	ᄆ ᅡ ᄇ ᅵ ᄀ ᅡ
질환	ᄌ ᅵ ᆯ ᄒ ᅪ ᆫ
조현병	ᄌ ᅩ ᄒ ᅧ ᆫ ᄇ ᅧ ᆼ
망상	ᄆ ᅡ ᆼ ᄉ ᅡ ᆼ
환청	ᄒ ᅪ ᆫ ᄎ ᅥ ᆼ
조선시대	ᄌ ᅩ ᄉ ᅥ ᆫ ᄉ ᅵ ᄃ ᅢ
장애인들에	ᄌ ᅡ ᆼ ᄋ ᅢ ᄋ ᅵ ᆫ ᄃ ᅳ ᄅ ᅦ
알아봤는데요	ᄋ ᅡ ᄅ ᅡ ᄇ ᅪ ᆫ ᄂ ᅳ ᆫ ᄃ ᅦ ᄋ ᅭ
글을	ᄀ ᅳ ᄅ ᅳ ᆯ
보셔서	ᄇ ᅩ ᄉ ᅧ ᄉ ᅥ
나아졌으면	ᄂ ᅡ ᄋ ᅡ ᄌ ᅥ ᄊ ᅳ ᄆ ᅧ ᆫ
좋겠습니다	ᄌ ᅩ ᄏ ᅦ ᆮ ᄊ ᅳ ᆷ ᄂ ᅵ ᄃ ᅡ
글	ᄀ ᅳ ᆯ
읽어주셔서	ᄋ ᅵ ᆯ ᄀ ᅥ ᄌ ᅮ ᄉ ᅧ ᄉ ᅥ
대전	ᄃ ᅢ ᄌ ᅥ ᆫ
삼천	ᄉ ᅡ ᆷ ᄎ ᅥ ᆫ
이유린	ᄋ ᅵ ᄋ ᅲ ᄅ ᅵ ᆫ
어경	ᄋ ᅥ ᄀ ᅧ ᆼ
클럽	ᄏ ᅳ ᆯ ᄅ ᅥ ᆸ
주간지라고	ᄌ ᅮ ᄀ ᅡ ᆫ ᄌ ᅵ ᄅ ᅡ ᄀ ᅩ
하루에	ᄒ ᅡ ᄅ ᅮ ᄋ ᅦ
신문은	ᄉ ᅵ ᆫ ᄆ ᅮ ᄂ ᅳ ᆫ
일간지	ᄋ ᅵ ᆯ ᄀ ᅡ ᆫ ᄌ ᅵ
이처럼	ᄋ ᅵ ᄎ ᅥ ᄅ ᅥ ᆷ
금액을	ᄀ ᅳ ᄆ ᅢ ᄀ ᅳ ᆯ
내고	ᄂ ᅢ ᄀ ᅩ
정기적으로	ᄌ ᅥ ᆼ ᄀ ᅵ ᄌ ᅥ ᄀ ᅳ ᄅ ᅩ
제품이나	ᄌ ᅦ ᄑ ᅮ ᄆ ᅵ ᄂ ᅡ
구독이라고	ᄀ ᅮ ᄃ ᅩ ᄀ ᅵ ᄅ ᅡ ᄀ ᅩ
구독경제는	ᄀ ᅮ ᄃ ᅩ ᆨ ᄁ ᅧ ᆼ ᄌ ᅦ ᄂ ᅳ ᆫ
신문이나	ᄉ ᅵ ᆫ ᄆ ᅮ ᄂ ᅵ ᄂ ᅡ
잡지를	ᄌ ᅡ ᆸ ᄍ ᅵ ᄅ ᅳ ᆯ
지정된	ᄌ ᅵ ᄌ ᅥ ᆼ ᄃ ᅬ ᆫ
날짜에	ᄂ ᅡ ᆯ ᄍ ᅡ ᄋ ᅦ
상품이나	ᄉ ᅡ ᆼ ᄑ ᅮ ᄆ ᅵ ᄂ ᅡ
제공하는	ᄌ ᅦ ᄀ ᅩ ᆼ ᄒ ᅡ ᄂ ᅳ ᆫ
형	ᄒ ᅧ ᆼ
태의	ᄐ ᅢ ᄋ ᅴ
사업을	ᄉ ᅡ ᄋ ᅥ ᄇ ᅳ ᆯ
구독경제의	ᄀ ᅮ ᄃ ᅩ ᆨ ᄁ ᅧ ᆼ ᄌ ᅦ ᄋ ᅴ
핵심은	ᄒ ᅢ ᆨ ᄊ ᅵ ᄆ ᅳ ᆫ
비용을	ᄇ ᅵ ᄋ ᅭ ᆼ ᄋ ᅳ ᆯ
만족을	ᄆ ᅡ ᆫ ᄌ ᅩ ᄀ ᅳ ᆯ
기본적인	ᄀ ᅵ ᄇ ᅩ ᆫ ᄌ ᅥ ᄀ ᅵ ᆫ
원칙에서	ᄋ ᅯ ᆫ ᄎ ᅵ ᄀ ᅦ ᄉ ᅥ
